"","seqnames","start","end","width","flank.5","flank.3","total.width"
"1","chr1",181578,181600,23,1,144,168
"2","chr1",376202,376219,18,51,76,145
"3","chr1",604402,604419,18,51,76,145
"4","chr1",827588,827610,23,74,64,161
"5","chr1",869463,869520,58,52,66,176
"6","chr1",899025,899045,21,77,75,173
"7","chr1",959010,959032,23,4,17,44
"8","chr1",960278,960297,20,23,113,156
"9","chr1",984612,984657,46,9,12,67
"10","chr1",998744,998782,39,47,13,99
"11","chr1",1019942,1020044,103,3,57,163
"12","chr1",1020057,1020083,27,42,18,87
"13","chr1",1033686,1033833,148,58,8,214
"14","chr1",1040966,1041138,173,136,81,390
"15","chr1",1041107,1041142,36,140,32,208
"16","chr1",1048768,1048789,22,55,8,85
"17","chr1",1056609,1056634,26,90,80,196
"18","chr1",1113914,1113934,21,8,27,56
"19","chr1",1116461,1116480,20,136,39,195
"20","chr1",1166518,1166548,31,47,59,137
"21","chr1",1170468,1170574,107,25,116,248
"22","chr1",1266881,1266905,25,75,20,120
"23","chr1",1324763,1324806,44,1,13,58
"24","chr1",1349507,1349533,27,14,36,77
"25","chr1",1408765,1408791,27,74,40,141
"26","chr1",1423776,1423799,24,76,13,113
"27","chr1",1427958,1428214,257,1,2,260
"28","chr1",1435695,1435718,24,24,16,64
"29","chr1",1439720,1439755,36,17,63,116
"30","chr1",1452809,1452831,23,28,64,115
"31","chr1",1455217,1455243,27,53,6,86
"32","chr1",1460070,1460088,19,6,31,56
"33","chr1",1469286,1469304,19,132,6,157
"34","chr1",1472098,1472141,44,47,17,108
"35","chr1",1477678,1477725,48,78,66,192
"36","chr1",1483128,1483153,26,85,105,216
"37","chr1",1503955,1503981,27,102,89,218
"38","chr1",1510083,1510105,23,132,6,161
"39","chr1",1512486,1512520,35,42,13,90
"40","chr1",1521299,1521329,31,30,6,67
"41","chr1",1527959,1527976,18,75,35,128
"42","chr1",1540379,1540410,32,38,128,198
"43","chr1",1540606,1540639,34,12,27,73
"44","chr1",1540645,1540683,39,43,28,110
"45","chr1",1543051,1543075,25,54,71,150
"46","chr1",1546861,1546884,24,147,56,227
"47","chr1",1550174,1550191,18,55,48,121
"48","chr1",1584544,1584567,24,77,133,234
"49","chr1",1586902,1586938,37,8,21,66
"50","chr1",1587223,1587240,18,21,8,47
"51","chr1",1612524,1612574,51,8,43,102
"52","chr1",1650665,1650688,24,104,11,139
"53","chr1",1658919,1658950,32,56,44,132
"54","chr1",1679831,1679850,20,15,7,42
"55","chr1",1681989,1682040,52,36,70,158
"56","chr1",1694294,1694316,23,32,6,61
"57","chr1",1807699,1807725,27,77,121,225
"58","chr1",1902675,1902713,39,74,23,136
"59","chr1",1910044,1910083,40,15,12,67
"60","chr1",1912921,1912941,21,102,8,131
"61","chr1",1932067,1932100,34,133,18,185
"62","chr1",1941116,1941138,23,95,3,121
"63","chr1",1988825,1988873,49,73,53,175
"64","chr1",1995979,1996001,23,75,3,101
"65","chr1",2004502,2004524,23,5,144,172
"66","chr1",2004956,2004979,24,42,3,69
"67","chr1",2042766,2042788,23,79,74,176
"68","chr1",2054942,2054960,19,76,44,139
"69","chr1",2101520,2101540,21,86,17,124
"70","chr1",2143026,2143046,21,77,51,149
"71","chr1",2187281,2187322,42,9,6,57
"72","chr1",2192907,2192924,18,132,138,288
"73","chr1",2199392,2199421,30,22,13,65
"74","chr1",2202017,2202057,41,35,74,150
"75","chr1",2216127,2216151,25,142,97,264
"76","chr1",2222105,2222128,24,9,88,121
"77","chr1",2227952,2228009,58,2,18,78
"78","chr1",2228145,2228200,56,24,29,109
"79","chr1",2228416,2228436,21,38,28,87
"80","chr1",2287973,2288001,29,71,49,149
"81","chr1",2335348,2335368,21,134,51,206
"82","chr1",2428048,2428065,18,86,63,167
"83","chr1",2443833,2443863,31,6,3,40
"84","chr1",2529506,2529524,19,74,18,111
"85","chr1",2546254,2546273,20,1,51,72
"86","chr1",2629029,2629057,29,26,32,87
"87","chr1",2983072,2983097,26,43,52,121
"88","chr1",3029802,3029819,18,147,85,250
"89","chr1",3064306,3064324,19,4,70,93
"90","chr1",3069057,3069081,25,107,10,142
"91","chr1",3088751,3088788,38,64,144,246
"92","chr1",3088762,3088801,40,77,133,250
"93","chr1",3089916,3089941,26,51,83,160
"94","chr1",3148420,3148437,18,1,145,164
"95","chr1",3200910,3201011,102,100,142,344
"96","chr1",3240408,3240454,47,9,15,71
"97","chr1",3331451,3331474,24,29,2,55
"98","chr1",3390835,3390853,19,76,12,107
"99","chr1",3393846,3393868,23,37,8,68
"100","chr1",3409647,3410190,544,24,145,713
"101","chr1",3425076,3425095,20,76,50,146
"102","chr1",3538697,3538745,49,14,130,193
"103","chr1",3618017,3618034,18,65,38,121
"104","chr1",3625282,3625318,37,43,3,83
"105","chr1",3753307,3753340,34,10,92,136
"106","chr1",3772722,3772748,27,78,15,120
"107","chr1",3887627,3887645,19,6,99,124
"108","chr1",3900329,3900346,18,65,42,125
"109","chr1",3924895,3924926,32,65,5,102
"110","chr1",3929153,3930790,1638,49,94,1781
"111","chr1",3999084,3999107,24,68,3,95
"112","chr1",4124196,4124213,18,57,7,82
"113","chr1",4160908,4160925,18,76,88,182
"114","chr1",4211396,4211423,28,33,67,128
"115","chr1",4352525,4352570,46,4,74,124
"116","chr1",4500031,4500052,22,69,62,153
"117","chr1",4590142,4590168,27,9,41,77
"118","chr1",4639407,4639428,22,37,73,132
"119","chr1",4712267,4712286,20,50,66,136
"120","chr1",4712523,4712544,22,98,14,134
"121","chr1",4780599,4780647,49,74,56,179
"122","chr1",5595427,5595445,19,9,74,102
"123","chr1",5841685,5841707,23,24,74,121
"124","chr1",5895500,5895528,29,35,74,138
"125","chr1",5991752,5991775,24,99,31,154
"126","chr1",6141290,6141326,37,6,28,71
"127","chr1",6191360,6191383,24,145,81,250
"128","chr1",6203856,6203874,19,45,73,137
"129","chr1",6215332,6215349,18,106,7,131
"130","chr1",6230587,6230608,22,14,2,38
"131","chr1",6244973,6245081,109,64,36,209
"132","chr1",6260844,6260879,36,43,83,162
"133","chr1",6261038,6261055,18,72,8,98
"134","chr1",6261210,6261237,28,15,30,73
"135","chr1",6328680,6328703,24,108,76,208
"136","chr1",6335328,6335352,25,86,9,120
"137","chr1",6364847,6364873,27,77,75,179
"138","chr1",6394588,6394611,24,8,22,54
"139","chr1",6404708,6404758,51,19,6,76
"140","chr1",6419960,6419979,20,69,79,168
"141","chr1",6461152,6461170,19,18,59,96
"142","chr1",6504563,6504587,25,45,108,178
"143","chr1",6523580,6523603,24,77,73,174
"144","chr1",6694975,6694996,22,117,74,213
"145","chr1",6703835,6703868,34,76,79,189
"146","chr1",6728201,6728223,23,21,118,162
"147","chr1",6735644,6735687,44,76,3,123
"148","chr1",6744536,6744556,21,126,145,292
"149","chr1",6770094,6770125,32,72,6,110
"150","chr1",6785449,6785487,39,10,14,63
"151","chr1",6785677,6785702,26,31,43,100
"152","chr1",6860965,6860982,18,17,21,56
"153","chr1",7075663,7075680,18,8,34,60
"154","chr1",7221280,7221302,23,28,12,63
"155","chr1",7423470,7423490,21,97,74,192
"156","chr1",7467770,7467790,21,63,4,88
"157","chr1",7635609,7635627,19,94,74,187
"158","chr1",7680843,7680861,19,22,116,157
"159","chr1",7680862,7680883,22,44,97,163
"160","chr1",7704790,7704833,44,32,25,101
"161","chr1",7704953,7704988,36,51,1,88
"162","chr1",7748239,7748273,35,88,118,241
"163","chr1",7908296,7908315,20,36,46,102
"164","chr1",7921339,7921382,44,94,3,141
"165","chr1",7928881,7928933,53,8,4,65
"166","chr1",7951305,7951324,20,115,4,139
"167","chr1",7955020,7955044,25,5,50,80
"168","chr1",7977986,7978014,29,76,16,121
"169","chr1",7986970,7986993,24,97,135,256
"170","chr1",7990873,7990900,28,7,15,50
"171","chr1",8057965,8058023,59,24,79,162
"172","chr1",8058028,8058070,43,71,16,130
"173","chr1",8074276,8074298,23,67,32,122
"174","chr1",8129281,8129301,21,76,83,180
"175","chr1",8144577,8144607,31,125,19,175
"176","chr1",8160403,8160424,22,9,132,163
"177","chr1",8163467,8163521,55,47,63,165
"178","chr1",8164264,8164281,18,9,8,35
"179","chr1",8187354,8187380,27,5,57,89
"180","chr1",8241069,8241096,28,75,8,111
"181","chr1",8254995,8255014,20,69,64,153
"182","chr1",8255435,8255493,59,39,13,111
"183","chr1",8291397,8291421,25,8,43,76
"184","chr1",8423870,8423905,36,1,20,57
"185","chr1",8507738,8507756,19,7,120,146
"186","chr1",8531008,8531106,99,75,128,302
"187","chr1",8531108,8531135,28,104,28,160
"188","chr1",8545983,8546007,25,43,11,79
"189","chr1",8601018,8601037,20,8,47,75
"190","chr1",8730338,8730361,24,77,90,191
"191","chr1",8798992,8799013,22,78,145,245
"192","chr1",8817827,8817854,28,84,48,160
"193","chr1",8823398,8823423,26,120,147,293
"194","chr1",8832604,8832636,33,8,114,155
"195","chr1",8853418,8853449,32,77,35,144
"196","chr1",8882455,8882480,26,76,11,113
"197","chr1",8906589,8906611,23,7,141,171
"198","chr1",8906901,8906925,25,8,4,37
"199","chr1",8913370,8913393,24,71,119,214
"200","chr1",8917014,8917046,33,147,6,186
"201","chr1",8971312,8971329,18,8,114,140
"202","chr1",9005782,9005800,19,31,31,81
"203","chr1",9010344,9010370,27,3,5,35
"204","chr1",9026887,9026912,26,76,118,220
"205","chr1",9165672,9165690,19,70,39,128
"206","chr1",9165856,9165873,18,76,65,159
"207","chr1",9198919,9198949,31,93,25,149
"208","chr1",9234708,9234749,42,65,94,201
"209","chr1",9291573,9291590,18,113,144,275
"210","chr1",9292797,9292821,25,1,70,96
"211","chr1",9361152,9361183,32,32,20,84
"212","chr1",9420028,9420056,29,76,24,129
"213","chr1",9427944,9427966,23,38,74,135
"214","chr1",9502022,9502040,19,6,69,94
"215","chr1",9511874,9511908,35,68,100,203
"216","chr1",9523516,9523560,45,45,46,136
"217","chr1",9523560,9523591,32,76,2,110
"218","chr1",9533797,9533818,22,76,37,135
"219","chr1",9541148,9541171,24,76,76,176
"220","chr1",9599616,9599638,23,74,84,181
"221","chr1",9620320,9620337,18,7,68,93
"222","chr1",9636878,9636912,35,5,26,66
"223","chr1",9639722,9639748,27,77,21,125
"224","chr1",9643074,9643118,45,78,20,143
"225","chr1",9655067,9655089,23,54,74,151
"226","chr1",9674693,9674725,33,123,3,159
"227","chr1",9678145,9678178,34,144,73,251
"228","chr1",9689449,9689474,26,3,25,54
"229","chr1",9720668,9720690,23,141,26,190
"230","chr1",9730649,9730678,30,92,52,174
"231","chr1",9772141,9772166,26,40,109,175
"232","chr1",9823863,9823881,19,25,29,73
"233","chr1",9837869,9838036,168,82,45,295
"234","chr1",9844534,9844558,25,131,111,267
"235","chr1",9851343,9851373,31,61,89,181
"236","chr1",9881330,9881355,26,6,15,47
"237","chr1",9910038,9910082,45,69,116,230
"238","chr1",9919729,9919752,24,9,47,80
"239","chr1",9959374,9959398,25,145,72,242
"240","chr1",9998380,9998410,31,61,110,202
"241","chr1",10023914,10023939,26,76,69,171
"242","chr1",10035714,10035760,47,7,137,191
"243","chr1",10041694,10041712,19,5,86,110
"244","chr1",10068338,10068367,30,76,54,160
"245","chr1",10088357,10088397,41,80,84,205
"246","chr1",10154243,10154273,31,82,74,187
"247","chr1",10202165,10202190,26,10,97,133
"248","chr1",10235863,10235883,21,40,73,134
"249","chr1",10313549,10313568,20,8,58,86
"250","chr1",10332502,10332533,32,76,9,117
"251","chr1",10390504,10390526,23,77,132,232
"252","chr1",10436333,10436360,28,88,91,207
"253","chr1",10443399,10443424,26,73,61,160
"254","chr1",10455053,10455072,20,5,50,75
"255","chr1",10457673,10457700,28,85,11,124
"256","chr1",10491675,10491697,23,75,2,100
"257","chr1",10554134,10554154,21,145,27,193
"258","chr1",10555637,10555667,31,12,143,186
"259","chr1",10600718,10600739,22,35,6,63
"260","chr1",10627929,10627953,25,8,33,66
"261","chr1",10638896,10638916,21,59,87,167
"262","chr1",10639084,10639151,68,28,40,136
"263","chr1",10639216,10639236,21,43,101,165
"264","chr1",10642285,10642313,29,149,73,251
"265","chr1",10664809,10664828,20,8,52,80
"266","chr1",10694585,10694622,38,36,46,120
"267","chr1",10709605,10709658,54,74,58,186
"268","chr1",10714308,10714365,58,9,5,72
"269","chr1",10779280,10779301,22,26,109,157
"270","chr1",10794135,10794199,65,103,38,206
"271","chr1",10794529,10794546,18,7,141,166
"272","chr1",10796055,10796073,19,101,10,130
"273","chr1",10796402,10796429,28,80,14,122
"274","chr1",10820858,10820880,23,36,48,107
"275","chr1",10824633,10824683,51,23,3,77
"276","chr1",10863309,10863335,27,83,17,127
"277","chr1",10871228,10871251,24,72,131,227
"278","chr1",10875595,10875622,28,9,127,164
"279","chr1",10891804,10891822,19,78,25,122
"280","chr1",10929932,10929953,22,14,6,42
"281","chr1",10946478,10946495,18,15,53,86
"282","chr1",10983046,10983090,45,14,74,133
"283","chr1",11002827,11002874,48,86,6,140
"284","chr1",11008945,11008968,24,15,3,42
"285","chr1",11012295,11012313,19,81,123,223
"286","chr1",11033927,11033966,40,23,80,143
"287","chr1",11033966,11033986,21,43,41,105
"288","chr1",11055121,11055138,18,29,93,140
"289","chr1",11059944,11059966,23,47,19,89
"290","chr1",11061214,11061233,20,1,131,152
"291","chr1",11073878,11073900,23,9,9,41
"292","chr1",11119574,11119599,26,148,3,177
"293","chr1",11202905,11202926,22,8,127,157
"294","chr1",11334316,11334338,23,67,6,96
"295","chr1",11354139,11354166,28,91,6,125
"296","chr1",11370494,11370528,35,75,116,226
"297","chr1",11391979,11392003,25,93,52,170
"298","chr1",11418016,11418053,38,70,74,182
"299","chr1",11462876,11462894,19,19,120,158
"300","chr1",11491610,11491638,29,149,75,253
"301","chr1",11496366,11496393,28,34,97,159
"302","chr1",11502154,11502189,36,121,81,238
"303","chr1",11544321,11544345,25,133,34,192
"304","chr1",11654463,11654489,27,100,59,186
"305","chr1",11662938,11662974,37,8,76,121
"306","chr1",11665555,11665578,24,76,11,111
"307","chr1",11690924,11690961,38,119,63,220
"308","chr1",11760813,11760857,45,8,92,145
"309","chr1",11858855,11858892,38,5,5,48
"310","chr1",11896057,11896075,19,112,6,137
"311","chr1",11898029,11898066,38,34,6,78
"312","chr1",11901850,11901868,19,10,27,56
"313","chr1",11909480,11909506,27,143,6,176
"314","chr1",11941225,11941258,34,35,116,185
"315","chr1",11943287,11943313,27,7,146,180
"316","chr1",11980519,11980536,18,44,103,165
"317","chr1",11991924,11991952,29,68,6,103
"318","chr1",12016260,12016277,18,67,43,128
"319","chr1",12018935,12018971,37,148,27,212
"320","chr1",12023060,12023081,22,8,97,127
"321","chr1",12040097,12040115,19,11,71,101
"322","chr1",12050318,12050335,18,37,143,198
"323","chr1",12124830,12124887,58,14,66,138
"324","chr1",12166933,12166950,18,27,144,189
"325","chr1",12198660,12198684,25,52,136,213
"326","chr1",12242938,12242971,34,9,9,52
"327","chr1",12275221,12275245,25,125,40,190
"328","chr1",12508543,12508565,23,82,30,135
"329","chr1",12516070,12516088,19,8,7,34
"330","chr1",12558225,12558244,20,88,36,144
"331","chr1",12571527,12571547,21,68,120,209
"332","chr1",12617515,12617540,26,79,1,106
"333","chr1",12648347,12648408,62,70,68,200
"334","chr1",12837995,12838050,56,114,6,176
"335","chr1",13232644,13232665,22,5,8,35
"336","chr1",13232649,13232682,34,22,3,59
"337","chr1",13443299,13443337,39,63,13,115
"338","chr1",13530989,13531008,20,78,26,124
"339","chr1",13649997,13650016,20,27,5,52
"340","chr1",13671959,13671981,23,6,145,174
"341","chr1",13808464,13808483,20,78,33,131
"342","chr1",14598736,14598759,24,21,47,92
"343","chr1",14628843,14628863,21,75,122,218
"344","chr1",14734291,14734326,36,81,87,204
"345","chr1",14776934,14776955,22,13,76,111
"346","chr1",14776984,14777019,36,77,26,139
"347","chr1",14798743,14798767,25,65,2,92
"348","chr1",14801667,14801702,36,77,10,123
"349","chr1",14894739,14894767,29,11,7,47
"350","chr1",14905846,14905875,30,136,32,198
"351","chr1",14924048,14924073,26,2,45,73
"352","chr1",14924583,14924602,20,37,18,75
"353","chr1",15005456,15005476,21,120,27,168
"354","chr1",15037585,15037611,27,15,27,69
"355","chr1",15041323,15041354,32,125,84,241
"356","chr1",15315486,15315503,18,76,125,219
"357","chr1",15390345,15390367,23,35,7,65
"358","chr1",15430874,15430897,24,8,4,36
"359","chr1",15436456,15436474,19,92,21,132
"360","chr1",15521157,15521176,20,133,6,159
"361","chr1",15572353,15572376,24,75,142,241
"362","chr1",15590522,15590553,32,12,72,116
"363","chr1",15617632,15617655,24,141,83,248
"364","chr1",15619451,15619483,33,80,120,233
"365","chr1",15675435,15675453,19,23,72,114
"366","chr1",15684501,15684544,44,4,6,54
"367","chr1",15686649,15686666,18,8,142,168
"368","chr1",15704284,15704323,40,43,116,199
"369","chr1",15738782,15738826,45,79,77,201
"370","chr1",15742427,15742444,18,45,63,126
"371","chr1",15760221,15760238,18,138,9,165
"372","chr1",15765306,15765328,23,54,48,125
"373","chr1",15771240,15771264,25,76,10,111
"374","chr1",15792684,15792722,39,107,56,202
"375","chr1",15798701,15798723,23,9,5,37
"376","chr1",15807579,15807601,23,142,81,246
"377","chr1",15823843,15823865,23,44,65,132
"378","chr1",15847934,15847981,48,58,21,127
"379","chr1",15865421,15865439,19,7,27,53
"380","chr1",15872223,15872244,22,81,49,152
"381","chr1",15894920,15894939,20,75,58,153
"382","chr1",16017889,16017916,28,90,14,132
"383","chr1",16114503,16114526,24,34,72,130
"384","chr1",16154757,16154780,24,117,73,214
"385","chr1",16207884,16207902,19,26,103,148
"386","chr1",16210274,16210291,18,96,58,172
"387","chr1",16215420,16215462,43,7,40,90
"388","chr1",16284972,16284990,19,139,70,228
"389","chr1",16310194,16310211,18,145,7,170
"390","chr1",16310975,16311002,28,105,136,269
"391","chr1",16331423,16331452,30,131,64,225
"392","chr1",16345848,16345865,18,85,73,176
"393","chr1",16360970,16361013,44,15,145,204
"394","chr1",16415551,16415569,19,68,30,117
"395","chr1",16438371,16438419,49,44,60,153
"396","chr1",16483130,16483154,25,24,4,53
"397","chr1",16499362,16499385,24,1,41,66
"398","chr1",16500081,16500105,25,18,75,118
"399","chr1",16518876,16518898,23,130,74,227
"400","chr1",16586341,16586359,19,83,139,241
"401","chr1",16637555,16637575,21,141,123,285
"402","chr1",16658233,16658267,35,37,7,79
"403","chr1",16692440,16692482,43,12,128,183
"404","chr1",16699527,16699550,24,9,52,85
"405","chr1",16708314,16708337,24,76,43,143
"406","chr1",16733500,16733540,41,61,96,198
"407","chr1",16749201,16749235,35,9,35,79
"408","chr1",16862948,16862970,23,79,36,138
"409","chr1",16937353,16937375,23,30,119,172
"410","chr1",16939210,16939227,18,145,12,175
"411","chr1",16940221,16940239,19,7,27,53
"412","chr1",16961206,16961230,25,15,43,83
"413","chr1",16962535,16962561,27,43,74,144
"414","chr1",16994198,16994241,44,67,119,230
"415","chr1",16994219,16994249,31,75,98,204
"416","chr1",17017007,17017028,22,67,6,95
"417","chr1",17049648,17049677,30,23,105,158
"418","chr1",17422027,17422062,36,30,54,120
"419","chr1",17432960,17432988,29,48,4,81
"420","chr1",17458257,17458275,19,75,75,169
"421","chr1",17478691,17478714,24,4,1,29
"422","chr1",17484644,17484661,18,9,143,170
"423","chr1",17513032,17513052,21,63,71,155
"424","chr1",17513049,17513067,19,78,54,151
"425","chr1",17521185,17521210,26,4,132,162
"426","chr1",17608030,17608051,22,9,48,79
"427","chr1",17680075,17680110,36,138,16,190
"428","chr1",17731989,17732019,31,12,4,47
"429","chr1",17743324,17743347,24,60,146,230
"430","chr1",17748842,17748877,36,27,4,67
"431","chr1",17800584,17800610,27,74,88,189
"432","chr1",17894951,17894986,36,108,73,217
"433","chr1",18001625,18001660,36,14,7,57
"434","chr1",18108986,18109015,30,37,123,190
"435","chr1",18208549,18208570,22,29,75,126
"436","chr1",18471864,18471896,33,75,58,166
"437","chr1",18630804,18630834,31,4,13,48
"438","chr1",18646873,18646896,24,35,28,87
"439","chr1",18678083,18678123,41,141,5,187
"440","chr1",18717037,18717061,25,10,38,73
"441","chr1",18728698,18728715,18,145,6,169
"442","chr1",18822471,18822512,42,120,125,287
"443","chr1",18866623,18866643,21,37,62,120
"444","chr1",18956232,18956278,47,17,15,79
"445","chr1",19025213,19025235,23,12,74,109
"446","chr1",19235702,19235733,32,67,73,172
"447","chr1",19262640,19262657,18,145,100,263
"448","chr1",19335613,19335630,18,145,35,198
"449","chr1",19338803,19338820,18,32,93,143
"450","chr1",19460575,19460597,23,126,12,161
"451","chr1",19485728,19485760,33,1,19,53
"452","chr1",19486001,19486032,32,63,76,171
"453","chr1",19560966,19560983,18,5,74,97
"454","chr1",19635632,19635649,18,10,141,169
"455","chr1",19635645,19635673,29,34,128,191
"456","chr1",19637341,19637368,28,13,5,46
"457","chr1",19799913,19799931,19,72,26,117
"458","chr1",19911389,19911407,19,76,72,167
"459","chr1",20206892,20206911,20,33,143,196
"460","chr1",20444945,20444963,19,78,42,139
"461","chr1",20485582,20485599,18,16,29,63
"462","chr1",20523001,20523027,27,4,8,39
"463","chr1",20553764,20553791,28,12,98,138
"464","chr1",20556384,20556418,35,18,137,190
"465","chr1",20576342,20576366,25,126,43,194
"466","chr1",20669538,20669589,52,51,5,108
"467","chr1",21072383,21072420,38,7,41,86
"468","chr1",21147326,21147348,23,66,10,99
"469","chr1",21176227,21176280,54,59,13,126
"470","chr1",21176568,21176611,44,15,11,70
"471","chr1",21185641,21185682,42,72,123,237
"472","chr1",21191867,21191896,30,8,83,121
"473","chr1",21287527,21287555,29,121,42,192
"474","chr1",21319348,21319387,40,25,71,136
"475","chr1",21348512,21348534,23,17,9,49
"476","chr1",21372211,21372231,21,10,67,98
"477","chr1",21401830,21401877,48,26,73,147
"478","chr1",21404257,21404278,22,21,76,119
"479","chr1",21509299,21509360,62,91,11,164
"480","chr1",21573437,21573481,45,14,74,133
"481","chr1",21580731,21580764,34,96,2,132
"482","chr1",21603938,21603961,24,33,25,82
"483","chr1",21622613,21622633,21,86,5,112
"484","chr1",21637973,21637992,20,136,33,189
"485","chr1",21638149,21638175,27,13,8,48
"486","chr1",21651904,21651924,21,15,58,94
"487","chr1",21796721,21796751,31,91,2,124
"488","chr1",21817858,21817877,20,28,122,170
"489","chr1",22009365,22009389,25,64,5,94
"490","chr1",22051826,22051862,37,18,68,123
"491","chr1",22142263,22142280,18,6,130,154
"492","chr1",22142804,22142825,22,30,10,62
"493","chr1",22143123,22143159,37,4,39,80
"494","chr1",22143155,22143200,46,21,7,74
"495","chr1",22156890,22156913,24,55,18,97
"496","chr1",22158344,22158361,18,6,6,30
"497","chr1",22341239,22341257,19,81,82,182
"498","chr1",22374768,22374801,34,23,22,79
"499","chr1",22412869,22412908,40,2,12,54
"500","chr1",22558689,22558712,24,7,38,69
"501","chr1",22563455,22563474,20,4,15,39
"502","chr1",22563614,22563635,22,138,51,211
"503","chr1",22563736,22563762,27,29,35,91
"504","chr1",22580128,22580154,27,73,121,221
"505","chr1",22629513,22629535,23,130,38,191
"506","chr1",22644065,22644090,26,57,105,188
"507","chr1",22711052,22711070,19,25,9,53
"508","chr1",22819206,22819250,45,107,3,155
"509","chr1",22864035,22864058,24,3,69,96
"510","chr1",22928136,22928156,21,110,74,205
"511","chr1",22991871,22991922,52,49,5,106
"512","chr1",23008091,23008125,35,77,74,186
"513","chr1",23218509,23218542,34,7,76,117
"514","chr1",23235836,23235899,64,70,61,195
"515","chr1",23241251,23241273,23,100,73,196
"516","chr1",23251029,23251053,25,118,4,147
"517","chr1",23355040,23355058,19,58,146,223
"518","chr1",23488969,23488991,23,74,16,113
"519","chr1",23525356,23525378,23,1,88,112
"520","chr1",23531239,23531266,28,50,13,91
"521","chr1",23541612,23541630,19,20,74,113
"522","chr1",23582564,23582584,21,35,76,132
"523","chr1",23586198,23586219,22,76,61,159
"524","chr1",23623054,23623081,28,10,76,114
"525","chr1",23637189,23637212,24,14,13,51
"526","chr1",23690487,23690507,21,29,143,193
"527","chr1",23691421,23691440,20,18,4,42
"528","chr1",23725296,23725316,21,77,27,125
"529","chr1",23766407,23766443,37,26,42,105
"530","chr1",23800274,23800297,24,88,81,193
"531","chr1",23809218,23809239,22,10,133,165
"532","chr1",23809239,23809257,19,9,112,140
"533","chr1",23826754,23826811,58,34,48,140
"534","chr1",23839411,23839433,23,14,139,176
"535","chr1",23898336,23898359,24,8,146,178
"536","chr1",23902787,23902805,19,103,23,145
"537","chr1",23903080,23903098,19,1,56,76
"538","chr1",23918040,23918063,24,18,4,46
"539","chr1",23925969,23925995,27,126,51,204
"540","chr1",24099864,24099882,19,4,18,41
"541","chr1",24219066,24219331,266,111,112,489
"542","chr1",24259550,24259595,46,112,6,164
"543","chr1",24401686,24401708,23,119,27,169
"544","chr1",24500397,24500414,18,102,6,126
"545","chr1",24503164,24503188,25,54,23,102
"546","chr1",24503214,24503237,24,103,1,128
"547","chr1",24532949,24532975,27,32,9,68
"548","chr1",24538572,24538591,20,32,75,127
"549","chr1",24583718,24583738,21,74,72,167
"550","chr1",24613464,24613490,27,77,33,137
"551","chr1",24624886,24624908,23,77,10,110
"552","chr1",24712040,24712064,25,46,6,77
"553","chr1",24728759,24728777,19,65,1,85
"554","chr1",24745494,24745520,27,7,98,132
"555","chr1",24755437,24755455,19,91,76,186
"556","chr1",24813402,24813436,35,76,85,196
"557","chr1",24833827,24833844,18,12,3,33
"558","chr1",24859752,24859772,21,68,124,213
"559","chr1",24859773,24859811,39,107,103,249
"560","chr1",24969660,24969682,23,83,35,141
"561","chr1",25105741,25105761,21,35,75,131
"562","chr1",25245991,25246010,20,114,70,204
"563","chr1",25256148,25256166,19,115,144,278
"564","chr1",25406311,25406329,19,75,125,219
"565","chr1",25430046,25430070,25,35,102,162
"566","chr1",25547483,25547528,46,38,98,182
"567","chr1",25616804,25616838,35,20,12,67
"568","chr1",25681227,25681268,42,104,73,219
"569","chr1",25690289,25690310,22,8,39,69
"570","chr1",25700127,25700149,23,29,33,85
"571","chr1",25792365,25792404,40,131,45,216
"572","chr1",25792573,25792594,22,16,1,39
"573","chr1",25800118,25800186,69,65,41,175
"574","chr1",25868710,25868730,21,31,91,143
"575","chr1",25906067,25906090,24,53,137,214
"576","chr1",25954458,25954498,41,12,73,126
"577","chr1",25970478,25970500,23,116,56,195
"578","chr1",25991892,25991914,23,59,7,89
"579","chr1",26006634,26006668,35,27,21,83
"580","chr1",26019001,26019029,29,9,58,96
"581","chr1",26111186,26111205,20,85,55,160
"582","chr1",26117744,26117765,22,109,73,204
"583","chr1",26164401,26164428,28,37,57,122
"584","chr1",26204578,26204599,22,86,66,174
"585","chr1",26264981,26265003,23,10,146,179
"586","chr1",26316126,26316151,26,124,143,293
"587","chr1",26373388,26373411,24,80,74,178
"588","chr1",26390571,26390591,21,13,6,40
"589","chr1",26396078,26396097,20,77,135,232
"590","chr1",26409287,26409316,30,18,110,158
"591","chr1",26410378,26410416,39,53,135,227
"592","chr1",26410666,26410699,34,13,109,156
"593","chr1",26432225,26432247,23,65,105,193
"594","chr1",26434821,26434840,20,35,130,185
"595","chr1",26435431,26435455,25,76,24,125
"596","chr1",26451622,26451646,25,76,144,245
"597","chr1",26488459,26488668,210,19,62,291
"598","chr1",26508879,26508906,28,69,113,210
"599","chr1",26511542,26511559,18,75,115,208
"600","chr1",26517325,26517392,68,36,98,202
"601","chr1",26523257,26523282,26,118,3,147
"602","chr1",26637352,26637391,40,75,82,197
"603","chr1",26643040,26643058,19,25,4,48
"604","chr1",26695951,26696015,65,12,69,146
"605","chr1",26696167,26696217,51,36,8,95
"606","chr1",26696650,26696681,32,66,65,163
"607","chr1",26719942,26719960,19,4,5,28
"608","chr1",26738867,26738893,27,64,2,93
"609","chr1",26749169,26749186,18,44,70,132
"610","chr1",26785750,26785776,27,93,36,156
"611","chr1",26826953,26826983,31,15,34,80
"612","chr1",26830771,26830800,30,76,43,149
"613","chr1",26974635,26974655,21,6,5,32
"614","chr1",26992646,26992665,20,8,146,174
"615","chr1",27013705,27013731,27,5,21,53
"616","chr1",27015953,27015971,19,122,5,146
"617","chr1",27024819,27024839,21,76,84,181
"618","chr1",27030165,27030192,28,7,72,107
"619","chr1",27032612,27032632,21,9,136,166
"620","chr1",27075553,27075574,22,77,98,197
"621","chr1",27128658,27128675,18,13,72,103
"622","chr1",27147112,27147143,32,70,31,133
"623","chr1",27156779,27156802,24,145,6,175
"624","chr1",27169731,27169756,26,76,54,156
"625","chr1",27175135,27175154,20,69,8,97
"626","chr1",27191209,27191227,19,7,140,166
"627","chr1",27211491,27211518,28,7,3,38
"628","chr1",27232643,27232664,22,8,122,152
"629","chr1",27396162,27396186,25,8,77,110
"630","chr1",27441754,27441776,23,145,6,174
"631","chr1",27477899,27477936,38,114,6,158
"632","chr1",27477908,27477945,38,123,65,226
"633","chr1",27489349,27489391,43,36,115,194
"634","chr1",27489454,27489482,29,127,10,166
"635","chr1",27499863,27499888,26,52,72,150
"636","chr1",27527865,27527897,33,3,122,158
"637","chr1",27548842,27548862,21,73,92,186
"638","chr1",27551504,27551521,18,37,113,168
"639","chr1",27603146,27603188,43,36,113,192
"640","chr1",27625941,27625968,28,70,122,220
"641","chr1",27632120,27632142,23,64,33,120
"642","chr1",27640683,27640700,18,149,5,172
"643","chr1",27647882,27647927,46,9,42,97
"644","chr1",27675265,27675290,26,7,32,65
"645","chr1",27677638,27677671,34,96,11,141
"646","chr1",27679269,27679295,27,76,46,149
"647","chr1",27704937,27704960,24,129,7,160
"648","chr1",27920852,27920870,19,7,26,52
"649","chr1",27985257,27985276,20,121,103,244
"650","chr1",28097297,28097325,29,8,115,152
"651","chr1",28131550,28131575,26,39,6,71
"652","chr1",28140912,28140938,27,71,77,175
"653","chr1",28149326,28149352,27,9,23,59
"654","chr1",28168126,28168144,19,29,75,123
"655","chr1",28201790,28201823,34,29,5,68
"656","chr1",28247127,28247158,32,3,35,70
"657","chr1",28252909,28252928,20,69,134,223
"658","chr1",28260120,28260180,61,21,35,117
"659","chr1",28290345,28290365,21,8,10,39
"660","chr1",28295203,28295240,38,145,67,250
"661","chr1",28300759,28300789,31,12,39,82
"662","chr1",28329281,28329303,23,76,16,115
"663","chr1",28338150,28338167,18,76,69,163
"664","chr1",28351971,28352000,30,14,30,74
"665","chr1",28357782,28357822,41,143,70,254
"666","chr1",28367174,28367205,32,73,77,182
"667","chr1",28448590,28448612,23,77,34,134
"668","chr1",28505202,28505231,30,149,6,185
"669","chr1",28523028,28523049,22,76,35,133
"670","chr1",28547505,28547525,21,12,73,106
"671","chr1",28551889,28551911,23,36,63,122
"672","chr1",28608176,28608196,21,146,27,194
"673","chr1",28615679,28615712,34,105,74,213
"674","chr1",28627392,28627409,18,145,2,165
"675","chr1",28633165,28633184,20,76,142,238
"676","chr1",28650155,28650173,19,23,75,117
"677","chr1",28667043,28667075,33,146,38,217
"678","chr1",28674709,28674736,28,8,131,167
"679","chr1",28676731,28676751,21,113,69,203
"680","chr1",28678888,28678926,39,43,9,91
"681","chr1",28723107,28723131,25,53,74,152
"682","chr1",28731747,28731767,21,8,119,148
"683","chr1",28764255,28764287,33,7,141,181
"684","chr1",28777367,28777395,29,66,5,100
"685","chr1",28807821,28807867,47,112,73,232
"686","chr1",28823191,28823214,24,8,8,40
"687","chr1",28842023,28842047,25,45,145,215
"688","chr1",28851856,28851880,25,142,21,188
"689","chr1",28858100,28858130,31,7,112,150
"690","chr1",28922627,28922644,18,7,48,73
"691","chr1",29011123,29011152,30,82,69,181
"692","chr1",29041134,29041188,55,138,76,269
"693","chr1",29108544,29108574,31,7,49,87
"694","chr1",29123931,29123957,27,36,100,163
"695","chr1",29133096,29133150,55,48,9,112
"696","chr1",29133123,29133245,123,10,49,182
"697","chr1",29138161,29138222,62,36,66,164
"698","chr1",29149169,29149202,34,144,10,188
"699","chr1",29168192,29168210,19,35,133,187
"700","chr1",29236526,29236553,28,7,29,64
"701","chr1",29236548,29236591,44,8,7,59
"702","chr1",29241581,29241606,26,70,38,134
"703","chr1",29442835,29442853,19,7,42,68
"704","chr1",29698896,29698918,23,47,21,91
"705","chr1",30048351,30048416,66,19,104,189
"706","chr1",30249999,30250045,47,78,55,180
"707","chr1",30330439,30330465,27,79,144,250
"708","chr1",30366356,30366420,65,87,8,160
"709","chr1",30704436,30704470,35,142,108,285
"710","chr1",30727123,30727147,25,76,12,113
"711","chr1",30826498,30826523,26,4,26,56
"712","chr1",30908467,30908485,19,58,8,85
"713","chr1",30908506,30908548,43,19,4,66
"714","chr1",30908590,30908626,37,46,71,154
"715","chr1",30908784,30908803,20,5,46,71
"716","chr1",30917369,30917396,28,146,6,180
"717","chr1",30924883,30924905,23,4,121,148
"718","chr1",30961196,30961217,22,68,71,161
"719","chr1",31057406,31057441,36,59,3,98
"720","chr1",31089453,31089478,26,76,27,129
"721","chr1",31100199,31100217,19,69,75,163
"722","chr1",31102324,31102341,18,25,7,50
"723","chr1",31132120,31132143,24,13,42,79
"724","chr1",31145081,31145101,21,10,74,105
"725","chr1",31145388,31145407,20,141,4,165
"726","chr1",31154953,31154973,21,56,25,102
"727","chr1",31155124,31155145,22,28,7,57
"728","chr1",31160611,31160629,19,10,22,51
"729","chr1",31168151,31168174,24,9,27,60
"730","chr1",31181526,31181558,33,28,125,186
"731","chr1",31200459,31200477,19,103,107,229
"732","chr1",31413154,31413185,32,17,53,102
"733","chr1",31503910,31503936,27,69,131,227
"734","chr1",31623297,31623332,36,50,39,125
"735","chr1",31677069,31677103,35,8,56,99
"736","chr1",31764067,31764098,32,11,52,95
"737","chr1",31764108,31764128,21,41,11,73
"738","chr1",31938062,31938102,41,108,35,184
"739","chr1",31938145,31938164,20,11,23,54
"740","chr1",31988298,31988318,21,69,6,96
"741","chr1",32068085,32068109,25,146,5,176
"742","chr1",32071323,32071350,28,7,76,111
"743","chr1",32071644,32071668,25,144,68,237
"744","chr1",32087320,32087341,22,147,72,241
"745","chr1",32093400,32093429,30,8,144,182
"746","chr1",32093802,32093835,34,7,55,96
"747","chr1",32094118,32094144,27,8,11,46
"748","chr1",32110057,32110079,23,73,43,139
"749","chr1",32124843,32124860,18,25,113,156
"750","chr1",32183424,32183445,22,9,10,41
"751","chr1",32213504,32213526,23,8,143,174
"752","chr1",32270693,32270718,26,97,145,268
"753","chr1",32288976,32289027,52,114,141,307
"754","chr1",32293321,32293339,19,135,74,228
"755","chr1",32335865,32335885,21,31,2,54
"756","chr1",32336455,32336472,18,98,112,228
"757","chr1",32341249,32341280,32,104,19,155
"758","chr1",32343283,32343324,42,72,52,166
"759","chr1",32463686,32463709,24,23,82,129
"760","chr1",32500046,32500069,24,13,8,45
"761","chr1",32500068,32500096,29,40,54,123
"762","chr1",32500491,32500509,19,93,125,237
"763","chr1",32500830,32500852,23,55,12,90
"764","chr1",32553887,32553905,19,135,73,227
"765","chr1",32586003,32586024,22,136,6,164
"766","chr1",32644705,32644726,22,87,24,133
"767","chr1",32698215,32698236,22,147,136,305
"768","chr1",32738942,32738961,20,127,75,222
"769","chr1",32750809,32750827,19,34,142,195
"770","chr1",32762979,32762998,20,5,54,79
"771","chr1",32770013,32770030,18,1,52,71
"772","chr1",32778727,32778755,29,44,125,198
"773","chr1",32838334,32838363,30,84,74,188
"774","chr1",32845008,32845042,35,8,63,106
"775","chr1",32903260,32903284,25,145,27,197
"776","chr1",32903998,32904046,49,63,74,186
"777","chr1",32959882,32959901,20,77,27,124
"778","chr1",32963719,32963743,25,133,5,163
"779","chr1",32976486,32976532,47,76,33,156
"780","chr1",33114341,33114371,31,8,20,59
"781","chr1",33256167,33256200,34,1,38,73
"782","chr1",33256451,33256473,23,18,26,67
"783","chr1",33256540,33256581,42,64,123,229
"784","chr1",33256827,33256860,34,26,68,128
"785","chr1",33256904,33256945,42,15,23,80
"786","chr1",33257395,33257429,35,48,97,180
"787","chr1",33349937,33349993,57,24,9,90
"788","chr1",33430623,33430650,28,67,17,112
"789","chr1",33432677,33432699,23,5,32,60
"790","chr1",33648362,33648379,18,53,74,145
"791","chr1",33934834,33934854,21,145,83,249
"792","chr1",33992704,33992728,25,78,36,139
"793","chr1",34129655,34129683,29,36,3,68
"794","chr1",34259493,34259521,29,71,68,168
"795","chr1",34327608,34327628,21,22,65,108
"796","chr1",34381497,34381519,23,52,43,118
"797","chr1",34409428,34409460,33,43,25,101
"798","chr1",34904680,34904714,35,51,144,230
"799","chr1",34929604,34929630,27,115,3,145
"800","chr1",34929688,34929723,36,31,6,73
"801","chr1",34929739,34929773,35,6,70,111
"802","chr1",35092547,35092644,98,75,139,312
"803","chr1",35149604,35149622,19,133,74,226
"804","chr1",35207854,35207893,40,4,6,50
"805","chr1",35216595,35216624,30,78,1,109
"806","chr1",35219107,35219126,20,77,6,103
"807","chr1",35261048,35261072,25,7,48,80
"808","chr1",35434084,35434104,21,10,95,126
"809","chr1",35494451,35494489,39,124,4,167
"810","chr1",35521652,35521687,36,9,56,101
"811","chr1",35629811,35629840,30,105,73,208
"812","chr1",35641194,35641212,19,45,70,134
"813","chr1",35669642,35669659,18,4,75,97
"814","chr1",35719761,35719789,29,91,6,126
"815","chr1",35730568,35730591,24,23,74,121
"816","chr1",35787469,35787498,30,77,35,142
"817","chr1",35794251,35794273,23,8,16,47
"818","chr1",35805130,35805157,28,8,89,125
"819","chr1",35808150,35808168,19,63,3,85
"820","chr1",35808171,35808196,26,25,21,72
"821","chr1",35808339,35808363,25,20,33,78
"822","chr1",35825859,35825877,19,82,5,106
"823","chr1",35829841,35829866,26,135,82,243
"824","chr1",35867673,35867694,22,6,135,163
"825","chr1",35878076,35878098,23,73,60,156
"826","chr1",35900912,35900930,19,7,72,98
"827","chr1",36120778,36120808,31,14,44,89
"828","chr1",36129413,36129431,19,125,8,152
"829","chr1",36131621,36131644,24,73,44,141
"830","chr1",36156309,36156330,22,11,14,47
"831","chr1",36156365,36156384,20,65,14,99
"832","chr1",36198356,36198377,22,3,14,39
"833","chr1",36202861,36202886,26,76,18,120
"834","chr1",36239258,36239277,20,69,91,180
"835","chr1",36262960,36262983,24,29,75,128
"836","chr1",36274626,36274649,24,75,115,214
"837","chr1",36318899,36318941,43,139,16,198
"838","chr1",36322545,36322568,24,105,86,215
"839","chr1",36323652,36323675,24,48,20,92
"840","chr1",36385861,36385884,24,62,18,104
"841","chr1",36441751,36441772,22,5,7,34
"842","chr1",36452258,36452277,20,3,35,58
"843","chr1",36622378,36622395,18,76,20,114
"844","chr1",36684867,36684888,22,13,54,89
"845","chr1",36684886,36684927,42,52,35,129
"846","chr1",36708165,36708193,29,101,50,180
"847","chr1",36823473,36823501,29,61,7,97
"848","chr1",37010728,37010752,25,69,40,134
"849","chr1",37474706,37474752,47,16,50,113
"850","chr1",37516929,37516952,24,7,74,105
"851","chr1",37585060,37585077,18,77,96,191
"852","chr1",37765671,37765718,48,122,106,276
"853","chr1",37793761,37793795,35,128,7,170
"854","chr1",37794378,37794410,33,122,49,204
"855","chr1",37871458,37871483,26,58,6,90
"856","chr1",37876704,37876723,20,142,33,195
"857","chr1",37917309,37917339,31,6,54,91
"858","chr1",37939435,37939461,27,7,2,36
"859","chr1",37962604,37962624,21,108,73,202
"860","chr1",37967678,37967710,33,77,42,152
"861","chr1",37990773,37990790,18,8,6,32
"862","chr1",38005138,38005160,23,13,38,74
"863","chr1",38044596,38044623,28,40,76,144
"864","chr1",38045412,38045429,18,5,103,126
"865","chr1",38046632,38046662,31,106,6,143
"866","chr1",38052713,38052735,23,128,66,217
"867","chr1",38054961,38055005,45,41,29,115
"868","chr1",38355798,38355820,23,72,66,161
"869","chr1",38859678,38859703,26,63,79,168
"870","chr1",38859718,38859767,50,32,39,121
"871","chr1",38870170,38870190,21,138,6,165
"872","chr1",38884574,38884625,52,47,23,122
"873","chr1",38956561,38956585,25,57,143,225
"874","chr1",38977647,38977678,32,16,120,168
"875","chr1",38984230,38984248,19,76,12,107
"876","chr1",39055715,39055742,28,139,55,222
"877","chr1",39056166,39056184,19,130,73,222
"878","chr1",39111367,39111397,31,6,71,108
"879","chr1",39121436,39121467,32,12,138,182
"880","chr1",39149530,39149587,58,76,71,205
"881","chr1",39175942,39175960,19,77,17,113
"882","chr1",39176110,39176127,18,76,74,168
"883","chr1",39194318,39194371,54,8,127,189
"884","chr1",39247069,39247090,22,8,143,173
"885","chr1",39337563,39337583,21,75,83,179
"886","chr1",39415526,39415543,18,34,52,104
"887","chr1",39417714,39417749,36,27,75,138
"888","chr1",39559788,39559806,19,8,45,72
"889","chr1",39601548,39601580,33,27,22,82
"890","chr1",39601580,39601603,24,50,42,116
"891","chr1",39606713,39606730,18,123,6,147
"892","chr1",39606737,39606754,18,147,50,215
"893","chr1",39613138,39613168,31,76,3,110
"894","chr1",39615588,39615608,21,76,79,176
"895","chr1",39639684,39639712,29,96,2,127
"896","chr1",39642154,39642178,25,114,74,213
"897","chr1",39676139,39676157,19,141,4,164
"898","chr1",39696171,39696201,31,60,7,98
"899","chr1",39788862,39788879,18,46,7,71
"900","chr1",39838653,39838675,23,30,129,182
"901","chr1",39864598,39864618,21,145,17,183
"902","chr1",39884636,39884658,23,10,13,46
"903","chr1",40022350,40022377,28,69,16,113
"904","chr1",40035892,40035909,18,144,45,207
"905","chr1",40159685,40159711,27,9,44,80
"906","chr1",40169623,40169645,23,11,67,101
"907","chr1",40185657,40185678,22,145,39,206
"908","chr1",40198302,40198320,19,6,12,37
"909","chr1",40287057,40287083,27,7,120,154
"910","chr1",40488041,40488058,18,137,80,235
"911","chr1",40523006,40523031,26,74,68,168
"912","chr1",40534237,40534258,22,8,35,65
"913","chr1",40796916,40796952,37,29,76,142
"914","chr1",40819127,40819167,41,71,104,216
"915","chr1",40865024,40865057,34,31,125,190
"916","chr1",40885576,40885605,30,16,67,113
"917","chr1",41150502,41150525,24,18,75,117
"918","chr1",41361528,41361554,27,94,66,187
"919","chr1",41442030,41442063,34,143,6,183
"920","chr1",41494040,41494058,19,56,9,84
"921","chr1",41662160,41662202,43,11,35,89
"922","chr1",41753671,41753709,39,19,3,61
"923","chr1",41888203,41888225,23,29,143,195
"924","chr1",41918108,41918133,26,19,15,60
"925","chr1",42086755,42086786,32,69,77,178
"926","chr1",42373632,42373650,19,8,143,170
"927","chr1",42413134,42413155,22,83,74,179
"928","chr1",42432225,42432242,18,105,141,264
"929","chr1",42520635,42520658,24,44,7,75
"930","chr1",42629970,42629992,23,76,5,104
"931","chr1",42723060,42723081,22,75,27,124
"932","chr1",42749757,42749776,20,57,85,162
"933","chr1",42834544,42834570,27,73,31,131
"934","chr1",42864328,42864357,30,84,7,121
"935","chr1",42924886,42924923,38,28,15,81
"936","chr1",42956408,42956433,26,75,11,112
"937","chr1",42958185,42958208,24,43,56,123
"938","chr1",43093977,43094011,35,7,4,46
"939","chr1",43159928,43159954,27,137,7,171
"940","chr1",43231700,43231718,19,77,25,121
"941","chr1",43353448,43353477,30,78,75,183
"942","chr1",43366586,43366606,21,102,6,129
"943","chr1",43367822,43367873,52,47,27,126
"944","chr1",43369496,43369521,26,147,9,182
"945","chr1",43453838,43453868,31,74,51,156
"946","chr1",43530912,43530977,66,24,45,135
"947","chr1",43531830,43531851,22,133,57,212
"948","chr1",43731558,43731578,21,37,69,127
"949","chr1",43802923,43802951,29,84,52,165
"950","chr1",43979337,43979364,28,6,16,50
"951","chr1",44003749,44003772,24,56,5,85
"952","chr1",44022699,44022725,27,78,117,222
"953","chr1",44031167,44031203,37,34,99,170
"954","chr1",44148186,44148215,30,9,15,54
"955","chr1",44405378,44405402,25,109,134,268
"956","chr1",44405395,44405431,37,138,117,292
"957","chr1",44625018,44625058,41,120,29,190
"958","chr1",44645721,44645746,26,31,54,111
"959","chr1",44704835,44704852,18,8,122,148
"960","chr1",44714270,44714292,23,86,6,115
"961","chr1",44722904,44722924,21,145,27,193
"962","chr1",44726106,44726128,23,17,3,43
"963","chr1",44752134,44752156,23,12,131,166
"964","chr1",44789243,44789298,56,125,19,200
"965","chr1",44794206,44794228,23,25,74,122
"966","chr1",44801785,44801806,22,40,11,73
"967","chr1",44919884,44919901,18,37,75,130
"968","chr1",45044724,45044747,24,41,6,71
"969","chr1",45044747,45044849,103,143,51,297
"970","chr1",45206358,45206375,18,8,22,48
"971","chr1",45206725,45206743,19,128,109,256
"972","chr1",45224232,45224256,25,76,131,232
"973","chr1",45365678,45365696,19,76,146,241
"974","chr1",45472974,45473004,31,77,35,143
"975","chr1",45500866,45500887,22,113,4,139
"976","chr1",45520724,45520745,22,137,6,165
"977","chr1",45549183,45549202,20,7,74,101
"978","chr1",45558396,45558416,21,7,75,103
"979","chr1",45581002,45581027,26,6,5,37
"980","chr1",45625194,45625213,20,9,146,175
"981","chr1",45639881,45639899,19,126,6,151
"982","chr1",45777601,45777638,38,7,13,58
"983","chr1",45784017,45784048,32,72,28,132
"984","chr1",45977488,45977515,28,145,74,247
"985","chr1",46073787,46073806,20,28,30,78
"986","chr1",46133219,46133241,23,3,62,88
"987","chr1",46186665,46186683,19,11,67,97
"988","chr1",46198462,46198489,28,21,37,86
"989","chr1",46198519,46198555,37,87,22,146
"990","chr1",46305299,46305321,23,40,23,86
"991","chr1",46305752,46305784,33,39,8,80
"992","chr1",46311321,46311352,32,1,112,145
"993","chr1",46358088,46358112,25,7,69,101
"994","chr1",46383449,46383471,23,74,2,99
"995","chr1",46466507,46466524,18,18,20,56
"996","chr1",46468500,46468530,31,92,64,187
"997","chr1",46484806,46484824,19,37,68,124
"998","chr1",46489707,46489731,25,16,38,79
"999","chr1",46607372,46607403,32,88,43,163
"1000","chr1",46719046,46719069,24,28,20,72
"1001","chr1",47259286,47259305,20,73,145,238
"1002","chr1",47344914,47344933,20,7,29,56
"1003","chr1",47346864,47346881,18,88,84,190
"1004","chr1",47416494,47416511,18,84,142,244
"1005","chr1",47438930,47438947,18,3,71,92
"1006","chr1",47438990,47439014,25,70,11,106
"1007","chr1",47439163,47439181,19,69,82,170
"1008","chr1",47614335,47614366,32,6,30,68
"1009","chr1",47769167,47769192,26,17,4,47
"1010","chr1",47997482,47997521,40,122,10,172
"1011","chr1",47997587,47997622,36,10,49,95
"1012","chr1",48622476,48622500,25,75,26,126
"1013","chr1",49965940,49965959,20,76,14,110
"1014","chr1",50094743,50094781,39,78,121,238
"1015","chr1",50419102,50419130,29,68,78,175
"1016","chr1",50650285,50650305,21,127,5,153
"1017","chr1",50959885,50959910,26,43,57,126
"1018","chr1",50965058,50965100,43,30,2,75
"1019","chr1",50990613,50990646,34,78,76,188
"1020","chr1",51090270,51090290,21,67,6,94
"1021","chr1",51217837,51217862,26,8,135,169
"1022","chr1",51243432,51243451,20,71,113,204
"1023","chr1",51335395,51335412,18,78,25,121
"1024","chr1",51519375,51519401,27,48,98,173
"1025","chr1",52019356,52019383,28,73,75,176
"1026","chr1",52056281,52056301,21,62,91,174
"1027","chr1",52095770,52095788,19,66,4,89
"1028","chr1",52109004,52109022,19,76,18,113
"1029","chr1",52135120,52135137,18,74,48,140
"1030","chr1",52340905,52340933,29,8,70,107
"1031","chr1",52441445,52441466,22,25,81,128
"1032","chr1",52528185,52528208,24,12,68,104
"1033","chr1",52553109,52553145,37,50,82,169
"1034","chr1",52553129,52553149,21,54,62,137
"1035","chr1",52602726,52602750,25,41,6,72
"1036","chr1",52609588,52609626,39,129,60,228
"1037","chr1",52721255,52721279,25,8,129,162
"1038","chr1",52721560,52721580,21,45,12,78
"1039","chr1",52726473,52726502,30,31,109,170
"1040","chr1",52767020,52767317,298,116,62,476
"1041","chr1",53069872,53069895,24,14,146,184
"1042","chr1",53327840,53327874,35,25,5,65
"1043","chr1",53328007,53328045,39,70,27,136
"1044","chr1",53393108,53393126,19,114,67,200
"1045","chr1",53443840,53443862,23,76,121,220
"1046","chr1",53511636,53511658,23,20,73,116
"1047","chr1",53526517,53526612,96,16,59,171
"1048","chr1",53739170,53739203,34,65,14,113
"1049","chr1",53836452,53836469,18,32,122,172
"1050","chr1",53839606,53839633,28,132,2,162
"1051","chr1",53870161,53870189,29,9,142,180
"1052","chr1",53907914,53907936,23,142,71,236
"1053","chr1",54025864,54025906,43,69,30,142
"1054","chr1",54112178,54112216,39,78,123,240
"1055","chr1",54137664,54137705,42,45,36,123
"1056","chr1",54198028,54198056,29,107,6,142
"1057","chr1",54235449,54235473,25,76,143,244
"1058","chr1",54242953,54242976,24,84,71,179
"1059","chr1",54289021,54289057,37,76,73,186
"1060","chr1",54308601,54308618,18,145,74,237
"1061","chr1",54405867,54405909,43,146,43,232
"1062","chr1",54406037,54406060,24,103,27,154
"1063","chr1",54406111,54406134,24,33,108,165
"1064","chr1",54406358,54406388,31,5,7,43
"1065","chr1",54418434,54418469,36,119,74,229
"1066","chr1",54434133,54434151,19,77,6,102
"1067","chr1",54454793,54454810,18,5,143,166
"1068","chr1",54493456,54493480,25,127,76,228
"1069","chr1",54500511,54500537,27,6,7,40
"1070","chr1",54532903,54532924,22,8,124,154
"1071","chr1",54574030,54574047,18,38,5,61
"1072","chr1",54981618,54981640,23,55,6,84
"1073","chr1",55178677,55178731,55,135,66,256
"1074","chr1",55226998,55227015,18,35,139,192
"1075","chr1",56578777,56578805,29,148,141,318
"1076","chr1",56604645,56604679,35,4,61,100
"1077","chr1",56622323,56622341,19,148,74,241
"1078","chr1",56636706,56636735,30,8,8,46
"1079","chr1",57193382,57193404,23,76,1,100
"1080","chr1",57488402,57488422,21,41,7,69
"1081","chr1",58250462,58250493,32,138,80,250
"1082","chr1",58578886,58578920,35,8,143,186
"1083","chr1",58703212,58703242,31,146,23,200
"1084","chr1",59297041,59297079,39,69,113,221
"1085","chr1",59762067,59762085,19,54,39,112
"1086","chr1",59814721,59814748,28,10,142,180
"1087","chr1",61025883,61025905,23,72,96,191
"1088","chr1",61077360,61077382,23,27,119,169
"1089","chr1",61082219,61082261,43,84,72,199
"1090","chr1",61184116,61184176,61,12,89,162
"1091","chr1",61328724,61328741,18,9,8,35
"1092","chr1",61329382,61329400,19,76,109,204
"1093","chr1",61341061,61341081,21,8,142,171
"1094","chr1",61493809,61493832,24,4,79,107
"1095","chr1",61616435,61616489,55,38,70,163
"1096","chr1",61717191,61717218,28,145,29,202
"1097","chr1",61741193,61741218,26,10,142,178
"1098","chr1",61810700,61810746,47,49,3,99
"1099","chr1",61838522,61838543,22,29,75,126
"1100","chr1",61934113,61934136,24,8,65,97
"1101","chr1",61940716,61940757,42,49,74,165
"1102","chr1",62194168,62194212,45,27,12,84
"1103","chr1",62358750,62358768,19,15,4,38
"1104","chr1",62688272,62688305,34,49,5,88
"1105","chr1",63180001,63180022,22,143,25,190
"1106","chr1",63253596,63253614,19,111,5,135
"1107","chr1",63371590,63371619,30,73,92,195
"1108","chr1",63576836,63576853,18,133,74,225
"1109","chr1",63594789,63594811,23,77,24,124
"1110","chr1",63615551,63615580,30,76,51,157
"1111","chr1",63774385,63774402,18,29,66,113
"1112","chr1",63786257,63786290,34,76,14,124
"1113","chr1",64446198,64446234,37,18,112,167
"1114","chr1",64470380,64470405,26,58,47,131
"1115","chr1",64500718,64500735,18,117,6,141
"1116","chr1",64505380,64505402,23,1,72,96
"1117","chr1",64505848,64505876,29,46,55,130
"1118","chr1",64590146,64590169,24,142,33,199
"1119","chr1",64668327,64668361,35,70,74,179
"1120","chr1",64745231,64745254,24,108,16,148
"1121","chr1",64966557,64966581,25,19,67,111
"1122","chr1",64970445,64970463,19,145,70,234
"1123","chr1",65038181,65038215,35,75,64,174
"1124","chr1",65052862,65052881,20,77,26,123
"1125","chr1",65708677,65708702,26,8,62,96
"1126","chr1",65773188,65773206,19,77,27,123
"1127","chr1",65819490,65819520,31,77,39,147
"1128","chr1",66427184,66427206,23,36,75,134
"1129","chr1",67053742,67053767,26,43,3,72
"1130","chr1",67391804,67391825,22,38,143,203
"1131","chr1",67833419,67833446,28,39,83,150
"1132","chr1",68020703,68020726,24,73,4,101
"1133","chr1",68042651,68042668,18,75,74,167
"1134","chr1",68163405,68163425,21,1,67,89
"1135","chr1",68452697,68452729,33,80,103,216
"1136","chr1",68754795,68754817,23,145,27,195
"1137","chr1",69522427,69522453,27,7,28,62
"1138","chr1",70325879,70325897,19,95,74,188
"1139","chr1",70996640,70996681,42,45,131,218
"1140","chr1",71358524,71358570,47,70,118,235
"1141","chr1",71759288,71759315,28,76,28,132
"1142","chr1",72282887,72282930,44,71,72,187
"1143","chr1",72282939,72282981,43,122,20,185
"1144","chr1",73005963,73005981,19,78,103,200
"1145","chr1",73836904,73836932,29,12,5,46
"1146","chr1",73864075,73864092,18,68,35,121
"1147","chr1",75536601,75536640,40,63,43,146
"1148","chr1",75536653,75536675,23,13,22,58
"1149","chr1",75573128,75573154,27,37,69,133
"1150","chr1",75734331,75734348,18,29,143,190
"1151","chr1",75797175,75797192,18,70,1,89
"1152","chr1",76089197,76089233,37,38,74,149
"1153","chr1",76184520,76184562,43,104,25,172
"1154","chr1",76614719,76614754,36,92,6,134
"1155","chr1",76673550,76673573,24,145,27,196
"1156","chr1",76868592,76868628,37,94,5,136
"1157","chr1",77531990,77532008,19,17,86,122
"1158","chr1",77554772,77554789,18,114,76,208
"1159","chr1",77634172,77634203,32,71,72,175
"1160","chr1",77683483,77683501,19,43,117,179
"1161","chr1",77683505,77683530,26,72,95,193
"1162","chr1",77840566,77840585,20,68,110,198
"1163","chr1",77888599,77888623,25,27,14,66
"1164","chr1",77931232,77931264,33,145,27,205
"1165","chr1",77977344,77977362,19,63,35,117
"1166","chr1",78241764,78241789,26,6,37,69
"1167","chr1",79104410,79104439,30,87,66,183
"1168","chr1",79360929,79360968,40,59,6,105
"1169","chr1",79540348,79540370,23,7,60,90
"1170","chr1",79582674,79582698,25,8,5,38
"1171","chr1",80120641,80120665,25,6,27,58
"1172","chr1",81383809,81383826,18,144,25,187
"1173","chr1",81397314,81397338,25,77,42,144
"1174","chr1",82077844,82077880,37,57,15,109
"1175","chr1",83537812,83537845,34,37,106,177
"1176","chr1",83674432,83674465,34,71,74,179
"1177","chr1",84078068,84078122,55,85,13,153
"1178","chr1",84893245,84893272,28,6,8,42
"1179","chr1",84997170,84997192,23,65,21,109
"1180","chr1",85072642,85072669,28,9,74,111
"1181","chr1",85143334,85143352,19,34,123,176
"1182","chr1",85201664,85201691,28,14,10,52
"1183","chr1",85282950,85282977,28,69,111,208
"1184","chr1",85464590,85464611,22,9,105,136
"1185","chr1",85465064,85465087,24,2,97,123
"1186","chr1",85576959,85576987,29,14,21,64
"1187","chr1",85682179,85682196,18,28,77,123
"1188","chr1",85891218,85891237,20,29,143,192
"1189","chr1",86794207,86794244,38,141,3,182
"1190","chr1",87328530,87328548,19,26,25,70
"1191","chr1",87621692,87621718,27,67,72,166
"1192","chr1",88467158,88467183,26,128,37,191
"1193","chr1",88657264,88657311,48,99,4,151
"1194","chr1",88758039,88758063,25,123,9,157
"1195","chr1",88896593,88896612,20,14,8,42
"1196","chr1",88992551,88992569,19,43,80,142
"1197","chr1",89709713,89709769,57,8,19,84
"1198","chr1",89786268,89786293,26,79,75,180
"1199","chr1",89821078,89821097,20,2,18,40
"1200","chr1",89868886,89868923,38,7,23,68
"1201","chr1",89981837,89981856,20,29,72,121
"1202","chr1",90717832,90717854,23,60,11,94
"1203","chr1",90718005,90718032,28,128,49,205
"1204","chr1",90719505,90719531,27,33,82,142
"1205","chr1",90841481,90841498,18,129,96,243
"1206","chr1",91145710,91145748,39,67,67,173
"1207","chr1",91166869,91166896,28,68,56,152
"1208","chr1",91560930,91560954,25,11,122,158
"1209","chr1",91666919,91666942,24,28,85,137
"1210","chr1",91669911,91669940,30,29,131,190
"1211","chr1",92030450,92030486,37,34,76,147
"1212","chr1",92030486,92030509,24,57,40,121
"1213","chr1",92119889,92119918,30,8,144,182
"1214","chr1",92452186,92452210,25,9,24,58
"1215","chr1",92457000,92457043,44,74,77,195
"1216","chr1",92612710,92612741,32,127,75,234
"1217","chr1",92783484,92783528,45,144,56,245
"1218","chr1",92801197,92801225,29,138,74,241
"1219","chr1",92959741,92959763,23,43,21,87
"1220","chr1",92959904,92959927,24,24,84,132
"1221","chr1",92981830,92981904,75,33,72,180
"1222","chr1",93085477,93085495,19,67,9,95
"1223","chr1",93274402,93274419,18,4,74,96
"1224","chr1",93298647,93298693,47,64,12,123
"1225","chr1",93741555,93741584,30,74,14,118
"1226","chr1",93847897,93847923,27,86,87,200
"1227","chr1",94237538,94237566,29,28,49,106
"1228","chr1",94247704,94247724,21,59,33,113
"1229","chr1",94418422,94418444,23,126,21,170
"1230","chr1",94444332,94444352,21,130,123,274
"1231","chr1",94595378,94595398,21,87,78,186
"1232","chr1",94820318,94820377,60,11,56,127
"1233","chr1",95227874,95227895,22,7,96,125
"1234","chr1",96183465,96183483,19,147,74,240
"1235","chr1",96460382,96460400,19,145,33,197
"1236","chr1",96720178,96720195,18,18,11,47
"1237","chr1",97333518,97333538,21,36,125,182
"1238","chr1",97374719,97374749,31,136,6,173
"1239","chr1",97887470,97887495,26,97,6,129
"1240","chr1",98661875,98661892,18,35,22,75
"1241","chr1",98847830,98847851,22,8,7,37
"1242","chr1",99744789,99744813,25,70,3,98
"1243","chr1",99767358,99767399,42,9,143,194
"1244","chr1",100435824,100435847,24,99,47,170
"1245","chr1",100539686,100539704,19,104,8,131
"1246","chr1",101236730,101236755,26,101,86,213
"1247","chr1",101256062,101256101,40,75,62,177
"1248","chr1",101256253,101256277,25,144,4,173
"1249","chr1",102924054,102924071,18,76,26,120
"1250","chr1",103208284,103208307,24,35,76,135
"1251","chr1",103278398,103278435,38,88,84,210
"1252","chr1",104101002,104101025,24,29,55,108
"1253","chr1",104214440,104214465,26,146,34,206
"1254","chr1",104509886,104509922,37,137,6,180
"1255","chr1",104515937,104515955,19,71,6,96
"1256","chr1",104759371,104759390,20,35,67,122
"1257","chr1",105162412,105162434,23,32,4,59
"1258","chr1",106816842,106816860,19,38,75,132
"1259","chr1",107069413,107069497,85,75,38,198
"1260","chr1",107140756,107140808,53,81,122,256
"1261","chr1",107249160,107249183,24,127,73,224
"1262","chr1",107261845,107261868,24,63,4,91
"1263","chr1",107564162,107564196,35,142,30,207
"1264","chr1",107851172,107851190,19,145,73,237
"1265","chr1",107964920,107964939,20,12,35,67
"1266","chr1",108560105,108560144,40,1,40,81
"1267","chr1",108604866,108604894,29,33,102,164
"1268","chr1",108687567,108687589,23,85,135,243
"1269","chr1",108817483,108817519,37,8,59,104
"1270","chr1",108876886,108876903,18,6,63,87
"1271","chr1",109010579,109010600,22,76,4,102
"1272","chr1",109036837,109036862,26,9,74,109
"1273","chr1",109042229,109042269,41,42,37,120
"1274","chr1",109087492,109087523,32,8,140,180
"1275","chr1",109088721,109088743,23,75,133,231
"1276","chr1",109088906,109088933,28,38,63,129
"1277","chr1",109103686,109103706,21,13,36,70
"1278","chr1",109103851,109103871,21,114,80,215
"1279","chr1",109113393,109113468,76,61,74,211
"1280","chr1",109179410,109179429,20,50,66,136
"1281","chr1",109218194,109218217,24,77,5,106
"1282","chr1",109372603,109372626,24,22,134,180
"1283","chr1",109380814,109380842,29,145,36,210
"1284","chr1",109453107,109453125,19,17,6,42
"1285","chr1",109466672,109466691,20,48,28,96
"1286","chr1",109479453,109479498,46,47,107,200
"1287","chr1",109615609,109615645,37,88,100,225
"1288","chr1",109656551,109656590,40,143,54,237
"1289","chr1",109910719,109910766,48,57,95,200
"1290","chr1",109910965,109910986,22,10,45,77
"1291","chr1",109994446,109994468,23,35,59,117
"1292","chr1",110040154,110040200,47,77,8,132
"1293","chr1",110304446,110304487,42,101,3,146
"1294","chr1",110334849,110334875,27,11,76,114
"1295","chr1",110607471,110607493,23,5,26,54
"1296","chr1",110849074,110849093,20,9,23,52
"1297","chr1",110889556,110889590,35,116,9,160
"1298","chr1",111010814,111010842,29,32,43,104
"1299","chr1",111165045,111165067,23,9,21,53
"1300","chr1",111619867,111619919,53,47,129,229
"1301","chr1",111990189,111990231,43,90,30,163
"1302","chr1",112326679,112326704,26,68,17,111
"1303","chr1",112474065,112474102,38,15,6,59
"1304","chr1",112605089,112605108,20,146,143,309
"1305","chr1",112736643,112736663,21,74,65,160
"1306","chr1",112743686,112743705,20,38,4,62
"1307","chr1",112759780,112759797,18,43,7,68
"1308","chr1",112759796,112759889,94,135,58,287
"1309","chr1",112806918,112806941,24,14,73,111
"1310","chr1",112844656,112844680,25,33,70,128
"1311","chr1",112862000,112862017,18,127,5,150
"1312","chr1",112911367,112911391,25,9,26,60
"1313","chr1",112959193,112959215,23,5,20,48
"1314","chr1",112990800,112990823,24,75,3,102
"1315","chr1",112997089,112997112,24,7,11,42
"1316","chr1",113033911,113033931,21,46,146,213
"1317","chr1",113145384,113145401,18,74,92,184
"1318","chr1",113148446,113148470,25,10,8,43
"1319","chr1",113384145,113384168,24,8,121,153
"1320","chr1",113406279,113406298,20,145,31,196
"1321","chr1",113456118,113456138,21,29,75,125
"1322","chr1",113723178,113723195,18,8,117,143
"1323","chr1",113853676,113853697,22,74,118,214
"1324","chr1",113853849,113853883,35,8,75,118
"1325","chr1",113929712,113929731,20,26,5,51
"1326","chr1",114225357,114225396,40,147,58,245
"1327","chr1",114241854,114241872,19,112,25,156
"1328","chr1",114450326,114450347,22,6,5,33
"1329","chr1",114510931,114510948,18,85,5,108
"1330","chr1",114537741,114537763,23,123,4,150
"1331","chr1",114641923,114641964,42,70,147,259
"1332","chr1",114958757,114958780,24,145,35,204
"1333","chr1",115839259,115839282,24,10,3,37
"1334","chr1",115976466,115976500,35,108,20,163
"1335","chr1",116512609,116512628,20,95,75,190
"1336","chr1",116671161,116671246,86,9,33,128
"1337","chr1",116770235,116770253,19,145,32,196
"1338","chr1",116831442,116831475,34,67,6,107
"1339","chr1",116869704,116869767,64,84,30,178
"1340","chr1",116896125,116896149,25,8,85,118
"1341","chr1",116897376,116897393,18,50,140,208
"1342","chr1",116897391,116897418,28,75,125,228
"1343","chr1",116910139,116910182,44,138,139,321
"1344","chr1",117310167,117310195,29,78,33,140
"1345","chr1",117367314,117367358,45,16,24,85
"1346","chr1",117600196,117600215,20,82,119,221
"1347","chr1",117789597,117789615,19,4,11,34
"1348","chr1",118872525,118872558,34,95,121,250
"1349","chr1",118979834,118979852,19,32,6,57
"1350","chr1",118985091,118985122,32,22,90,144
"1351","chr1",119131452,119131479,28,7,136,171
"1352","chr1",119648189,119648248,60,50,77,187
"1353","chr1",119727666,119727684,19,77,36,132
"1354","chr1",119778727,119778753,27,7,92,126
"1355","chr1",120293310,120293337,28,8,6,42
"1356","chr1",120310695,120310717,23,96,9,128
"1357","chr1",120394923,120394965,43,8,128,179
"1358","chr1",120403652,120403684,33,50,21,104
"1359","chr1",120546814,120546867,54,11,56,121
"1360","chr1",120587671,120587693,23,11,94,128
"1361","chr1",120605054,120605081,28,8,6,42
"1362","chr1",120848537,120848569,33,102,4,139
"1363","chr1",120949880,120949971,92,6,1,99
"1364","chr1",121005689,121005747,59,75,21,155
"1365","chr1",121038564,121038582,19,147,5,171
"1366","chr1",121554189,121554215,27,149,73,249
"1367","chr1",125065918,125065945,28,109,4,141
"1368","chr1",125099008,125099035,28,43,74,145
"1369","chr1",143321353,143321398,46,80,70,196
"1370","chr1",143322497,143322523,27,14,14,55
"1371","chr1",143699692,143699715,24,137,3,164
"1372","chr1",143788835,143788863,29,27,35,91
"1373","chr1",143788863,143788909,47,73,7,127
"1374","chr1",143821836,143821853,18,147,5,170
"1375","chr1",143911730,143911757,28,12,4,44
"1376","chr1",143916796,143916818,23,8,58,89
"1377","chr1",144146728,144146773,46,80,70,196
"1378","chr1",144147747,144147768,22,119,139,280
"1379","chr1",144147877,144147903,27,14,9,50
"1380","chr1",144414993,144415028,36,7,101,144
"1381","chr1",144440820,144440841,22,29,143,194
"1382","chr1",144484370,144484410,41,127,6,174
"1383","chr1",144571832,144571873,42,103,5,150
"1384","chr1",144818660,144818686,27,11,12,50
"1385","chr1",144818795,144818816,22,141,117,280
"1386","chr1",144819790,144819835,46,72,78,196
"1387","chr1",145139168,145139193,26,6,145,177
"1388","chr1",145172305,145172322,18,37,57,112
"1389","chr1",145283530,145283564,35,68,101,204
"1390","chr1",145406086,145406108,23,30,143,196
"1391","chr1",145425615,145425640,26,52,129,207
"1392","chr1",145439272,145439298,27,8,111,146
"1393","chr1",145488067,145488107,41,35,66,142
"1394","chr1",145684208,145684226,19,8,84,111
"1395","chr1",145766790,145766810,21,1,5,27
"1396","chr1",145795017,145795037,21,6,74,101
"1397","chr1",145929356,145929380,25,45,29,99
"1398","chr1",145962636,145962658,23,1,47,71
"1399","chr1",145970454,145970476,23,32,51,106
"1400","chr1",145970876,145970904,29,147,6,182
"1401","chr1",146034485,146034507,23,8,136,167
"1402","chr1",146252366,146252386,21,136,7,164
"1403","chr1",146298138,146298157,20,18,17,55
"1404","chr1",146365836,146365868,33,8,92,133
"1405","chr1",146449824,146449848,25,8,125,158
"1406","chr1",146458240,146458274,35,50,21,106
"1407","chr1",146862511,146862531,21,35,143,199
"1408","chr1",146898232,146898336,105,39,75,219
"1409","chr1",147172643,147172660,18,33,74,125
"1410","chr1",147393009,147393035,27,5,89,121
"1411","chr1",147492990,147493016,27,70,41,138
"1412","chr1",147569474,147569500,27,77,54,158
"1413","chr1",147600190,147600215,26,32,14,72
"1414","chr1",147982052,147982075,24,6,45,75
"1415","chr1",148061178,148061234,57,35,66,158
"1416","chr1",148525016,148525050,35,7,101,143
"1417","chr1",148703110,148703131,22,136,7,165
"1418","chr1",148748921,148748940,20,18,17,55
"1419","chr1",148846445,148846474,30,11,5,46
"1420","chr1",148857360,148857379,20,69,70,159
"1421","chr1",148905179,148905201,23,8,6,37
"1422","chr1",148922553,148922575,23,15,9,47
"1423","chr1",148964058,148964111,54,60,9,123
"1424","chr1",149114887,149114919,33,24,48,105
"1425","chr1",149123302,149123325,24,127,6,157
"1426","chr1",149207709,149207731,23,11,94,128
"1427","chr1",149272885,149272904,20,72,67,159
"1428","chr1",149283766,149283803,38,7,9,54
"1429","chr1",149644038,149644113,76,6,1,83
"1430","chr1",149730377,149730395,19,147,5,171
"1431","chr1",149819460,149819480,21,11,2,34
"1432","chr1",149828688,149828706,19,27,72,118
"1433","chr1",149837024,149837045,22,19,44,85
"1434","chr1",149843447,149843466,20,141,18,179
"1435","chr1",149850346,149850365,20,20,139,179
"1436","chr1",149856775,149856796,22,46,17,85
"1437","chr1",149865110,149865128,19,74,25,118
"1438","chr1",149874380,149874404,25,4,9,38
"1439","chr1",150016431,150016471,41,75,106,222
"1440","chr1",150078765,150078787,23,107,3,133
"1441","chr1",150214802,150214820,19,3,73,95
"1442","chr1",150223682,150223701,20,14,5,39
"1443","chr1",150248047,150248081,35,8,78,121
"1444","chr1",150342506,150342526,21,62,71,154
"1445","chr1",150369624,150369642,19,41,75,135
"1446","chr1",150369771,150369798,28,76,131,235
"1447","chr1",150427145,150427162,18,50,6,74
"1448","chr1",150466012,150466034,23,85,99,207
"1449","chr1",150495709,150495730,22,69,130,221
"1450","chr1",150547112,150547133,22,81,83,186
"1451","chr1",150548981,150548999,19,4,89,112
"1452","chr1",150549313,150549370,58,1,2,61
"1453","chr1",150569274,150569293,20,76,73,169
"1454","chr1",150579759,150579814,56,113,117,286
"1455","chr1",150588217,150588235,19,134,119,272
"1456","chr1",150591258,150591282,25,76,115,216
"1457","chr1",150602737,150602775,39,76,96,211
"1458","chr1",150792801,150792834,34,135,54,223
"1459","chr1",150836878,150836917,40,109,54,203
"1460","chr1",150898932,150898949,18,78,17,113
"1461","chr1",150921514,150921553,40,112,23,175
"1462","chr1",150925263,150925280,18,51,75,144
"1463","chr1",150974769,150974803,35,22,1,58
"1464","chr1",151022417,151022434,18,74,138,230
"1465","chr1",151028409,151028438,30,5,73,108
"1466","chr1",151029366,151029387,22,10,51,83
"1467","chr1",151045267,151045290,24,26,75,125
"1468","chr1",151112224,151112247,24,93,74,191
"1469","chr1",151112324,151112358,35,7,131,173
"1470","chr1",151123856,151123887,32,19,2,53
"1471","chr1",151124051,151124068,18,145,118,281
"1472","chr1",151124146,151124180,35,77,23,135
"1473","chr1",151149397,151149419,23,99,5,127
"1474","chr1",151171824,151171850,27,72,55,154
"1475","chr1",151197266,151197299,34,10,41,85
"1476","chr1",151208720,151208749,30,7,84,121
"1477","chr1",151280708,151280737,30,145,6,181
"1478","chr1",151291641,151291661,21,79,129,229
"1479","chr1",151327524,151327541,18,118,38,174
"1480","chr1",151339266,151339287,22,143,43,208
"1481","chr1",151379702,151379724,23,77,27,127
"1482","chr1",151388410,151388446,37,75,116,228
"1483","chr1",151419025,151419062,38,138,6,182
"1484","chr1",151452098,151452122,25,138,5,168
"1485","chr1",151458673,151458702,30,16,122,168
"1486","chr1",151491508,151491531,24,3,54,81
"1487","chr1",151501336,151501354,19,139,3,161
"1488","chr1",151508001,151508024,24,5,22,51
"1489","chr1",151509615,151509648,34,8,1,43
"1490","chr1",151511436,151511483,48,10,12,70
"1491","chr1",151532613,151532633,21,73,17,111
"1492","chr1",151609094,151609122,29,7,142,178
"1493","chr1",151642944,151642978,35,4,5,44
"1494","chr1",151643265,151643311,47,75,10,132
"1495","chr1",151725108,151725127,20,7,2,29
"1496","chr1",151795282,151795299,18,8,146,172
"1497","chr1",151825248,151825307,60,137,120,317
"1498","chr1",151866027,151866047,21,6,87,114
"1499","chr1",152534226,152534263,38,27,10,75
"1500","chr1",153452867,153452888,22,61,3,86
"1501","chr1",153559512,153559529,18,23,98,139
"1502","chr1",153571258,153571299,42,76,40,158
"1503","chr1",153595452,153595470,19,61,5,85
"1504","chr1",153655292,153655312,21,82,75,178
"1505","chr1",153679141,153679169,29,130,46,205
"1506","chr1",153679148,153679188,41,10,39,90
"1507","chr1",153696441,153696466,26,48,2,76
"1508","chr1",153714473,153714616,144,79,114,337
"1509","chr1",153766688,153766707,20,8,50,78
"1510","chr1",153781734,153781761,28,7,79,114
"1511","chr1",153784749,153784767,19,6,3,28
"1512","chr1",153830449,153830490,42,5,142,189
"1513","chr1",153890173,153890196,24,3,73,100
"1514","chr1",153989240,153989266,27,7,137,171
"1515","chr1",154134735,154134754,20,7,77,104
"1516","chr1",154174369,154174408,40,63,40,143
"1517","chr1",154196933,154196952,20,115,74,209
"1518","chr1",154221001,154221034,34,147,98,279
"1519","chr1",154253384,154253402,19,11,63,93
"1520","chr1",154336795,154336812,18,76,3,97
"1521","chr1",154346869,154346896,28,65,30,123
"1522","chr1",154417737,154417757,21,13,74,108
"1523","chr1",154514676,154514706,31,77,99,207
"1524","chr1",154525896,154525919,24,126,75,225
"1525","chr1",154558555,154558574,20,25,38,83
"1526","chr1",154558615,154558648,34,57,7,98
"1527","chr1",154558757,154558777,21,37,2,60
"1528","chr1",154608493,154608513,21,23,78,122
"1529","chr1",154721282,154721317,36,8,99,143
"1530","chr1",154722386,154722405,20,8,11,39
"1531","chr1",154905247,154905265,19,8,8,35
"1532","chr1",154995482,154995502,21,147,73,241
"1533","chr1",155078917,155078934,18,1,126,145
"1534","chr1",155078956,155078976,21,4,87,112
"1535","chr1",155182844,155182862,19,10,33,62
"1536","chr1",155244402,155244431,30,47,72,149
"1537","chr1",155249886,155249906,21,73,74,168
"1538","chr1",155258012,155258036,25,7,76,108
"1539","chr1",155258319,155258353,35,75,11,121
"1540","chr1",155315684,155315717,34,77,5,116
"1541","chr1",155350921,155350957,37,149,6,192
"1542","chr1",155361519,155361549,31,77,4,112
"1543","chr1",155397125,155397149,25,82,74,181
"1544","chr1",155405830,155405847,18,4,6,28
"1545","chr1",155426057,155426083,27,9,142,178
"1546","chr1",155446301,155446318,18,10,28,56
"1547","chr1",155484928,155484968,41,138,7,186
"1548","chr1",155567309,155567329,21,8,57,86
"1549","chr1",155568828,155568867,40,74,143,257
"1550","chr1",155569128,155569148,21,71,64,156
"1551","chr1",155569435,155569455,21,76,145,242
"1552","chr1",155578508,155578528,21,8,141,170
"1553","chr1",155578818,155578841,24,34,3,61
"1554","chr1",155587440,155587461,22,12,6,40
"1555","chr1",155608803,155608840,38,7,10,55
"1556","chr1",155609218,155609244,27,57,54,138
"1557","chr1",155609244,155609263,20,76,28,124
"1558","chr1",155647342,155647361,20,76,6,102
"1559","chr1",155706749,155706785,37,122,92,251
"1560","chr1",155735109,155735133,25,145,107,277
"1561","chr1",155787944,155787970,27,37,74,138
"1562","chr1",155832280,155832323,44,124,69,237
"1563","chr1",155842524,155842547,24,138,6,168
"1564","chr1",155849774,155849795,22,104,6,132
"1565","chr1",155874892,155874927,36,102,4,142
"1566","chr1",155877554,155877571,18,8,87,113
"1567","chr1",155908089,155908112,24,86,76,186
"1568","chr1",156053813,156053858,46,43,54,143
"1569","chr1",156073951,156073978,28,69,140,237
"1570","chr1",156076896,156076914,19,41,1,61
"1571","chr1",156082822,156082856,35,43,108,186
"1572","chr1",156117970,156117994,25,63,106,194
"1573","chr1",156139583,156139605,23,44,57,124
"1574","chr1",156216394,156216417,24,38,3,65
"1575","chr1",156220629,156220653,25,19,2,46
"1576","chr1",156235436,156235459,24,8,64,96
"1577","chr1",156289444,156289461,18,144,36,198
"1578","chr1",156296550,156296580,31,73,11,115
"1579","chr1",156296580,156296608,29,101,43,173
"1580","chr1",156296608,156296642,35,135,15,185
"1581","chr1",156334240,156334257,18,26,5,49
"1582","chr1",156340459,156340478,20,75,10,105
"1583","chr1",156362048,156362072,25,8,3,36
"1584","chr1",156383829,156383850,22,7,143,172
"1585","chr1",156398706,156398745,40,67,130,237
"1586","chr1",156411889,156411943,55,15,59,129
"1587","chr1",156435736,156435770,35,69,38,142
"1588","chr1",156511656,156511690,35,112,3,150
"1589","chr1",156569529,156569552,24,92,15,131
"1590","chr1",156619404,156619424,21,130,2,153
"1591","chr1",156621727,156621750,24,21,17,62
"1592","chr1",156625766,156625784,19,31,37,87
"1593","chr1",156643610,156643636,27,62,84,173
"1594","chr1",156643636,156643668,33,94,58,185
"1595","chr1",156679136,156679153,18,71,15,104
"1596","chr1",156687724,156687751,28,4,22,54
"1597","chr1",156743698,156743733,36,129,58,223
"1598","chr1",156747231,156747268,38,71,119,228
"1599","chr1",156761608,156761627,20,109,8,137
"1600","chr1",157546451,157546503,53,92,71,216
"1601","chr1",157863790,157863823,34,6,72,112
"1602","chr1",158042910,158042938,29,145,31,205
"1603","chr1",158088477,158088502,26,8,8,42
"1604","chr1",158114288,158114322,35,73,43,151
"1605","chr1",158199204,158199229,26,70,27,123
"1606","chr1",159171786,159171806,21,129,7,157
"1607","chr1",160087893,160087913,21,34,104,159
"1608","chr1",160098856,160098894,39,34,33,106
"1609","chr1",160205402,160205439,38,114,76,228
"1610","chr1",160270000,160270020,21,41,75,137
"1611","chr1",160284725,160284750,26,22,78,126
"1612","chr1",160965527,160965550,24,54,6,84
"1613","chr1",160969578,160969615,38,85,6,129
"1614","chr1",161016481,161016498,18,68,69,155
"1615","chr1",161027503,161027522,20,77,29,126
"1616","chr1",161027671,161027694,24,76,75,175
"1617","chr1",161132639,161132666,28,49,3,80
"1618","chr1",161153052,161153070,19,41,4,64
"1619","chr1",161156537,161156557,21,10,8,39
"1620","chr1",161190345,161190362,18,76,14,108
"1621","chr1",161215007,161215029,23,6,11,40
"1622","chr1",161244385,161244411,27,112,67,206
"1623","chr1",161293279,161293318,40,66,5,111
"1624","chr1",161340339,161340362,24,113,24,161
"1625","chr1",161372678,161372696,19,93,76,188
"1626","chr1",161399250,161399277,28,43,40,111
"1627","chr1",161538513,161538531,19,137,7,163
"1628","chr1",161565907,161565930,24,8,127,159
"1629","chr1",161647298,161647317,20,75,127,222
"1630","chr1",161894703,161894723,21,105,142,268
"1631","chr1",162022245,162022268,24,76,42,142
"1632","chr1",162069751,162069777,27,50,35,112
"1633","chr1",162180232,162180259,28,73,91,192
"1634","chr1",162596155,162596177,23,29,143,195
"1635","chr1",162788040,162788076,37,65,18,120
"1636","chr1",163007535,163007568,34,19,6,59
"1637","chr1",163422888,163422957,70,20,10,100
"1638","chr1",164458270,164458292,23,35,72,130
"1639","chr1",164890939,164890959,21,70,6,97
"1640","chr1",165445153,165445174,22,27,18,67
"1641","chr1",165597249,165597279,31,5,116,152
"1642","chr1",165651893,165651911,19,28,76,123
"1643","chr1",165698032,165698070,39,20,3,62
"1644","chr1",165943958,165943980,23,144,33,200
"1645","chr1",166166712,166166731,20,14,28,62
"1646","chr1",166839697,166839715,19,28,6,53
"1647","chr1",167143301,167143341,41,76,64,181
"1648","chr1",167302184,167302206,23,113,85,221
"1649","chr1",167630161,167630216,56,26,31,113
"1650","chr1",167722117,167722134,18,13,42,73
"1651","chr1",168136700,168136722,23,40,82,145
"1652","chr1",168136941,168136972,32,23,42,97
"1653","chr1",168238492,168238523,32,137,140,309
"1654","chr1",168790588,168790623,36,145,26,207
"1655","chr1",169055658,169055700,43,127,146,316
"1656","chr1",169485720,169485742,23,98,17,138
"1657","chr1",170216025,170216050,26,29,75,130
"1658","chr1",170255098,170255120,23,8,18,49
"1659","chr1",170488865,170488895,31,78,8,117
"1660","chr1",170531489,170531508,20,50,5,75
"1661","chr1",170650684,170650704,21,79,42,142
"1662","chr1",171063253,171063271,19,9,146,174
"1663","chr1",171401368,171401387,20,93,123,236
"1664","chr1",171425896,171425919,24,145,6,175
"1665","chr1",171486108,171486129,22,108,38,168
"1666","chr1",171671525,171671546,22,145,74,241
"1667","chr1",171901113,171901131,19,86,6,111
"1668","chr1",172414903,172414920,18,96,72,186
"1669","chr1",173564943,173564985,43,76,143,262
"1670","chr1",173825450,173825485,36,7,114,157
"1671","chr1",173908491,173908512,22,10,5,37
"1672","chr1",173924641,173924667,27,9,112,148
"1673","chr1",174022136,174022177,42,77,62,181
"1674","chr1",174685552,174685583,32,11,11,54
"1675","chr1",174763651,174763688,38,77,6,121
"1676","chr1",174925355,174925379,25,13,16,54
"1677","chr1",175074485,175074509,25,69,34,128
"1678","chr1",175368951,175368994,44,92,4,140
"1679","chr1",175937937,175937957,21,31,30,82
"1680","chr1",176760806,176760833,28,38,59,125
"1681","chr1",178093761,178093825,65,22,26,113
"1682","chr1",178349259,178349278,20,80,33,133
"1683","chr1",178605604,178605621,18,80,27,125
"1684","chr1",178725451,178725469,19,70,73,162
"1685","chr1",179035804,179035827,24,131,14,169
"1686","chr1",179083582,179083599,18,126,121,265
"1687","chr1",179111282,179111303,22,76,78,176
"1688","chr1",179113937,179113959,23,134,16,173
"1689","chr1",179117954,179117989,36,131,122,289
"1690","chr1",179228051,179228072,22,20,6,48
"1691","chr1",179229633,179229666,34,42,47,123
"1692","chr1",179295967,179296001,35,27,76,138
"1693","chr1",179325148,179325167,20,8,98,126
"1694","chr1",179365364,179365381,18,131,12,161
"1695","chr1",179455096,179455123,28,75,6,109
"1696","chr1",179455275,179455308,34,9,74,117
"1697","chr1",179743464,179743487,24,59,38,121
"1698","chr1",180154946,180154964,19,133,60,212
"1699","chr1",180207500,180207524,25,74,3,102
"1700","chr1",180229990,180230032,43,9,139,191
"1701","chr1",180243290,180243307,18,72,76,166
"1702","chr1",180584048,180584070,23,31,27,81
"1703","chr1",180632526,180632546,21,98,49,168
"1704","chr1",181105496,181105524,29,104,92,225
"1705","chr1",182139990,182140027,38,76,108,222
"1706","chr1",182265309,182265326,18,139,62,219
"1707","chr1",182324442,182324474,33,7,49,89
"1708","chr1",182391965,182391982,18,61,15,94
"1709","chr1",182840300,182840320,21,48,17,86
"1710","chr1",182898673,182898707,35,74,27,136
"1711","chr1",183023087,183023149,63,36,3,102
"1712","chr1",183166080,183166102,23,72,93,188
"1713","chr1",183472370,183472392,23,37,113,173
"1714","chr1",183635467,183635493,27,19,108,154
"1715","chr1",184214425,184214532,108,54,88,250
"1716","chr1",184231480,184231500,21,76,49,146
"1717","chr1",184386769,184386820,52,15,10,77
"1718","chr1",184571297,184571323,27,23,6,56
"1719","chr1",184675913,184675934,22,76,134,232
"1720","chr1",184884216,184884241,26,76,38,140
"1721","chr1",184917369,184917393,25,36,78,139
"1722","chr1",184921129,184921147,19,77,6,102
"1723","chr1",184934896,184934918,23,30,5,58
"1724","chr1",185330054,185330076,23,76,54,153
"1725","chr1",185404263,185404302,40,99,67,206
"1726","chr1",186375989,186376022,34,93,27,154
"1727","chr1",186455798,186455822,25,145,35,205
"1728","chr1",187365986,187366034,49,9,103,161
"1729","chr1",187647143,187647189,47,5,93,145
"1730","chr1",187763084,187763101,18,122,75,215
"1731","chr1",188474363,188474380,18,77,34,129
"1732","chr1",188813281,188813312,32,123,14,169
"1733","chr1",189367489,189367510,22,80,27,129
"1734","chr1",189521135,189521155,21,143,28,192
"1735","chr1",189540460,189540479,20,36,72,128
"1736","chr1",189696824,189696849,26,8,137,171
"1737","chr1",190265540,190265562,23,75,33,131
"1738","chr1",190408189,190408206,18,18,75,111
"1739","chr1",190434100,190434135,36,53,6,95
"1740","chr1",190706620,190706678,59,6,38,103
"1741","chr1",190989821,190989840,20,33,76,129
"1742","chr1",191596059,191596093,35,23,114,172
"1743","chr1",191720775,191720795,21,29,75,125
"1744","chr1",192293197,192293218,22,8,138,168
"1745","chr1",192865832,192865852,21,75,134,230
"1746","chr1",193059656,193059683,28,37,55,120
"1747","chr1",193116893,193116915,23,7,6,36
"1748","chr1",193177359,193177380,22,77,36,135
"1749","chr1",193280174,193280198,25,76,75,176
"1750","chr1",193586456,193586512,57,55,6,118
"1751","chr1",194431902,194431926,25,87,75,187
"1752","chr1",194657742,194657809,68,76,7,151
"1753","chr1",195653979,195654000,22,8,18,48
"1754","chr1",195919180,195919207,28,67,37,132
"1755","chr1",196768715,196768733,19,34,79,132
"1756","chr1",197450785,197450810,26,77,27,130
"1757","chr1",197805930,197805965,36,115,134,285
"1758","chr1",197923496,197923522,27,90,62,179
"1759","chr1",198665081,198665107,27,76,142,245
"1760","chr1",198679397,198679416,20,4,78,102
"1761","chr1",198705392,198705435,44,123,66,233
"1762","chr1",199989239,199989287,49,78,3,130
"1763","chr1",199989260,199989293,34,84,54,172
"1764","chr1",200356822,200356840,19,77,34,130
"1765","chr1",200409604,200409624,21,3,54,78
"1766","chr1",200487615,200487633,19,125,6,150
"1767","chr1",200521342,200521365,24,75,144,243
"1768","chr1",200523275,200523295,21,144,6,171
"1769","chr1",200561230,200561256,27,145,123,295
"1770","chr1",200623869,200623914,46,56,141,243
"1771","chr1",200669789,200669806,18,18,75,111
"1772","chr1",200669896,200669918,23,48,7,78
"1773","chr1",200711910,200711928,19,45,121,185
"1774","chr1",200721336,200721358,23,61,146,230
"1775","chr1",200722342,200722464,123,15,3,141
"1776","chr1",200738825,200738852,28,74,91,193
"1777","chr1",200739621,200739643,23,76,145,244
"1778","chr1",200750902,200750920,19,76,65,160
"1779","chr1",201444192,201444211,20,70,61,151
"1780","chr1",201519907,201519927,21,42,73,136
"1781","chr1",201550011,201550035,25,135,6,166
"1782","chr1",201642383,201642405,23,49,72,144
"1783","chr1",201642570,201642754,185,43,87,315
"1784","chr1",201682116,201682136,21,77,74,172
"1785","chr1",201802137,201802155,19,145,6,170
"1786","chr1",201955091,201955133,43,25,6,74
"1787","chr1",201960000,201960022,23,52,7,82
"1788","chr1",202022310,202022330,21,12,7,40
"1789","chr1",202104817,202104839,23,6,38,67
"1790","chr1",202643319,202643344,26,105,121,252
"1791","chr1",202721206,202721225,20,7,7,34
"1792","chr1",202832932,202832952,21,88,101,210
"1793","chr1",202842009,202842035,27,51,5,83
"1794","chr1",202928275,202928320,46,131,74,251
"1795","chr1",202971256,202971277,22,76,145,243
"1796","chr1",203273775,203273792,18,71,27,116
"1797","chr1",203330818,203330838,21,77,63,161
"1798","chr1",203471092,203471116,25,136,56,217
"1799","chr1",203555023,203555054,32,113,4,149
"1800","chr1",203563859,203563885,27,76,4,107
"1801","chr1",203567365,203567400,36,77,11,124
"1802","chr1",203631787,203631813,27,10,33,70
"1803","chr1",203634966,203634988,23,4,143,170
"1804","chr1",203781760,203781784,25,77,8,110
"1805","chr1",203879914,203879931,18,22,6,46
"1806","chr1",204071928,204071947,20,8,127,155
"1807","chr1",204074938,204074963,26,48,135,209
"1808","chr1",204079344,204079363,20,8,28,56
"1809","chr1",204181986,204182032,47,67,73,187
"1810","chr1",204222021,204222067,47,6,54,107
"1811","chr1",204412048,204412079,32,36,34,102
"1812","chr1",204496311,204496338,28,29,75,132
"1813","chr1",204506457,204506479,23,100,68,191
"1814","chr1",204624712,204624737,26,122,94,242
"1815","chr1",204787285,204787307,23,120,128,271
"1816","chr1",205043230,205043257,28,72,121,221
"1817","chr1",205049379,205049409,31,18,115,164
"1818","chr1",205117051,205117070,20,6,137,163
"1819","chr1",205266241,205266261,21,100,6,127
"1820","chr1",205299498,205299515,18,56,28,102
"1821","chr1",205299515,205299537,23,78,11,112
"1822","chr1",205391947,205391964,18,80,32,130
"1823","chr1",205445186,205445205,20,3,56,79
"1824","chr1",205450101,205450120,20,1,79,100
"1825","chr1",205504601,205504633,33,28,39,100
"1826","chr1",205680032,205680059,28,9,11,48
"1827","chr1",206151930,206151948,19,66,8,93
"1828","chr1",206481767,206481797,31,8,42,81
"1829","chr1",206612945,206612976,32,26,26,84
"1830","chr1",206613246,206613279,34,144,5,183
"1831","chr1",206685621,206685640,20,73,52,145
"1832","chr1",206712963,206713005,43,69,77,189
"1833","chr1",206775211,206775236,26,35,140,201
"1834","chr1",207053870,207053922,53,9,11,73
"1835","chr1",207057303,207057328,26,77,16,119
"1836","chr1",207247718,207247736,19,23,138,180
"1837","chr1",207416966,207416986,21,147,5,173
"1838","chr1",207677308,207677337,30,84,20,134
"1839","chr1",207679154,207679176,23,71,85,179
"1840","chr1",207788361,207788379,19,86,27,132
"1841","chr1",207789871,207789898,28,133,33,194
"1842","chr1",207824032,207824074,43,70,52,165
"1843","chr1",208182436,208182469,34,33,3,70
"1844","chr1",208244300,208244336,37,56,45,138
"1845","chr1",209142196,209142222,27,46,13,86
"1846","chr1",209205843,209205860,18,27,27,72
"1847","chr1",209231553,209231570,18,16,98,132
"1848","chr1",209928356,209928395,40,138,6,184
"1849","chr1",209937995,209938026,32,1,6,39
"1850","chr1",210266460,210266482,23,67,6,96
"1851","chr1",210504903,210504920,18,12,132,162
"1852","chr1",211259429,211259473,45,58,26,129
"1853","chr1",211558921,211558960,40,125,73,238
"1854","chr1",211578138,211578156,19,61,88,168
"1855","chr1",211596020,211596037,18,11,65,94
"1856","chr1",211607238,211607285,48,93,8,149
"1857","chr1",211687849,211687876,28,56,27,111
"1858","chr1",212215584,212215603,20,8,67,95
"1859","chr1",212249208,212249226,19,96,2,117
"1860","chr1",212291398,212291421,24,29,129,182
"1861","chr1",212305036,212305056,21,78,140,239
"1862","chr1",212382208,212382225,18,39,73,130
"1863","chr1",212515237,212515272,36,3,18,57
"1864","chr1",212637863,212637900,38,39,95,172
"1865","chr1",212699673,212699699,27,4,24,55
"1866","chr1",212811686,212811712,27,68,23,118
"1867","chr1",212874917,212874947,31,87,55,173
"1868","chr1",212950642,212950669,28,17,10,55
"1869","chr1",212950666,212950684,19,32,47,98
"1870","chr1",212951478,212951510,33,52,18,103
"1871","chr1",213015516,213015534,19,72,103,194
"1872","chr1",213037695,213037727,33,39,60,132
"1873","chr1",213165410,213165438,29,73,13,115
"1874","chr1",213168617,213168638,22,7,127,156
"1875","chr1",213949110,213949133,24,36,127,187
"1876","chr1",213987703,213987723,21,136,54,211
"1877","chr1",213988095,213988280,186,33,66,285
"1878","chr1",214281432,214281454,23,73,16,112
"1879","chr1",214383706,214383724,19,35,39,93
"1880","chr1",214448398,214448425,28,25,142,195
"1881","chr1",214599836,214599859,24,80,138,242
"1882","chr1",214870547,214870578,32,76,73,181
"1883","chr1",215044791,215044827,37,86,1,124
"1884","chr1",215083004,215083032,29,29,60,118
"1885","chr1",215614019,215614048,30,74,4,108
"1886","chr1",216011972,216011997,26,69,13,108
"1887","chr1",217412775,217412800,26,10,5,41
"1888","chr1",217454589,217454610,22,12,6,40
"1889","chr1",217598389,217598407,19,133,122,274
"1890","chr1",217797236,217797254,19,63,72,154
"1891","chr1",217894673,217894695,23,77,74,174
"1892","chr1",217902845,217902866,22,81,73,176
"1893","chr1",218368144,218368161,18,75,102,195
"1894","chr1",218378149,218378189,41,71,69,181
"1895","chr1",218533000,218533017,18,76,5,99
"1896","chr1",219199610,219199632,23,8,143,174
"1897","chr1",219238305,219238332,28,37,26,91
"1898","chr1",219536575,219536598,24,65,140,229
"1899","chr1",219579811,219579833,23,36,66,125
"1900","chr1",219749980,219750002,23,8,104,135
"1901","chr1",219950640,219950661,22,113,73,208
"1902","chr1",220140984,220141002,19,140,74,233
"1903","chr1",220288954,220288987,34,8,143,185
"1904","chr1",220313584,220313622,39,116,87,242
"1905","chr1",220356670,220356687,18,53,36,107
"1906","chr1",220528033,220528076,44,27,32,103
"1907","chr1",221434355,221434402,48,27,74,149
"1908","chr1",221692065,221692086,22,77,26,125
"1909","chr1",221741862,221741911,50,118,74,242
"1910","chr1",222431747,222431770,24,41,74,139
"1911","chr1",222617903,222618048,146,27,116,289
"1912","chr1",222741047,222741078,32,10,97,139
"1913","chr1",223496541,223496563,23,121,6,150
"1914","chr1",223845786,223845815,30,9,18,57
"1915","chr1",223910880,223910907,28,28,143,199
"1916","chr1",223989800,223989846,47,136,76,259
"1917","chr1",224146067,224146084,18,53,73,144
"1918","chr1",224183257,224183274,18,19,63,100
"1919","chr1",224200529,224200552,24,78,6,108
"1920","chr1",224205128,224205151,24,8,26,58
"1921","chr1",224214762,224214790,29,147,116,292
"1922","chr1",224237962,224237985,24,10,66,100
"1923","chr1",224254391,224254409,19,7,12,38
"1924","chr1",224264017,224264040,24,122,4,150
"1925","chr1",224281278,224281313,36,3,39,78
"1926","chr1",224340833,224340861,29,49,1,79
"1927","chr1",224434071,224434088,18,61,95,174
"1928","chr1",224434205,224434253,49,1,123,173
"1929","chr1",224434505,224434525,21,54,61,136
"1930","chr1",224434525,224434559,35,32,41,108
"1931","chr1",224434689,224434717,29,14,23,66
"1932","chr1",224616328,224616354,27,3,34,64
"1933","chr1",224747627,224747651,25,32,80,137
"1934","chr1",224900240,224900280,41,47,8,96
"1935","chr1",225428113,225428138,26,27,4,57
"1936","chr1",225654923,225654965,43,65,20,128
"1937","chr1",225662819,225662836,18,14,5,37
"1938","chr1",225834098,225834125,28,148,6,182
"1939","chr1",225919229,225919247,19,8,101,128
"1940","chr1",225949980,225950003,24,10,8,42
"1941","chr1",226080460,226080483,24,147,74,245
"1942","chr1",226081890,226081911,22,146,73,241
"1943","chr1",226082193,226082212,20,30,73,123
"1944","chr1",226103336,226103354,19,8,115,142
"1945","chr1",226175092,226175128,37,116,10,163
"1946","chr1",226343924,226343944,21,36,8,65
"1947","chr1",226367168,226367190,23,9,76,108
"1948","chr1",226400300,226400332,33,71,73,177
"1949","chr1",226548933,226548965,33,18,34,85
"1950","chr1",226635163,226635239,77,9,29,115
"1951","chr1",226737183,226737205,23,30,54,107
"1952","chr1",226756127,226756149,23,76,109,208
"1953","chr1",226783735,226783755,21,35,75,131
"1954","chr1",226826303,226826328,26,74,9,109
"1955","chr1",226936612,226936638,27,8,68,103
"1956","chr1",227318062,227318085,24,105,17,146
"1957","chr1",227383841,227383905,65,139,77,281
"1958","chr1",227400144,227400164,21,95,27,143
"1959","chr1",227400505,227400523,19,96,75,190
"1960","chr1",227857345,227857372,28,106,5,139
"1961","chr1",228149687,228149705,19,137,57,213
"1962","chr1",228153577,228153601,25,9,51,85
"1963","chr1",228158212,228158232,21,40,49,110
"1964","chr1",228167356,228167373,18,7,87,112
"1965","chr1",228285328,228285351,24,51,70,145
"1966","chr1",228289788,228289810,23,85,125,233
"1967","chr1",228378490,228378507,18,36,4,58
"1968","chr1",228406869,228406905,37,45,88,170
"1969","chr1",228458656,228458684,29,139,128,296
"1970","chr1",228555901,228555920,20,33,8,61
"1971","chr1",228641716,228641733,18,61,15,94
"1972","chr1",228643957,228643974,18,61,15,94
"1973","chr1",228736261,228736280,20,94,23,137
"1974","chr1",228896487,228896518,32,78,106,216
"1975","chr1",229233196,229233217,22,8,27,57
"1976","chr1",229404579,229404598,20,8,122,150
"1977","chr1",229432497,229432526,30,109,67,206
"1978","chr1",229569708,229569742,35,4,25,64
"1979","chr1",229632812,229632831,20,99,128,247
"1980","chr1",229841212,229841248,37,66,5,108
"1981","chr1",229877441,229877458,18,10,5,33
"1982","chr1",230393825,230393844,20,47,6,73
"1983","chr1",230426223,230426267,45,5,26,76
"1984","chr1",230426471,230426488,18,11,20,49
"1985","chr1",230434344,230434383,40,29,144,213
"1986","chr1",230517320,230517389,70,105,137,312
"1987","chr1",230836193,230836217,25,92,31,148
"1988","chr1",230847103,230847129,27,145,6,178
"1989","chr1",230902388,230902412,25,69,68,162
"1990","chr1",230902542,230902560,19,36,102,157
"1991","chr1",230978735,230978752,18,38,11,67
"1992","chr1",230978797,230978817,21,103,72,196
"1993","chr1",231129384,231129408,25,41,6,72
"1994","chr1",231129860,231129889,30,7,22,59
"1995","chr1",231163725,231163753,29,84,118,231
"1996","chr1",231228599,231228616,18,59,43,120
"1997","chr1",231421889,231421924,36,21,97,154
"1998","chr1",231492865,231492902,38,87,75,200
"1999","chr1",231530711,231530728,18,16,18,52
"2000","chr1",231683426,231683443,18,76,67,161
"2001","chr1",232167658,232167679,22,76,19,117
"2002","chr1",232330651,232330670,20,33,132,185
"2003","chr1",232449518,232449537,20,119,6,145
"2004","chr1",232630076,232630100,25,110,2,137
"2005","chr1",232701094,232701126,33,69,6,108
"2006","chr1",232864516,232864534,19,94,19,132
"2007","chr1",232999440,232999470,31,75,15,121
"2008","chr1",233295575,233295615,41,69,25,135
"2009","chr1",233614033,233614070,38,32,28,98
"2010","chr1",233614081,233614098,18,60,92,170
"2011","chr1",234139952,234140002,51,44,70,165
"2012","chr1",234600197,234600259,63,92,14,169
"2013","chr1",234609516,234609541,26,4,94,124
"2014","chr1",234609614,234609651,38,45,51,134
"2015","chr1",234609766,234609802,37,24,72,133
"2016","chr1",234716327,234716352,26,47,68,141
"2017","chr1",234998861,234998901,41,77,66,184
"2018","chr1",235092940,235092968,29,91,5,125
"2019","chr1",235095173,235095193,21,8,1,30
"2020","chr1",235162990,235163010,21,115,41,177
"2021","chr1",235301535,235301554,20,32,127,179
"2022","chr1",235311776,235311810,35,91,72,198
"2023","chr1",235353001,235353018,18,125,42,185
"2024","chr1",235353016,235353038,23,145,27,195
"2025","chr1",235373612,235373666,55,76,142,273
"2026","chr1",235410030,235410050,21,62,74,157
"2027","chr1",235596173,235596199,27,91,75,193
"2028","chr1",235596210,235596253,44,145,38,227
"2029","chr1",235628180,235628218,39,13,74,126
"2030","chr1",235650093,235650137,45,43,26,114
"2031","chr1",235660715,235660739,25,144,27,196
"2032","chr1",235900244,235900280,37,12,76,125
"2033","chr1",235945766,235945843,78,87,34,199
"2034","chr1",236004762,236004782,21,35,74,130
"2035","chr1",236069322,236069351,30,29,143,202
"2036","chr1",236088822,236088844,23,8,128,159
"2037","chr1",236127954,236127987,34,26,76,136
"2038","chr1",236142385,236142434,50,66,23,139
"2039","chr1",236170040,236170064,25,54,6,85
"2040","chr1",236371950,236371968,19,70,61,150
"2041","chr1",236464424,236464450,27,76,18,121
"2042","chr1",236512277,236512304,28,29,79,136
"2043","chr1",236531304,236531339,36,43,36,115
"2044","chr1",236608065,236608095,31,124,65,220
"2045","chr1",236729326,236729343,18,68,5,91
"2046","chr1",237536715,237536736,22,77,6,105
"2047","chr1",237904978,237904996,19,56,52,127
"2048","chr1",237983996,237984014,19,8,50,77
"2049","chr1",238239037,238239082,46,76,108,230
"2050","chr1",238295707,238295724,18,27,143,188
"2051","chr1",238605762,238605795,34,80,28,142
"2052","chr1",238759312,238759339,28,37,143,208
"2053","chr1",238778725,238778745,21,5,19,45
"2054","chr1",238842309,238842330,22,25,143,190
"2055","chr1",239249728,239249750,23,29,75,127
"2056","chr1",239435458,239435484,27,133,65,225
"2057","chr1",239900378,239900395,18,136,12,166
"2058","chr1",239948440,239948471,32,8,128,168
"2059","chr1",240030912,240030937,26,31,5,62
"2060","chr1",240086310,240086330,21,69,5,95
"2061","chr1",240091879,240091899,21,13,142,176
"2062","chr1",240092724,240092785,62,27,4,93
"2063","chr1",240121367,240121394,28,77,41,146
"2064","chr1",240138065,240138086,22,46,31,99
"2065","chr1",240277526,240277550,25,8,6,39
"2066","chr1",240434527,240434579,53,76,65,194
"2067","chr1",240510370,240510399,30,138,6,174
"2068","chr1",240784189,240784220,32,9,72,113
"2069","chr1",240932877,240932901,25,9,76,110
"2070","chr1",241157802,241157833,32,73,30,135
"2071","chr1",241182649,241182667,19,10,137,166
"2072","chr1",241461362,241461397,36,95,57,188
"2073","chr1",241954185,241954207,23,138,97,258
"2074","chr1",242419573,242419594,22,37,65,124
"2075","chr1",242438431,242438461,31,27,75,133
"2076","chr1",242470342,242470398,57,86,7,150
"2077","chr1",242524520,242524543,24,1,2,27
"2078","chr1",242548312,242548340,29,66,6,101
"2079","chr1",242910553,242910585,33,17,74,124
"2080","chr1",243152522,243152549,28,76,10,114
"2081","chr1",243178309,243178335,27,82,26,135
"2082","chr1",243255125,243255142,18,115,87,220
"2083","chr1",243298351,243298374,24,75,117,216
"2084","chr1",243327887,243327918,32,6,105,143
"2085","chr1",243348203,243348223,21,29,75,125
"2086","chr1",243348819,243348836,18,145,26,189
"2087","chr1",243478957,243478977,21,102,75,198
"2088","chr1",243492296,243492319,24,76,87,187
"2089","chr1",243850296,243850321,26,2,63,91
"2090","chr1",243865615,243865638,24,4,140,168
"2091","chr1",243931086,243931103,18,50,59,127
"2092","chr1",243950848,243950871,24,115,61,200
"2093","chr1",243958347,243958386,40,7,70,117
"2094","chr1",244048596,244048650,55,16,19,90
"2095","chr1",244048672,244048699,28,9,42,79
"2096","chr1",244048905,244048923,19,20,30,69
"2097","chr1",244048926,244048952,27,14,9,50
"2098","chr1",244073482,244073502,21,8,56,85
"2099","chr1",244224946,244225149,204,130,100,434
"2100","chr1",244343809,244343827,19,5,121,145
"2101","chr1",244461256,244461274,19,73,113,205
"2102","chr1",244740717,244740736,20,11,28,59
"2103","chr1",244740757,244740797,41,72,18,131
"2104","chr1",244783564,244783586,23,9,74,106
"2105","chr1",244793328,244793368,41,75,108,224
"2106","chr1",244829138,244829170,33,108,119,260
"2107","chr1",244863106,244863123,18,62,81,161
"2108","chr1",244863396,244863421,26,27,49,102
"2109","chr1",244868089,244868131,43,21,125,189
"2110","chr1",244868740,244868761,22,28,75,125
"2111","chr1",244903482,244903511,30,139,73,242
"2112","chr1",244904905,244904922,18,77,76,171
"2113","chr1",244970268,244970285,18,32,15,65
"2114","chr1",244970634,244970681,48,30,10,88
"2115","chr1",245018227,245018247,21,123,6,150
"2116","chr1",245020604,245020638,35,9,58,102
"2117","chr1",245093698,245093738,41,5,72,118
"2118","chr1",245202760,245202780,21,134,6,161
"2119","chr1",245202941,245202970,30,145,6,181
"2120","chr1",245303198,245303216,19,8,18,45
"2121","chr1",245342549,245342572,24,129,84,237
"2122","chr1",245362365,245362388,24,145,35,204
"2123","chr1",245713033,245713056,24,14,27,65
"2124","chr1",245813006,245813032,27,8,57,92
"2125","chr1",246185450,246185472,23,69,29,121
"2126","chr1",246475330,246475347,18,134,73,225
"2127","chr1",246621997,246622031,35,102,4,141
"2128","chr1",246788447,246788474,28,9,118,155
"2129","chr1",246805687,246805729,43,70,70,183
"2130","chr1",246901617,246901642,26,100,82,208
"2131","chr1",246908724,246908745,22,74,35,131
"2132","chr1",246931479,246931512,34,43,14,91
"2133","chr1",247006225,247006248,24,65,74,163
"2134","chr1",247067436,247067454,19,41,6,66
"2135","chr1",247126698,247126715,18,42,31,91
"2136","chr1",247171727,247171744,18,33,40,91
"2137","chr1",247278226,247278249,24,79,49,152
"2138","chr1",247278248,247278279,32,109,27,168
"2139","chr1",247353992,247354028,37,86,123,246
"2140","chr1",247362706,247362724,19,77,26,122
"2141","chr1",247372470,247372502,33,23,134,190
"2142","chr1",247373523,247373552,30,3,6,39
"2143","chr1",247837443,247837466,24,16,73,113
"2144","chr1",247839444,247839476,33,10,21,64
"2145","chr1",247967216,247967247,32,9,13,54
"2146","chr1",248858947,248858966,20,38,112,170
"2147","chr1",248944954,248945029,76,106,84,266
"2148","chr10",76140,76160,21,38,73,132
"2149","chr10",77094,77112,19,21,64,104
"2150","chr10",98466,98484,19,74,26,119
"2151","chr10",350633,350657,25,77,138,240
"2152","chr10",372075,372093,19,76,67,162
"2153","chr10",548465,548482,18,66,122,206
"2154","chr10",548520,548545,26,33,67,126
"2155","chr10",689501,689518,18,18,15,51
"2156","chr10",689680,689711,32,16,121,169
"2157","chr10",690042,690065,24,17,111,152
"2158","chr10",787591,787616,26,76,12,114
"2159","chr10",869905,869951,47,38,53,138
"2160","chr10",892903,892927,25,75,81,181
"2161","chr10",931279,931316,38,13,38,89
"2162","chr10",931286,931322,37,19,31,87
"2163","chr10",931549,931569,21,1,55,77
"2164","chr10",931597,931616,20,54,7,81
"2165","chr10",931943,931997,55,11,16,82
"2166","chr10",940013,940034,22,7,143,172
"2167","chr10",1092180,1092203,24,35,6,65
"2168","chr10",1809959,1809991,33,9,33,75
"2169","chr10",1897576,1897602,27,9,121,157
"2170","chr10",2229248,2229275,28,8,76,112
"2171","chr10",2232852,2232884,33,8,75,116
"2172","chr10",2322422,2322439,18,97,74,189
"2173","chr10",2578362,2578380,19,34,6,59
"2174","chr10",2836578,2836616,39,8,28,75
"2175","chr10",3076018,3076040,23,142,67,232
"2176","chr10",3401045,3401072,28,26,70,124
"2177","chr10",3413988,3414022,35,127,4,166
"2178","chr10",3812467,3812484,18,22,15,55
"2179","chr10",4807476,4807500,25,122,142,289
"2180","chr10",4817719,4817741,23,20,34,77
"2181","chr10",4866629,4866661,33,86,98,217
"2182","chr10",5613450,5613474,25,111,76,212
"2183","chr10",5638404,5638421,18,26,6,50
"2184","chr10",5723044,5723069,26,4,38,68
"2185","chr10",5842916,5842957,42,144,6,192
"2186","chr10",5881690,5881707,18,10,17,45
"2187","chr10",6065886,6065908,23,47,120,190
"2188","chr10",6088986,6089022,37,17,65,119
"2189","chr10",6155198,6155220,23,8,101,132
"2190","chr10",6158291,6158326,36,46,4,86
"2191","chr10",6165979,6165997,19,100,78,197
"2192","chr10",6177341,6177500,160,33,3,196
"2193","chr10",6246309,6246348,40,68,104,212
"2194","chr10",6270145,6270177,33,77,61,171
"2195","chr10",6330618,6330643,26,36,75,137
"2196","chr10",6395057,6395080,24,7,3,34
"2197","chr10",6445122,6445149,28,37,76,141
"2198","chr10",6477869,6477896,28,46,73,147
"2199","chr10",6479768,6479795,28,137,29,194
"2200","chr10",7163124,7163150,27,125,53,205
"2201","chr10",7198977,7198995,19,7,70,96
"2202","chr10",7263229,7263256,28,73,39,140
"2203","chr10",7430888,7430924,37,8,6,51
"2204","chr10",7457082,7457101,20,9,37,66
"2205","chr10",7501052,7501074,23,13,6,42
"2206","chr10",7568987,7569033,47,8,89,144
"2207","chr10",7731726,7731749,24,56,5,85
"2208","chr10",7865478,7865515,38,40,75,153
"2209","chr10",7915643,7915661,19,85,6,110
"2210","chr10",8027642,8027667,26,70,59,155
"2211","chr10",8029641,8029678,38,75,5,118
"2212","chr10",8073145,8073170,26,110,74,210
"2213","chr10",8073706,8073723,18,5,84,107
"2214","chr10",8598821,8598864,44,53,23,120
"2215","chr10",9009298,9009324,27,76,76,179
"2216","chr10",9252272,9252298,27,136,74,237
"2217","chr10",9332380,9332424,45,25,143,213
"2218","chr10",9757788,9757845,58,79,77,214
"2219","chr10",9759045,9759066,22,100,24,146
"2220","chr10",10091971,10091999,29,68,25,122
"2221","chr10",10752689,10752727,39,82,75,196
"2222","chr10",10767996,10768016,21,77,6,104
"2223","chr10",10904393,10904411,19,122,125,266
"2224","chr10",10908215,10908237,23,8,13,44
"2225","chr10",10937104,10937143,40,91,54,185
"2226","chr10",11049559,11049582,24,81,81,186
"2227","chr10",11058770,11058797,28,7,143,178
"2228","chr10",11196650,11196674,25,146,42,213
"2229","chr10",11423791,11423837,47,37,18,102
"2230","chr10",11446651,11446726,76,20,56,152
"2231","chr10",11555093,11555120,28,52,17,97
"2232","chr10",11562262,11562279,18,99,74,191
"2233","chr10",11581944,11581968,25,62,138,225
"2234","chr10",11611514,11611544,31,11,6,48
"2235","chr10",11697335,11697358,24,91,84,199
"2236","chr10",11742312,11742382,71,1,72,144
"2237","chr10",11752279,11752299,21,35,75,131
"2238","chr10",11878153,11878188,36,23,137,196
"2239","chr10",11900855,11900883,29,17,76,122
"2240","chr10",11907583,11907602,20,29,75,124
"2241","chr10",11923671,11923689,19,45,83,147
"2242","chr10",12117863,12117905,43,74,9,126
"2243","chr10",12148240,12148262,23,7,144,174
"2244","chr10",12157503,12157521,19,101,143,263
"2245","chr10",12258601,12258633,33,7,5,45
"2246","chr10",12258881,12258915,35,8,46,89
"2247","chr10",12264943,12264977,35,60,6,101
"2248","chr10",12267332,12267349,18,23,81,122
"2249","chr10",12345468,12345485,18,9,78,105
"2250","chr10",12363244,12363271,28,35,142,205
"2251","chr10",12376163,12376187,25,7,56,88
"2252","chr10",12401896,12401914,19,77,127,223
"2253","chr10",12571454,12571480,27,79,1,107
"2254","chr10",12602896,12602924,29,4,89,122
"2255","chr10",12739443,12739462,20,29,106,155
"2256","chr10",12900523,12900544,22,148,22,192
"2257","chr10",12917181,12917213,33,10,105,148
"2258","chr10",12963580,12963600,21,78,146,245
"2259","chr10",13074326,13074363,38,33,143,214
"2260","chr10",13074566,13074592,27,4,65,96
"2261","chr10",13117440,13117463,24,76,85,185
"2262","chr10",13235211,13235245,35,3,5,43
"2263","chr10",13249165,13249183,19,8,100,127
"2264","chr10",13288722,13288760,39,145,119,303
"2265","chr10",13296169,13296194,26,47,41,114
"2266","chr10",13300978,13301002,25,3,74,102
"2267","chr10",13308928,13308948,21,129,7,157
"2268","chr10",13347371,13347391,21,29,7,57
"2269","chr10",13347781,13347807,27,50,10,87
"2270","chr10",13348113,13348133,21,39,21,81
"2271","chr10",13391504,13391534,31,10,71,112
"2272","chr10",13528579,13528610,32,10,30,72
"2273","chr10",13528888,13528917,30,3,13,46
"2274","chr10",13528955,13528974,20,8,15,43
"2275","chr10",13590453,13590472,20,78,24,122
"2276","chr10",13683420,13683447,28,77,1,106
"2277","chr10",13713760,13714060,301,56,124,481
"2278","chr10",13891758,13891789,32,7,77,116
"2279","chr10",13992953,13992978,26,19,75,120
"2280","chr10",13994176,13994200,25,79,76,180
"2281","chr10",14174261,14174318,58,5,50,113
"2282","chr10",14184803,14184827,25,105,8,138
"2283","chr10",14330940,14330986,47,6,35,88
"2284","chr10",14497798,14497820,23,76,63,162
"2285","chr10",14517709,14517751,43,72,42,157
"2286","chr10",14583087,14583109,23,101,5,129
"2287","chr10",14604434,14604458,25,7,1,33
"2288","chr10",14782503,14782527,25,145,27,197
"2289","chr10",14814975,14814995,21,10,58,89
"2290","chr10",15026811,15026853,43,17,119,179
"2291","chr10",15168719,15168794,76,15,80,171
"2292","chr10",15312674,15312714,41,9,62,112
"2293","chr10",15370875,15370905,31,85,11,127
"2294","chr10",15371244,15371266,23,27,4,54
"2295","chr10",15490475,15490494,20,8,115,143
"2296","chr10",15680217,15680245,29,76,55,160
"2297","chr10",16739616,16739634,19,119,90,228
"2298","chr10",16799507,16799538,32,137,79,248
"2299","chr10",17454195,17454216,22,60,53,135
"2300","chr10",17454330,17454353,24,23,67,114
"2301","chr10",17524466,17524485,20,29,76,125
"2302","chr10",17617425,17617443,19,80,131,230
"2303","chr10",17618356,17618407,52,35,120,207
"2304","chr10",17637281,17637301,21,38,143,202
"2305","chr10",17752916,17752950,35,64,96,195
"2306","chr10",17832555,17832576,22,47,6,75
"2307","chr10",17930763,17930781,19,34,29,82
"2308","chr10",18085304,18085330,27,77,105,209
"2309","chr10",18639088,18639113,26,48,38,112
"2310","chr10",18663945,18663972,28,9,48,85
"2311","chr10",18695320,18695344,25,8,19,52
"2312","chr10",18704056,18704082,27,122,93,242
"2313","chr10",19816384,19816401,18,63,79,160
"2314","chr10",19944953,19944975,23,56,73,152
"2315","chr10",20578884,20578906,23,100,74,197
"2316","chr10",20894751,20894779,29,117,35,181
"2317","chr10",21063873,21063897,25,52,71,148
"2318","chr10",21063891,21063913,23,68,53,144
"2319","chr10",21173850,21173867,18,46,28,92
"2320","chr10",21174057,21174076,20,20,47,87
"2321","chr10",21196314,21196360,47,6,132,185
"2322","chr10",21245528,21245547,20,6,79,105
"2323","chr10",21476857,21476879,23,77,7,107
"2324","chr10",21516538,21516589,52,17,72,141
"2325","chr10",21516769,21516814,46,4,104,154
"2326","chr10",21516876,21516917,42,29,42,113
"2327","chr10",21517091,21517150,60,10,20,90
"2328","chr10",21534411,21534449,39,40,103,182
"2329","chr10",21535067,21535091,25,2,68,95
"2330","chr10",21535112,21535147,36,128,23,187
"2331","chr10",21554813,21554831,19,68,87,174
"2332","chr10",21594554,21594576,23,55,1,79
"2333","chr10",21660616,21660636,21,45,6,72
"2334","chr10",21861905,21861934,30,6,11,47
"2335","chr10",22003318,22003345,28,85,20,133
"2336","chr10",22321136,22321162,27,22,106,155
"2337","chr10",22321391,22321460,70,103,50,223
"2338","chr10",22325626,22325663,38,15,88,141
"2339","chr10",22759189,22759213,25,112,26,163
"2340","chr10",23193464,23193486,23,29,55,107
"2341","chr10",23409454,23409492,39,42,66,147
"2342","chr10",23485677,23485708,32,8,144,184
"2343","chr10",24038748,24038769,22,16,62,100
"2344","chr10",24208937,24208960,24,1,134,159
"2345","chr10",24380615,24380654,40,119,102,261
"2346","chr10",24415111,24415131,21,7,113,141
"2347","chr10",24666023,24666045,23,6,27,56
"2348","chr10",24702128,24702148,21,76,144,241
"2349","chr10",24723674,24723701,28,7,76,111
"2350","chr10",24789739,24789762,24,85,77,186
"2351","chr10",24871070,24871090,21,73,8,102
"2352","chr10",24952656,24952700,45,6,63,114
"2353","chr10",25457141,25457166,26,77,74,177
"2354","chr10",25580896,25580932,37,66,23,126
"2355","chr10",25884885,25884907,23,8,30,61
"2356","chr10",26135967,26135984,18,107,5,130
"2357","chr10",26391518,26391545,28,19,96,143
"2358","chr10",26567149,26567172,24,118,7,149
"2359","chr10",26567281,26567330,50,74,74,198
"2360","chr10",26933982,26934006,25,50,57,132
"2361","chr10",26934006,26934031,26,7,33,66
"2362","chr10",27109651,27109671,21,16,16,53
"2363","chr10",27175169,27175199,31,7,16,54
"2364","chr10",27331057,27331081,25,39,74,138
"2365","chr10",27401747,27401786,40,15,70,125
"2366","chr10",27625237,27625265,29,67,8,104
"2367","chr10",27746966,27747011,46,2,119,167
"2368","chr10",28302648,28302674,27,52,4,83
"2369","chr10",28310003,28310020,18,9,68,95
"2370","chr10",28356940,28356957,18,39,66,123
"2371","chr10",28357360,28357402,43,9,133,185
"2372","chr10",28489960,28489986,27,37,75,139
"2373","chr10",28533161,28533179,19,23,17,59
"2374","chr10",28533234,28533282,49,11,42,102
"2375","chr10",28533488,28533511,24,17,35,76
"2376","chr10",28630989,28631015,27,9,60,96
"2377","chr10",28699911,28699934,24,8,88,120
"2378","chr10",28732768,28732788,21,8,75,104
"2379","chr10",28817968,28817987,20,20,83,123
"2380","chr10",28826686,28826729,44,7,101,152
"2381","chr10",29154787,29154809,23,10,86,119
"2382","chr10",29622250,29622275,26,34,6,66
"2383","chr10",29760744,29760765,22,8,7,37
"2384","chr10",29782360,29782403,44,64,74,182
"2385","chr10",30027572,30027606,35,78,29,142
"2386","chr10",30031751,30031772,22,8,1,31
"2387","chr10",30156812,30156829,18,104,74,196
"2388","chr10",30339123,30339152,30,95,6,131
"2389","chr10",30349280,30349301,22,9,96,127
"2390","chr10",30391194,30391232,39,16,66,121
"2391","chr10",30429701,30429726,26,7,21,54
"2392","chr10",30471037,30471056,20,78,40,138
"2393","chr10",30484801,30484845,45,108,54,207
"2394","chr10",30583300,30583317,18,76,57,151
"2395","chr10",30650374,30650414,41,75,35,151
"2396","chr10",30715846,30716186,341,54,126,521
"2397","chr10",30736478,30736529,52,7,108,167
"2398","chr10",30737455,30737472,18,76,117,211
"2399","chr10",30872426,30872466,41,11,74,126
"2400","chr10",31032772,31032791,20,8,47,75
"2401","chr10",31061699,31061727,29,9,46,84
"2402","chr10",31318543,31318560,18,23,119,160
"2403","chr10",31928536,31928556,21,16,66,103
"2404","chr10",31970052,31970081,30,5,20,55
"2405","chr10",32163827,32163856,30,8,118,156
"2406","chr10",32180937,32180966,30,8,6,44
"2407","chr10",32211528,32211557,30,7,60,97
"2408","chr10",32225355,32225379,25,27,75,127
"2409","chr10",32252167,32252186,20,147,143,310
"2410","chr10",32351719,32351745,27,5,13,45
"2411","chr10",32957999,32958030,32,12,8,52
"2412","chr10",33100790,33100817,28,84,54,166
"2413","chr10",33203723,33203751,29,69,42,140
"2414","chr10",33285834,33285875,42,84,73,199
"2415","chr10",33318989,33319022,34,76,124,234
"2416","chr10",33334669,33334692,24,9,86,119
"2417","chr10",33962026,33962046,21,74,54,149
"2418","chr10",34101063,34101082,20,32,79,131
"2419","chr10",34355925,34355956,32,57,74,163
"2420","chr10",34605181,34605210,30,77,96,203
"2421","chr10",34727879,34727907,29,51,16,96
"2422","chr10",34815324,34815370,47,95,26,168
"2423","chr10",34851021,34851045,25,76,85,186
"2424","chr10",34855092,34855113,22,76,75,173
"2425","chr10",34901460,34901479,20,136,5,161
"2426","chr10",34934873,34934892,20,134,6,160
"2427","chr10",34971237,34971261,25,27,21,73
"2428","chr10",35021790,35021907,118,125,97,340
"2429","chr10",35073571,35073619,49,5,10,64
"2430","chr10",35090268,35090291,24,38,3,65
"2431","chr10",35106487,35106516,30,41,52,123
"2432","chr10",35227598,35227615,18,9,24,51
"2433","chr10",35240767,35240786,20,85,6,111
"2434","chr10",35336845,35336866,22,12,115,149
"2435","chr10",35624550,35624576,27,69,74,170
"2436","chr10",35640325,35640377,53,25,81,159
"2437","chr10",35640915,35640943,29,13,107,149
"2438","chr10",35641988,35642006,19,33,4,56
"2439","chr10",35804257,35804274,18,77,28,123
"2440","chr10",35898209,35898243,35,51,123,209
"2441","chr10",35898241,35898267,27,75,91,193
"2442","chr10",36002096,36002132,37,131,59,227
"2443","chr10",36232186,36232217,32,78,35,145
"2444","chr10",36374808,36374834,27,4,57,88
"2445","chr10",36444467,36444516,50,4,73,127
"2446","chr10",36715725,36715743,19,88,41,148
"2447","chr10",37124960,37124979,20,8,68,96
"2448","chr10",37460357,37460380,24,5,6,35
"2449","chr10",37790271,37790290,20,7,74,101
"2450","chr10",37988401,37988432,32,64,78,174
"2451","chr10",38200615,38200660,46,8,40,94
"2452","chr10",38353699,38353733,35,65,26,126
"2453","chr10",38442406,38442426,21,107,97,225
"2454","chr10",38451629,38451647,19,57,51,127
"2455","chr10",38730689,38730715,27,119,6,152
"2456","chr10",42122796,42122819,24,97,74,195
"2457","chr10",42241791,42241814,24,126,122,272
"2458","chr10",42371418,42371446,29,17,75,121
"2459","chr10",42424098,42424118,21,40,5,66
"2460","chr10",42752195,42752216,22,7,17,46
"2461","chr10",42932895,42932912,18,61,77,156
"2462","chr10",43077011,43077029,19,22,7,48
"2463","chr10",43077295,43077323,29,15,13,57
"2464","chr10",43138789,43138813,25,25,46,96
"2465","chr10",43266543,43266567,25,9,93,127
"2466","chr10",43342419,43342445,27,92,97,216
"2467","chr10",43396888,43396921,34,78,15,127
"2468","chr10",43424758,43424789,32,62,106,200
"2469","chr10",43426947,43426983,37,139,5,181
"2470","chr10",43433781,43433801,21,110,6,137
"2471","chr10",43436002,43436028,27,85,6,118
"2472","chr10",43444562,43444590,29,80,87,196
"2473","chr10",43468680,43468704,25,147,5,177
"2474","chr10",43487930,43487956,27,145,26,198
"2475","chr10",44064499,44064519,21,20,94,135
"2476","chr10",44385009,44385032,24,2,30,56
"2477","chr10",44385138,44385156,19,13,64,96
"2478","chr10",44386510,44386537,28,104,65,197
"2479","chr10",44386535,44386564,30,8,40,78
"2480","chr10",44887920,44887940,21,137,6,164
"2481","chr10",45032992,45033029,38,8,75,121
"2482","chr10",45152175,45152199,25,54,74,153
"2483","chr10",45165883,45165915,33,28,144,205
"2484","chr10",45245840,45245875,36,9,4,49
"2485","chr10",45555055,45555077,23,143,74,240
"2486","chr10",45594600,45594637,38,106,32,176
"2487","chr10",45678635,45678667,33,1,90,124
"2488","chr10",45744050,45744072,23,143,142,308
"2489","chr10",45847498,45847525,28,74,141,243
"2490","chr10",45869703,45869811,109,102,124,335
"2491","chr10",45870327,45870371,45,75,119,239
"2492","chr10",45870458,45870516,59,73,139,271
"2493","chr10",45870605,45870663,59,102,139,300
"2494","chr10",45872659,45872773,115,102,35,252
"2495","chr10",45993654,45993768,115,27,100,242
"2496","chr10",45993820,45993880,61,80,100,241
"2497","chr10",45993896,45993928,33,128,24,185
"2498","chr10",46078866,46078886,21,25,75,121
"2499","chr10",46349834,46349874,41,41,4,86
"2500","chr10",46598740,46598762,23,37,66,126
"2501","chr10",46701071,46701088,18,78,61,157
"2502","chr10",47300696,47300715,20,119,44,183
"2503","chr10",47377601,47377638,38,51,135,224
"2504","chr10",47377672,47377718,47,131,64,242
"2505","chr10",47510916,47510938,23,53,38,114
"2506","chr10",47510936,47510959,24,6,18,48
"2507","chr10",47639299,47639316,18,62,76,156
"2508","chr10",47739938,47739957,20,92,27,139
"2509","chr10",47742991,47743012,22,68,35,125
"2510","chr10",48019012,48019030,19,53,39,111
"2511","chr10",48019028,48019051,24,6,23,53
"2512","chr10",48403918,48403958,41,116,73,230
"2513","chr10",48517214,48517242,29,80,66,175
"2514","chr10",48656266,48656290,25,69,4,98
"2515","chr10",48715794,48715820,27,27,129,183
"2516","chr10",49190765,49190782,18,20,73,111
"2517","chr10",49217309,49217347,39,138,61,238
"2518","chr10",49963194,49963222,29,130,8,167
"2519","chr10",49963293,49963407,115,37,100,252
"2520","chr10",49964884,49964939,56,14,46,116
"2521","chr10",50001341,50001359,19,48,63,130
"2522","chr10",50084732,50084750,19,144,142,305
"2523","chr10",50090113,50090131,19,59,3,81
"2524","chr10",50495036,50495088,53,145,6,204
"2525","chr10",50905882,50905903,22,18,67,107
"2526","chr10",51324572,51324592,21,146,47,214
"2527","chr10",52681397,52681418,22,21,41,84
"2528","chr10",52681446,52681473,28,8,23,59
"2529","chr10",52884944,52884964,21,76,62,159
"2530","chr10",52935173,52935198,26,33,71,130
"2531","chr10",53249426,53249448,23,141,74,238
"2532","chr10",53304480,53304501,22,111,6,139
"2533","chr10",53471762,53471786,25,76,129,230
"2534","chr10",53841948,53841965,18,144,87,249
"2535","chr10",55195487,55195506,20,78,27,125
"2536","chr10",55341763,55341806,44,15,49,108
"2537","chr10",55341806,55341831,26,40,6,72
"2538","chr10",57056862,57056892,31,49,6,86
"2539","chr10",57270464,57270483,20,16,75,111
"2540","chr10",57591396,57591417,22,3,74,99
"2541","chr10",58148878,58148900,23,58,16,97
"2542","chr10",58197301,58197360,60,139,5,204
"2543","chr10",58319240,58319260,21,126,104,251
"2544","chr10",58707694,58707713,20,6,78,104
"2545","chr10",59287034,59287054,21,12,6,39
"2546","chr10",59663366,59663391,26,85,69,180
"2547","chr10",59693924,59693954,31,7,6,44
"2548","chr10",59709884,59709906,23,54,9,86
"2549","chr10",60176180,60176212,33,142,24,199
"2550","chr10",60176369,60176398,30,16,2,48
"2551","chr10",60492707,60492747,41,100,6,147
"2552","chr10",61443297,61443315,19,145,28,192
"2553","chr10",62136663,62136681,19,76,136,231
"2554","chr10",62692442,62692465,24,132,22,178
"2555","chr10",62813711,62813728,18,85,31,134
"2556","chr10",62994549,62994576,28,6,75,109
"2557","chr10",63037830,63037859,30,41,75,146
"2558","chr10",63309495,63309518,24,29,72,125
"2559","chr10",63363854,63363873,20,76,107,203
"2560","chr10",63414736,63414755,20,143,23,186
"2561","chr10",63444624,63444641,18,124,95,237
"2562","chr10",63466140,63466162,23,1,4,28
"2563","chr10",63598484,63598502,19,80,34,133
"2564","chr10",63651530,63651557,28,73,80,181
"2565","chr10",65881509,65881543,35,75,112,222
"2566","chr10",66493904,66493925,22,76,12,110
"2567","chr10",67139300,67139320,21,29,143,193
"2568","chr10",67731856,67731877,22,107,20,149
"2569","chr10",67849219,67849300,82,25,26,133
"2570","chr10",67869024,67869042,19,76,126,221
"2571","chr10",68093575,68093594,20,63,120,203
"2572","chr10",68157671,68157692,22,145,34,201
"2573","chr10",68173076,68173098,23,31,3,57
"2574","chr10",68238764,68238784,21,8,75,104
"2575","chr10",68259931,68259952,22,88,73,183
"2576","chr10",68429883,68429900,18,7,146,171
"2577","chr10",68464516,68464539,24,135,5,164
"2578","chr10",68505347,68505371,25,26,8,59
"2579","chr10",68575703,68575739,37,14,73,124
"2580","chr10",68580314,68580338,25,77,59,161
"2581","chr10",68652678,68652706,29,18,21,68
"2582","chr10",68688431,68688452,22,76,100,198
"2583","chr10",68702688,68702710,23,29,75,127
"2584","chr10",68713324,68713342,19,112,72,203
"2585","chr10",68713358,68713375,18,12,38,68
"2586","chr10",68714472,68714515,44,121,6,171
"2587","chr10",68751908,68751934,27,76,30,133
"2588","chr10",68809194,68809211,18,3,136,157
"2589","chr10",68840348,68840370,23,7,9,39
"2590","chr10",68843541,68843559,19,60,142,221
"2591","chr10",68905915,68905937,23,48,72,143
"2592","chr10",68930038,68930116,79,57,5,141
"2593","chr10",69050321,69050352,32,11,56,99
"2594","chr10",69151265,69151283,19,128,6,153
"2595","chr10",69294862,69294882,21,80,6,107
"2596","chr10",69310117,69310135,19,9,7,35
"2597","chr10",69318837,69318855,19,135,7,161
"2598","chr10",69396271,69396306,36,15,7,58
"2599","chr10",69801822,69801860,39,1,55,95
"2600","chr10",69802377,69802403,27,62,58,147
"2601","chr10",69998827,69998854,28,135,6,169
"2602","chr10",70106803,70106822,20,51,1,72
"2603","chr10",70121224,70121252,29,88,84,201
"2604","chr10",70121257,70121279,23,115,51,189
"2605","chr10",70132752,70132791,40,4,69,113
"2606","chr10",70404220,70404239,20,19,30,69
"2607","chr10",70451360,70451409,50,111,8,169
"2608","chr10",70451728,70451785,58,14,6,78
"2609","chr10",70464625,70464643,19,8,34,61
"2610","chr10",70505604,70505648,45,61,6,112
"2611","chr10",70513337,70513363,27,80,29,136
"2612","chr10",70733811,70733830,20,2,122,144
"2613","chr10",70818090,70818136,47,42,147,236
"2614","chr10",71189967,71190014,48,7,86,141
"2615","chr10",71212900,71212927,28,83,10,121
"2616","chr10",71213676,71213709,34,25,64,123
"2617","chr10",71213729,71213762,34,78,11,123
"2618","chr10",71224229,71224270,42,141,65,248
"2619","chr10",71235076,71235120,45,109,111,265
"2620","chr10",71318373,71318395,23,69,127,219
"2621","chr10",71403310,71403529,220,71,117,408
"2622","chr10",71599006,71599032,27,141,130,298
"2623","chr10",71642394,71642416,23,76,143,242
"2624","chr10",71827399,71827435,37,138,6,181
"2625","chr10",71833017,71833044,28,142,6,176
"2626","chr10",71835220,71835255,36,96,96,228
"2627","chr10",71835247,71835269,23,110,69,202
"2628","chr10",71861709,71861726,18,7,39,64
"2629","chr10",71871316,71871342,27,34,143,204
"2630","chr10",71886043,71886061,19,70,39,128
"2631","chr10",71915944,71915961,18,121,6,145
"2632","chr10",71964327,71964350,24,100,66,190
"2633","chr10",72162161,72162186,26,6,98,130
"2634","chr10",72218146,72218166,21,95,68,184
"2635","chr10",72218166,72218219,54,148,48,250
"2636","chr10",72279328,72279354,27,29,47,103
"2637","chr10",72281523,72281541,19,76,93,188
"2638","chr10",72289803,72289839,37,32,73,142
"2639","chr10",72290098,72290118,21,76,10,107
"2640","chr10",72297001,72297023,23,8,2,33
"2641","chr10",72299863,72299882,20,65,6,91
"2642","chr10",72386558,72386577,20,125,69,214
"2643","chr10",72476227,72476247,21,46,6,73
"2644","chr10",72492763,72492827,65,5,74,144
"2645","chr10",72504953,72504986,34,71,137,242
"2646","chr10",72692200,72692235,36,8,21,65
"2647","chr10",72904111,72904133,23,145,46,214
"2648","chr10",73059425,73059461,37,13,123,173
"2649","chr10",73059745,73059792,48,24,4,76
"2650","chr10",73168309,73168340,32,77,61,170
"2651","chr10",73307990,73308007,18,79,26,123
"2652","chr10",73361294,73361312,19,78,15,112
"2653","chr10",73377768,73377801,34,51,140,225
"2654","chr10",73377827,73377852,26,102,81,209
"2655","chr10",73495837,73495859,23,35,27,85
"2656","chr10",73560664,73560689,26,14,6,46
"2657","chr10",73683438,73683456,19,53,39,111
"2658","chr10",73683454,73683477,24,6,23,53
"2659","chr10",73702134,73702154,21,8,18,47
"2660","chr10",73748108,73748152,45,7,132,184
"2661","chr10",73819655,73819687,33,80,86,199
"2662","chr10",73874612,73874639,28,9,64,101
"2663","chr10",73899814,73899838,25,11,61,97
"2664","chr10",73963139,73963169,31,76,12,119
"2665","chr10",73978595,73978621,27,11,6,44
"2666","chr10",73986232,73986252,21,10,4,35
"2667","chr10",74039252,74039269,18,29,106,153
"2668","chr10",74084282,74084309,28,126,28,182
"2669","chr10",74087300,74087322,23,35,91,149
"2670","chr10",74087320,74087363,44,76,71,191
"2671","chr10",74101863,74101880,18,5,3,26
"2672","chr10",74157717,74157735,19,70,52,141
"2673","chr10",74168537,74168568,32,14,76,122
"2674","chr10",74172690,74172710,21,31,5,57
"2675","chr10",74284267,74284284,18,10,2,30
"2676","chr10",74750273,74750295,23,20,1,44
"2677","chr10",74788310,74788331,22,137,75,234
"2678","chr10",74790264,74790290,27,5,73,105
"2679","chr10",74825497,74825527,31,18,21,70
"2680","chr10",74825912,74825931,20,116,3,139
"2681","chr10",74871186,74871210,25,8,54,87
"2682","chr10",74890543,74890565,23,44,103,170
"2683","chr10",75043734,75043782,49,96,52,197
"2684","chr10",75169170,75169193,24,136,74,234
"2685","chr10",75174431,75174451,21,75,9,105
"2686","chr10",75191387,75191406,20,76,14,110
"2687","chr10",75194060,75194078,19,9,128,156
"2688","chr10",75209570,75209595,26,115,144,285
"2689","chr10",75227883,75227901,19,65,134,218
"2690","chr10",75235139,75235158,20,59,98,177
"2691","chr10",75259566,75259589,24,28,70,122
"2692","chr10",75259613,75259637,25,8,23,56
"2693","chr10",75400082,75400122,41,25,11,77
"2694","chr10",75401340,75401373,34,25,79,138
"2695","chr10",75401883,75401900,18,132,23,173
"2696","chr10",75428873,75428897,25,35,107,167
"2697","chr10",75792258,75792283,26,77,39,142
"2698","chr10",75964751,75964769,19,105,115,239
"2699","chr10",76132967,76132994,28,29,146,203
"2700","chr10",76743906,76743934,29,145,35,209
"2701","chr10",76923429,76923453,25,12,74,111
"2702","chr10",77106268,77106290,23,31,43,97
"2703","chr10",77412841,77412873,33,6,7,46
"2704","chr10",77595347,77595371,25,65,6,96
"2705","chr10",77637464,77637528,65,19,84,168
"2706","chr10",77637741,77637760,20,8,69,97
"2707","chr10",77713156,77713183,28,104,5,137
"2708","chr10",77736019,77736049,31,76,14,121
"2709","chr10",77900938,77900956,19,68,71,158
"2710","chr10",77903428,77903465,38,142,6,186
"2711","chr10",77926759,77926801,43,37,10,90
"2712","chr10",77939180,77939211,32,70,6,108
"2713","chr10",77981869,77981889,21,77,27,125
"2714","chr10",78032139,78032178,40,142,1,183
"2715","chr10",78032638,78032665,28,6,81,115
"2716","chr10",78032957,78032995,39,73,3,115
"2717","chr10",78033160,78033180,21,35,63,119
"2718","chr10",78115332,78115351,20,79,88,187
"2719","chr10",78320478,78320495,18,23,41,82
"2720","chr10",78502542,78502560,19,73,50,142
"2721","chr10",78570789,78570813,25,100,140,265
"2722","chr10",78973956,78973993,38,55,22,115
"2723","chr10",79033246,79033277,32,33,73,138
"2724","chr10",79062489,79062506,18,47,9,74
"2725","chr10",79080301,79080324,24,76,79,179
"2726","chr10",79114457,79114541,85,69,19,173
"2727","chr10",79242540,79242567,28,17,31,76
"2728","chr10",79243348,79243366,19,15,51,85
"2729","chr10",79265455,79265485,31,13,87,131
"2730","chr10",79288514,79288549,36,33,122,191
"2731","chr10",79305143,79305160,18,62,49,129
"2732","chr10",79394120,79394137,18,20,103,141
"2733","chr10",79445582,79445609,28,35,25,88
"2734","chr10",79446679,79446702,24,84,14,122
"2735","chr10",79502343,79502381,39,37,74,150
"2736","chr10",79663074,79663091,18,29,106,153
"2737","chr10",79826377,79826404,28,25,95,148
"2738","chr10",80047694,80047721,28,76,46,150
"2739","chr10",80059532,80059568,37,8,16,61
"2740","chr10",80124791,80124843,53,36,75,164
"2741","chr10",80404033,80404057,25,6,134,165
"2742","chr10",80512872,80512900,29,60,132,221
"2743","chr10",80587264,80587289,26,67,9,102
"2744","chr10",81164886,81164905,20,112,140,272
"2745","chr10",81823411,81823428,18,29,7,54
"2746","chr10",81875211,81875283,73,104,7,184
"2747","chr10",81875416,81875467,52,94,8,154
"2748","chr10",82479665,82479686,22,141,73,236
"2749","chr10",83866622,83866672,51,32,67,150
"2750","chr10",84307527,84307545,19,119,116,254
"2751","chr10",84436326,84436353,28,12,74,114
"2752","chr10",84483954,84483997,44,82,141,267
"2753","chr10",85096971,85096998,28,8,88,124
"2754","chr10",85428586,85428610,25,6,11,42
"2755","chr10",86062268,86062297,30,36,51,117
"2756","chr10",86069648,86069667,20,62,74,156
"2757","chr10",86080374,86080485,112,19,34,165
"2758","chr10",86366556,86366581,26,86,14,126
"2759","chr10",86366806,86366852,47,11,81,139
"2760","chr10",86412957,86412975,19,72,74,165
"2761","chr10",86429955,86429978,24,74,56,154
"2762","chr10",86510069,86510092,24,76,36,136
"2763","chr10",86532005,86532025,21,9,74,104
"2764","chr10",86597721,86597755,35,72,29,136
"2765","chr10",86697527,86697571,45,76,5,126
"2766","chr10",86883550,86883570,21,94,6,121
"2767","chr10",86939161,86939181,21,147,75,243
"2768","chr10",86939462,86939493,32,11,74,117
"2769","chr10",87094220,87094238,19,26,25,70
"2770","chr10",87095085,87095159,75,76,35,186
"2771","chr10",87095164,87095192,29,109,10,148
"2772","chr10",87144938,87144958,21,76,137,234
"2773","chr10",87343049,87343069,21,25,7,53
"2774","chr10",87659882,87659907,26,33,2,61
"2775","chr10",87659906,87659924,19,50,110,179
"2776","chr10",87863422,87863450,29,54,42,125
"2777","chr10",87863968,87863993,26,18,94,138
"2778","chr10",88704069,88704089,21,40,8,69
"2779","chr10",89248443,89248491,49,7,29,85
"2780","chr10",89389976,89389998,23,70,103,196
"2781","chr10",89534645,89534671,27,70,121,218
"2782","chr10",90858056,90858123,68,15,104,187
"2783","chr10",90971544,90971574,31,32,27,90
"2784","chr10",91070065,91070092,28,146,75,249
"2785","chr10",91162867,91162897,31,61,85,177
"2786","chr10",91778443,91778461,19,29,62,110
"2787","chr10",91910392,91910423,32,74,17,123
"2788","chr10",92120258,92120292,35,137,24,196
"2789","chr10",92142018,92142053,36,52,6,94
"2790","chr10",92239512,92239534,23,131,18,172
"2791","chr10",92254855,92254888,34,105,95,234
"2792","chr10",92264716,92264733,18,111,74,203
"2793","chr10",92420325,92420344,20,132,40,192
"2794","chr10",92436188,92436209,22,8,46,76
"2795","chr10",92437231,92437266,36,13,74,123
"2796","chr10",92448901,92448922,22,8,136,166
"2797","chr10",92491604,92491625,22,55,76,153
"2798","chr10",92501363,92501391,29,148,123,300
"2799","chr10",92515561,92515578,18,8,145,171
"2800","chr10",92577513,92577532,20,142,140,302
"2801","chr10",92583540,92583559,20,62,5,87
"2802","chr10",92592639,92592668,30,127,5,162
"2803","chr10",92742014,92742031,18,103,69,190
"2804","chr10",92831427,92831450,24,75,22,121
"2805","chr10",93050760,93050781,22,136,6,164
"2806","chr10",93128156,93128183,28,145,49,222
"2807","chr10",93169097,93169134,38,7,32,77
"2808","chr10",93260288,93260319,32,90,36,158
"2809","chr10",93305946,93305965,20,7,145,172
"2810","chr10",93546846,93546865,20,7,133,160
"2811","chr10",93583247,93583266,20,145,27,192
"2812","chr10",93601100,93601127,28,7,125,160
"2813","chr10",93702523,93702548,26,26,37,89
"2814","chr10",93969953,93970063,111,10,25,146
"2815","chr10",94188590,94188622,33,7,55,95
"2816","chr10",94235063,94235100,38,14,87,139
"2817","chr10",94340981,94341000,20,9,6,35
"2818","chr10",94403609,94403642,34,119,26,179
"2819","chr10",94403651,94403683,33,2,43,78
"2820","chr10",94488387,94488408,22,8,7,37
"2821","chr10",94618462,94618509,48,125,80,253
"2822","chr10",95357355,95357398,44,81,26,151
"2823","chr10",95520315,95520341,27,5,73,105
"2824","chr10",95694896,95694918,23,8,94,125
"2825","chr10",95709744,95709781,38,44,35,117
"2826","chr10",96003587,96003629,43,30,74,147
"2827","chr10",96100386,96100404,19,149,71,239
"2828","chr10",96119138,96119179,42,6,39,87
"2829","chr10",96355097,96355136,40,23,6,69
"2830","chr10",96380693,96380723,31,64,6,101
"2831","chr10",96580265,96580284,20,9,30,59
"2832","chr10",96586766,96586785,20,75,25,120
"2833","chr10",96586881,96586922,42,113,25,180
"2834","chr10",96767052,96767076,25,147,5,177
"2835","chr10",96832410,96832448,39,54,26,119
"2836","chr10",96832690,96832729,40,125,5,170
"2837","chr10",96856056,96856077,22,65,47,134
"2838","chr10",96868259,96868290,32,6,69,107
"2839","chr10",97248817,97248837,21,11,99,131
"2840","chr10",97319490,97319521,32,19,1,52
"2841","chr10",97366765,97366798,34,99,98,231
"2842","chr10",97391574,97391597,24,105,71,200
"2843","chr10",97422205,97422229,25,123,48,196
"2844","chr10",97449862,97449882,21,69,113,203
"2845","chr10",97492137,97492156,20,115,7,142
"2846","chr10",97532799,97532822,24,85,65,174
"2847","chr10",97587808,97587825,18,5,93,116
"2848","chr10",97602999,97603017,19,6,138,163
"2849","chr10",97617858,97617887,30,6,76,112
"2850","chr10",97721114,97721134,21,76,146,243
"2851","chr10",97732767,97732787,21,7,137,165
"2852","chr10",97771933,97771952,20,40,102,162
"2853","chr10",97783576,97783616,41,8,143,192
"2854","chr10",97865636,97865672,37,5,128,170
"2855","chr10",97904406,97904432,27,40,97,164
"2856","chr10",98414925,98414942,18,11,41,70
"2857","chr10",98638138,98638163,26,13,44,83
"2858","chr10",99112404,99112461,58,28,146,232
"2859","chr10",99316776,99316799,24,73,60,157
"2860","chr10",99516660,99516685,26,34,118,178
"2861","chr10",99535437,99535471,35,36,25,96
"2862","chr10",99536427,99536445,19,63,97,179
"2863","chr10",99558538,99558564,27,88,119,234
"2864","chr10",99580475,99580506,32,16,104,152
"2865","chr10",99615357,99615375,19,58,6,83
"2866","chr10",99734065,99734086,22,7,7,36
"2867","chr10",99780083,99780117,35,11,91,137
"2868","chr10",100009720,100009739,20,37,35,92
"2869","chr10",100044366,100044392,27,8,143,178
"2870","chr10",100046774,100046791,18,147,73,238
"2871","chr10",100266824,100266868,45,44,141,230
"2872","chr10",100322222,100322247,26,15,141,182
"2873","chr10",100322225,100322251,27,19,138,184
"2874","chr10",100398909,100398933,25,120,6,151
"2875","chr10",100621501,100621522,22,66,16,104
"2876","chr10",100627427,100627453,27,76,72,175
"2877","chr10",100656465,100656496,32,112,5,149
"2878","chr10",100661540,100661561,22,1,97,120
"2879","chr10",100671282,100671301,20,109,2,131
"2880","chr10",100680953,100680974,22,65,75,162
"2881","chr10",100681298,100681347,50,70,20,140
"2882","chr10",100745344,100745387,44,32,90,166
"2883","chr10",100828919,100828941,23,131,127,281
"2884","chr10",100856817,100856834,18,29,75,122
"2885","chr10",100999843,100999892,50,25,17,92
"2886","chr10",101003658,101003685,28,39,100,167
"2887","chr10",101010537,101010575,39,68,105,212
"2888","chr10",101067136,101067174,39,129,138,306
"2889","chr10",101082149,101082171,23,8,90,121
"2890","chr10",101135056,101135074,19,70,27,116
"2891","chr10",101339793,101339817,25,23,68,116
"2892","chr10",101344685,101344707,23,36,4,63
"2893","chr10",101345141,101345169,29,126,31,186
"2894","chr10",101694601,101694623,23,73,94,190
"2895","chr10",101694978,101694996,19,26,65,110
"2896","chr10",101695034,101695060,27,20,9,56
"2897","chr10",101729977,101729996,20,78,31,129
"2898","chr10",101730145,101730163,19,69,6,94
"2899","chr10",101756057,101756083,27,6,79,112
"2900","chr10",101770142,101770164,23,116,51,190
"2901","chr10",101776855,101776893,39,99,1,139
"2902","chr10",101841098,101841116,19,26,95,140
"2903","chr10",101966286,101966314,29,96,38,163
"2904","chr10",102007657,102007683,27,77,34,138
"2905","chr10",102054996,102055031,36,139,6,181
"2906","chr10",102061002,102061033,32,9,64,105
"2907","chr10",102071118,102071143,26,5,145,176
"2908","chr10",102120375,102120406,32,50,3,85
"2909","chr10",102123834,102123857,24,75,145,244
"2910","chr10",102128924,102128947,24,8,135,167
"2911","chr10",102230673,102230699,27,45,39,111
"2912","chr10",102388550,102388568,19,14,76,109
"2913","chr10",102404348,102404365,18,102,74,194
"2914","chr10",102426805,102426822,18,15,100,133
"2915","chr10",102446682,102446729,48,10,72,130
"2916","chr10",102449816,102449836,21,30,144,195
"2917","chr10",102495730,102495750,21,48,6,75
"2918","chr10",102541698,102541721,24,3,146,173
"2919","chr10",102567007,102567029,23,76,12,111
"2920","chr10",102643587,102643604,18,11,126,155
"2921","chr10",102645212,102645235,24,23,123,170
"2922","chr10",102664025,102664043,19,7,53,79
"2923","chr10",102686452,102686481,30,100,65,195
"2924","chr10",102700771,102700790,20,111,4,135
"2925","chr10",102731086,102731117,32,145,36,213
"2926","chr10",102768365,102768396,32,69,20,121
"2927","chr10",102784864,102784888,25,3,6,34
"2928","chr10",102827970,102827988,19,8,40,67
"2929","chr10",102871547,102871578,32,77,6,115
"2930","chr10",102885496,102885547,52,8,68,128
"2931","chr10",102990115,102990143,29,14,73,116
"2932","chr10",102999238,102999255,18,29,143,190
"2933","chr10",103173612,103173631,20,134,79,233
"2934","chr10",103214633,103214661,29,8,79,116
"2935","chr10",103230291,103230312,22,29,75,126
"2936","chr10",103277375,103277407,33,138,82,253
"2937","chr10",103300259,103300276,18,125,1,144
"2938","chr10",103338064,103338084,21,102,6,129
"2939","chr10",103350768,103350797,30,16,11,57
"2940","chr10",103350819,103350836,18,55,63,136
"2941","chr10",103353083,103353114,32,93,4,129
"2942","chr10",103422056,103422099,44,46,37,127
"2943","chr10",103459066,103459084,19,1,110,130
"2944","chr10",103672283,103672300,18,147,8,173
"2945","chr10",103693221,103693248,28,134,24,186
"2946","chr10",103693285,103693319,35,4,20,59
"2947","chr10",103746801,103746827,27,65,50,142
"2948","chr10",103788884,103788901,18,42,72,132
"2949","chr10",103804315,103804339,25,8,80,113
"2950","chr10",103816998,103817019,22,31,143,196
"2951","chr10",103825763,103825781,19,8,66,93
"2952","chr10",103974615,103974640,26,48,6,80
"2953","chr10",104287888,104287905,18,8,39,65
"2954","chr10",104297983,104298003,21,79,130,230
"2955","chr10",104642369,104642397,29,126,144,299
"2956","chr10",105000471,105000503,33,78,108,219
"2957","chr10",105607917,105607939,23,77,3,103
"2958","chr10",105672737,105672757,21,8,75,104
"2959","chr10",106290815,106290863,49,5,75,129
"2960","chr10",106380457,106380484,28,33,68,129
"2961","chr10",106760687,106760741,55,68,33,156
"2962","chr10",106767479,106767504,26,6,28,60
"2963","chr10",106800692,106800722,31,37,72,140
"2964","chr10",106836475,106836494,20,76,5,101
"2965","chr10",108660883,108660913,31,143,36,210
"2966","chr10",109208026,109208049,24,29,74,127
"2967","chr10",109291943,109291967,25,8,55,88
"2968","chr10",109485860,109485880,21,125,40,186
"2969","chr10",109923523,109923541,19,68,5,92
"2970","chr10",110188094,110188116,23,29,143,195
"2971","chr10",110208421,110208438,18,149,45,212
"2972","chr10",110454050,110454098,49,144,5,198
"2973","chr10",110459667,110459696,30,47,61,138
"2974","chr10",110553222,110553260,39,75,51,165
"2975","chr10",110560339,110560362,24,75,82,181
"2976","chr10",110701014,110701047,34,28,75,137
"2977","chr10",111286781,111286803,23,8,134,165
"2978","chr10",111688017,111688040,24,9,18,51
"2979","chr10",112310639,112310691,53,145,25,223
"2980","chr10",112381666,112381684,19,145,5,169
"2981","chr10",112687949,112687971,23,8,137,168
"2982","chr10",112873376,112873406,31,78,34,143
"2983","chr10",112961005,112961029,25,6,80,111
"2984","chr10",113469269,113469322,54,3,108,165
"2985","chr10",113519580,113519614,35,22,83,140
"2986","chr10",113723726,113723743,18,37,75,130
"2987","chr10",113855635,113855670,36,27,106,169
"2988","chr10",114037139,114037161,23,25,75,123
"2989","chr10",114043898,114043960,63,2,13,78
"2990","chr10",114229818,114229850,33,78,41,152
"2991","chr10",114237947,114237974,28,93,2,123
"2992","chr10",114289993,114290010,18,42,73,133
"2993","chr10",114341612,114341643,32,56,75,163
"2994","chr10",114598275,114598295,21,137,73,231
"2995","chr10",114637036,114637058,23,15,120,158
"2996","chr10",114769173,114769196,24,127,32,183
"2997","chr10",115081717,115081744,28,111,6,145
"2998","chr10",115407986,115408014,29,29,50,108
"2999","chr10",115558044,115558077,34,61,7,102
"3000","chr10",115728112,115728145,34,77,35,146
"3001","chr10",115759842,115759866,25,30,27,82
"3002","chr10",115970209,115970229,21,8,23,52
"3003","chr10",116295588,116295606,19,75,15,109
"3004","chr10",116509310,116509350,41,76,33,150
"3005","chr10",116533773,116533793,21,29,75,125
"3006","chr10",116533921,116533952,32,126,144,302
"3007","chr10",116682868,116682888,21,41,75,137
"3008","chr10",116742632,116742663,32,32,1,65
"3009","chr10",116849797,116849820,24,127,1,152
"3010","chr10",116876951,116876978,28,42,6,76
"3011","chr10",116986717,116986741,25,71,118,214
"3012","chr10",117134314,117134337,24,49,21,94
"3013","chr10",117150587,117150624,38,99,11,148
"3014","chr10",117450431,117450469,39,75,123,237
"3015","chr10",117452633,117452651,19,93,3,115
"3016","chr10",117541603,117541659,57,64,60,181
"3017","chr10",117542346,117542435,90,5,59,154
"3018","chr10",117543427,117543445,19,69,1,89
"3019","chr10",117646813,117646839,27,90,72,189
"3020","chr10",118534783,118534802,20,49,42,111
"3021","chr10",118602709,118602735,27,92,6,125
"3022","chr10",118872640,118872665,26,40,89,155
"3023","chr10",118904923,118904945,23,18,70,111
"3024","chr10",119028572,119028682,111,9,48,168
"3025","chr10",119030110,119030137,28,64,114,206
"3026","chr10",119030301,119030320,20,18,5,43
"3027","chr10",119074976,119074999,24,28,61,113
"3028","chr10",119079989,119080011,23,23,2,48
"3029","chr10",119097202,119097233,32,127,5,164
"3030","chr10",119104587,119104607,21,32,6,59
"3031","chr10",119124372,119124391,20,145,25,190
"3032","chr10",119149750,119149774,25,116,6,147
"3033","chr10",119186563,119186581,19,76,125,220
"3034","chr10",119207706,119207734,29,2,50,81
"3035","chr10",119485656,119485684,29,20,57,106
"3036","chr10",119496825,119496862,38,28,67,133
"3037","chr10",119542705,119542755,51,19,61,131
"3038","chr10",119596497,119596545,49,75,45,169
"3039","chr10",119609364,119609390,27,64,131,222
"3040","chr10",119699387,119699423,37,8,74,119
"3041","chr10",119742148,119742170,23,73,121,217
"3042","chr10",119854541,119854579,39,52,33,124
"3043","chr10",120040073,120040090,18,125,6,149
"3044","chr10",120479225,120479261,37,57,7,101
"3045","chr10",121068474,121068502,29,93,6,128
"3046","chr10",121328473,121328497,25,51,143,219
"3047","chr10",121481828,121481854,27,7,139,173
"3048","chr10",121554506,121554524,19,9,75,103
"3049","chr10",121575859,121575877,19,121,120,260
"3050","chr10",121576191,121576210,20,42,2,64
"3051","chr10",121581908,121581950,43,9,94,146
"3052","chr10",121598450,121598482,33,7,11,51
"3053","chr10",121602771,121602800,30,11,22,63
"3054","chr10",121664416,121664439,24,45,74,143
"3055","chr10",121974496,121974518,23,122,107,252
"3056","chr10",121975077,121975095,19,118,29,166
"3057","chr10",121975116,121975147,32,32,10,74
"3058","chr10",122005684,122005711,28,76,11,115
"3059","chr10",122031398,122031422,25,8,131,164
"3060","chr10",122059061,122059091,31,31,74,136
"3061","chr10",122061001,122061019,19,3,10,32
"3062","chr10",122119919,122119951,33,112,74,219
"3063","chr10",122217414,122217458,45,10,95,150
"3064","chr10",122461621,122461643,23,14,8,45
"3065","chr10",122461682,122461700,19,24,61,104
"3066","chr10",123099626,123099644,19,134,23,176
"3067","chr10",123135785,123135807,23,38,92,153
"3068","chr10",123136234,123136262,29,67,93,189
"3069","chr10",123332106,123332124,19,139,73,231
"3070","chr10",123651430,123651469,40,74,65,179
"3071","chr10",123891820,123891838,19,1,29,49
"3072","chr10",123933720,123933757,38,117,72,227
"3073","chr10",123991557,123991584,28,6,7,41
"3074","chr10",123991687,123991724,38,36,84,158
"3075","chr10",124093246,124093271,26,33,13,72
"3076","chr10",124200442,124200470,29,17,85,131
"3077","chr10",124212494,124212527,34,78,3,115
"3078","chr10",124388346,124388370,25,100,1,126
"3079","chr10",124400447,124400467,21,143,74,238
"3080","chr10",124406493,124406521,29,135,117,281
"3081","chr10",124437019,124437043,25,9,143,177
"3082","chr10",124447618,124447645,28,103,26,157
"3083","chr10",124470649,124470683,35,67,90,192
"3084","chr10",124502668,124502691,24,5,117,146
"3085","chr10",124692403,124692425,23,5,106,134
"3086","chr10",124744319,124744368,50,3,39,92
"3087","chr10",124767161,124767183,23,99,74,196
"3088","chr10",124792505,124792537,33,68,101,202
"3089","chr10",124792694,124792712,19,7,76,102
"3090","chr10",124800915,124800933,19,7,132,158
"3091","chr10",124807313,124807335,23,112,6,141
"3092","chr10",124874592,124874644,53,77,11,141
"3093","chr10",124917175,124917214,40,21,2,63
"3094","chr10",125024526,125024545,20,9,32,61
"3095","chr10",125079151,125079172,22,87,2,111
"3096","chr10",125159407,125159442,36,36,44,116
"3097","chr10",125159906,125159926,21,143,22,186
"3098","chr10",125160192,125160217,26,42,75,143
"3099","chr10",125160575,125160661,87,10,37,134
"3100","chr10",125194326,125194347,22,8,38,68
"3101","chr10",125247429,125247449,21,135,33,189
"3102","chr10",125602583,125602618,36,131,120,287
"3103","chr10",125636204,125636223,20,8,72,100
"3104","chr10",125897999,125898034,36,74,35,145
"3105","chr10",126106487,126106504,18,77,12,107
"3106","chr10",126448018,126448043,26,29,21,76
"3107","chr10",126789270,126789288,19,5,7,31
"3108","chr10",127061930,127061954,25,76,5,106
"3109","chr10",127166063,127166080,18,73,1,92
"3110","chr10",127196629,127196649,21,34,32,87
"3111","chr10",127196711,127196739,29,14,3,46
"3112","chr10",127387032,127387053,22,64,107,193
"3113","chr10",127420897,127420932,36,6,16,58
"3114","chr10",128010546,128010600,55,67,12,134
"3115","chr10",128126379,128126399,21,119,4,144
"3116","chr10",128128709,128128836,128,51,60,239
"3117","chr10",128130863,128130883,21,8,118,147
"3118","chr10",128210368,128210429,62,7,90,159
"3119","chr10",128403128,128403153,26,41,9,76
"3120","chr10",128625816,128625843,28,81,23,132
"3121","chr10",129591934,129591952,19,11,71,101
"3122","chr10",129731357,129731380,24,28,3,55
"3123","chr10",129831705,129831734,30,56,11,97
"3124","chr10",129949315,129949332,18,61,60,139
"3125","chr10",129949317,129949343,27,72,58,157
"3126","chr10",129963579,129963611,33,1,41,75
"3127","chr10",129964391,129964408,18,116,45,179
"3128","chr10",130030669,130030705,37,37,75,149
"3129","chr10",130060823,130060845,23,137,7,167
"3130","chr10",130118818,130118840,23,68,75,166
"3131","chr10",130279770,130279787,18,31,75,124
"3132","chr10",131060220,131060277,58,8,100,166
"3133","chr10",131120155,131120185,31,64,95,190
"3134","chr10",131137139,131137172,34,11,7,52
"3135","chr10",131278327,131278355,29,76,15,120
"3136","chr10",131311322,131311340,19,7,16,42
"3137","chr10",131311523,131311540,18,114,5,137
"3138","chr10",131311817,131311871,55,32,26,113
"3139","chr10",131346853,131347353,501,127,7,635
"3140","chr10",131442628,131442652,25,8,40,73
"3141","chr10",131468728,131468775,48,70,7,125
"3142","chr10",131617047,131617077,31,55,67,153
"3143","chr10",131686137,131686160,24,76,33,133
"3144","chr10",131696171,131696191,21,1,66,88
"3145","chr10",131864482,131864519,38,122,60,220
"3146","chr10",131901021,131901063,43,4,6,53
"3147","chr10",132000856,132000883,28,76,121,225
"3148","chr10",132073494,132073514,21,76,136,233
"3149","chr10",132186330,132186350,21,41,118,180
"3150","chr10",132186998,132187024,27,10,25,62
"3151","chr10",132317968,132317987,20,14,16,50
"3152","chr10",132338692,132338727,36,8,102,146
"3153","chr10",132397164,132397208,45,104,2,151
"3154","chr10",132397559,132397610,52,147,5,204
"3155","chr10",132421260,132421286,27,23,15,65
"3156","chr10",132450155,132450410,256,67,9,332
"3157","chr10",132537898,132537921,24,33,16,73
"3158","chr10",132538050,132538067,18,12,28,58
"3159","chr10",132609634,132609659,26,5,57,88
"3160","chr10",132786070,132786116,47,25,11,83
"3161","chr10",132786112,132786129,18,7,2,27
"3162","chr10",132830125,132830149,25,64,52,141
"3163","chr10",132942906,132943015,110,41,18,169
"3164","chr10",133073876,133073895,20,66,10,96
"3165","chr10",133100169,133100190,22,33,43,98
"3166","chr10",133124830,133124858,29,52,65,146
"3167","chr10",133160408,133160431,24,3,41,68
"3168","chr10",133210365,133210389,25,61,26,112
"3169","chr10",133222491,133222509,19,43,102,164
"3170","chr10",133223272,133223291,20,35,19,74
"3171","chr10",133230127,133230158,32,11,11,54
"3172","chr10",133247483,133247510,28,37,84,149
"3173","chr10",133256980,133257000,21,65,5,91
"3174","chr10",133324023,133324073,51,67,72,190
"3175","chr10",133330351,133330375,25,12,10,47
"3176","chr10",133340812,133340838,27,74,7,108
"3177","chr10",133352822,133352849,28,104,8,140
"3178","chr10",133373587,133373615,29,5,14,48
"3179","chr10",133456586,133456620,35,47,25,107
"3180","chr10",133460472,133460497,26,43,13,82
"3181","chr10",133665793,133665843,51,17,42,110
"3182","chr10",133666806,133666886,81,3,77,161
"3183","chr10",133667011,133667031,21,1,30,52
"3184","chr10",133669103,133669153,51,17,42,110
"3185","chr10",133670116,133670185,70,3,77,150
"3186","chr10",133670310,133670330,21,1,30,52
"3187","chr10",133672402,133672452,51,17,42,110
"3188","chr10",133673415,133673484,70,3,77,150
"3189","chr10",133673609,133673629,21,1,30,52
"3190","chr10",133675701,133675751,51,17,42,110
"3191","chr10",133676714,133676794,81,3,77,161
"3192","chr10",133676919,133676939,21,1,30,52
"3193","chr10",133679011,133679061,51,17,42,110
"3194","chr10",133680024,133680104,81,3,77,161
"3195","chr10",133680229,133680249,21,1,30,52
"3196","chr10",133682321,133682371,51,17,42,110
"3197","chr10",133683334,133683403,70,3,77,150
"3198","chr10",133683528,133683548,21,1,30,52
"3199","chr10",133741972,133742022,51,17,42,110
"3200","chr10",133742985,133743065,81,3,77,161
"3201","chr10",133743190,133743210,21,1,30,52
"3202","chr10",133745282,133745332,51,17,42,110
"3203","chr10",133746295,133746375,81,3,77,161
"3204","chr10",133746500,133746520,21,1,30,52
"3205","chr10",133748591,133748641,51,17,42,110
"3206","chr10",133749604,133749684,81,3,77,161
"3207","chr10",133749809,133749829,21,1,30,52
"3208","chr10",133751901,133751951,51,17,42,110
"3209","chr10",133752914,133752983,70,3,77,150
"3210","chr10",133753108,133753128,21,1,30,52
"3211","chr10",133755200,133755250,51,17,42,110
"3212","chr10",133756213,133756293,81,3,77,161
"3213","chr10",133756418,133756438,21,1,30,52
"3214","chr10",133758510,133758560,51,17,42,110
"3215","chr10",133759523,133759592,70,3,77,150
"3216","chr10",133759717,133759737,21,1,30,52
"3217","chr10",133786468,133786543,76,14,88,178
"3218","chr11",236362,236485,124,9,44,177
"3219","chr11",265756,265775,20,11,4,35
"3220","chr11",283312,283331,20,8,28,56
"3221","chr11",301021,301056,36,6,40,82
"3222","chr11",304996,305022,27,94,73,194
"3223","chr11",322960,322982,23,4,42,69
"3224","chr11",359186,359204,19,59,6,84
"3225","chr11",397347,397364,18,54,25,97
"3226","chr11",407367,407384,18,118,2,138
"3227","chr11",415208,415326,119,47,62,228
"3228","chr11",463165,463192,28,23,8,59
"3229","chr11",494139,494194,56,114,41,211
"3230","chr11",527699,527717,19,7,143,169
"3231","chr11",532431,532474,44,31,49,124
"3232","chr11",533400,533417,18,111,15,144
"3233","chr11",535290,535314,25,3,1,29
"3234","chr11",551105,551126,22,52,119,193
"3235","chr11",555141,555215,75,14,19,108
"3236","chr11",555243,555277,35,39,11,85
"3237","chr11",570866,570885,20,13,6,39
"3238","chr11",603321,603338,18,114,45,177
"3239","chr11",615769,615788,20,9,23,52
"3240","chr11",646253,646274,22,18,124,164
"3241","chr11",694950,695003,54,54,28,136
"3242","chr11",744457,744483,27,71,6,104
"3243","chr11",747446,747463,18,16,9,43
"3244","chr11",759569,759596,28,75,136,239
"3245","chr11",768653,768674,22,3,74,99
"3246","chr11",777197,777223,27,31,47,105
"3247","chr11",778085,778109,25,52,13,90
"3248","chr11",789983,790008,26,30,39,95
"3249","chr11",795061,795080,20,1,15,36
"3250","chr11",832893,832925,33,69,58,160
"3251","chr11",842530,842547,18,53,19,90
"3252","chr11",850611,850634,24,34,33,91
"3253","chr11",867606,867624,19,55,6,80
"3254","chr11",910938,910974,37,56,4,97
"3255","chr11",918662,918681,20,46,73,139
"3256","chr11",918797,918816,20,9,139,168
"3257","chr11",926109,926127,19,28,25,72
"3258","chr11",935604,935625,22,76,143,241
"3259","chr11",968433,968464,32,56,54,142
"3260","chr11",1041201,1041226,26,22,24,72
"3261","chr11",1049423,1049446,24,58,57,139
"3262","chr11",1072157,1072206,50,119,67,236
"3263","chr11",1103551,1103568,18,11,26,55
"3264","chr11",1233860,1233887,28,86,22,136
"3265","chr11",1318103,1318120,18,17,3,38
"3266","chr11",1355112,1355131,20,76,89,185
"3267","chr11",1355603,1355640,38,76,24,138
"3268","chr11",1390384,1390409,26,22,17,65
"3269","chr11",1458908,1458925,18,140,34,192
"3270","chr11",1495300,1495329,30,74,104,208
"3271","chr11",1506258,1506292,35,4,7,46
"3272","chr11",1572177,1572209,33,59,60,152
"3273","chr11",1657169,1657224,56,50,60,166
"3274","chr11",1668914,1668939,26,45,2,73
"3275","chr11",1721606,1721627,22,9,86,117
"3276","chr11",1752594,1752616,23,2,88,113
"3277","chr11",1832930,1832950,21,107,29,157
"3278","chr11",1845831,1845856,26,1,138,165
"3279","chr11",1850371,1850391,21,8,41,70
"3280","chr11",2081892,2081910,19,18,139,176
"3281","chr11",2138073,2138096,24,10,23,57
"3282","chr11",2138187,2138213,27,60,64,151
"3283","chr11",2182119,2182136,18,136,23,177
"3284","chr11",2189219,2189239,21,8,75,104
"3285","chr11",2319629,2319674,46,53,23,122
"3286","chr11",2411602,2411621,20,148,117,285
"3287","chr11",2419449,2419467,19,110,30,159
"3288","chr11",2456766,2456789,24,145,27,196
"3289","chr11",2745882,2745905,24,74,71,169
"3290","chr11",2749642,2749663,22,145,39,206
"3291","chr11",2862320,2862349,30,32,20,82
"3292","chr11",2884631,2884653,23,71,131,225
"3293","chr11",2884841,2885021,181,45,42,268
"3294","chr11",2921231,2921248,18,79,6,103
"3295","chr11",2929454,2929489,36,43,110,189
"3296","chr11",3072292,3072310,19,67,145,231
"3297","chr11",3100972,3100992,21,8,88,117
"3298","chr11",3125805,3125823,19,136,6,161
"3299","chr11",3161964,3161991,28,1,121,150
"3300","chr11",3168664,3168692,29,8,18,55
"3301","chr11",3203592,3203609,18,114,6,138
"3302","chr11",3427315,3427345,31,119,52,202
"3303","chr11",3606307,3606342,36,9,6,51
"3304","chr11",3766690,3766710,21,94,55,170
"3305","chr11",3800812,3800831,20,128,6,154
"3306","chr11",3801642,3801660,19,145,6,170
"3307","chr11",3840997,3841024,28,74,12,114
"3308","chr11",3852142,3852160,19,8,36,63
"3309","chr11",3855884,3855905,22,12,47,81
"3310","chr11",3886688,3886711,24,137,6,167
"3311","chr11",3894906,3894928,23,35,75,133
"3312","chr11",3895594,3895916,323,70,139,532
"3313","chr11",3910819,3910837,19,146,34,199
"3314","chr11",4316712,4316729,18,42,60,120
"3315","chr11",4897100,4897135,36,103,14,153
"3316","chr11",5042053,5042073,21,36,44,101
"3317","chr11",5619689,5619722,34,10,81,125
"3318","chr11",5685706,5685737,32,75,38,145
"3319","chr11",5729115,5729137,23,8,97,128
"3320","chr11",5962527,5962549,23,69,12,104
"3321","chr11",6390701,6390741,41,59,1,101
"3322","chr11",6410833,6410876,44,142,66,252
"3323","chr11",6499559,6499578,20,69,24,113
"3324","chr11",6543959,6543985,27,61,8,96
"3325","chr11",6655825,6655843,19,15,27,61
"3326","chr11",6655890,6655932,43,49,21,113
"3327","chr11",7599798,7599817,20,29,143,192
"3328","chr11",7760656,7760692,37,31,140,208
"3329","chr11",8022896,8022957,62,29,68,159
"3330","chr11",8039431,8039451,21,147,28,196
"3331","chr11",8081154,8081176,23,34,17,74
"3332","chr11",8283632,8283657,26,53,142,221
"3333","chr11",8293018,8293036,19,59,68,146
"3334","chr11",8964364,8964403,40,32,127,199
"3335","chr11",8965608,8965640,33,26,22,81
"3336","chr11",9091445,9091485,41,4,17,62
"3337","chr11",9220551,9220577,27,115,2,144
"3338","chr11",9275864,9275891,28,77,145,250
"3339","chr11",9317356,9317391,36,112,6,154
"3340","chr11",9335366,9335391,26,31,76,133
"3341","chr11",9404564,9404583,20,8,139,167
"3342","chr11",9425711,9425728,18,76,36,130
"3343","chr11",9438248,9438280,33,83,80,196
"3344","chr11",9453843,9453864,22,75,143,240
"3345","chr11",9502242,9502265,24,85,5,114
"3346","chr11",9515654,9515689,36,139,74,249
"3347","chr11",9574033,9574063,31,23,95,149
"3348","chr11",9601886,9601925,40,111,40,191
"3349","chr11",9602076,9602093,18,11,39,68
"3350","chr11",10080249,10080270,22,54,73,149
"3351","chr11",10279107,10279130,24,12,138,174
"3352","chr11",10308054,10308085,32,10,1,43
"3353","chr11",10383432,10383453,22,37,7,66
"3354","chr11",10633048,10633090,43,6,68,117
"3355","chr11",10702481,10702509,29,9,126,164
"3356","chr11",10860598,10860620,23,74,128,225
"3357","chr11",11293534,11293557,24,6,1,31
"3358","chr11",11393419,11393440,22,66,40,128
"3359","chr11",11462443,11462473,31,36,144,211
"3360","chr11",11622002,11622025,24,68,23,115
"3361","chr11",11841991,11842009,19,7,20,46
"3362","chr11",11853962,11853986,25,146,32,203
"3363","chr11",11860144,11860162,19,71,34,124
"3364","chr11",12377470,12377504,35,33,7,75
"3365","chr11",12387759,12387776,18,121,122,261
"3366","chr11",12443170,12443190,21,77,136,234
"3367","chr11",12674129,12674151,23,21,17,61
"3368","chr11",12674445,12674462,18,28,15,61
"3369","chr11",12811846,12811867,22,73,100,195
"3370","chr11",13277889,13277908,20,28,8,56
"3371","chr11",13668734,13668753,20,67,48,135
"3372","chr11",13668928,13668946,19,17,59,95
"3373","chr11",14200815,14200847,33,84,74,191
"3374","chr11",14343835,14343872,38,24,43,105
"3375","chr11",14395619,14395809,191,22,3,216
"3376","chr11",14906471,14906514,44,122,89,255
"3377","chr11",15581740,15581775,36,17,76,129
"3378","chr11",15906816,15906871,56,143,111,310
"3379","chr11",16796823,16796840,18,96,124,238
"3380","chr11",16834000,16834026,27,74,55,156
"3381","chr11",17014433,17014486,54,1,15,70
"3382","chr11",17078983,17079000,18,121,10,149
"3383","chr11",17095412,17095432,21,68,35,124
"3384","chr11",17095595,17095628,34,8,2,44
"3385","chr11",17298082,17298102,21,143,6,170
"3386","chr11",17389410,17389459,50,137,89,276
"3387","chr11",17629975,17630004,30,128,68,226
"3388","chr11",17735671,17735718,48,38,2,88
"3389","chr11",17815437,17815457,21,137,33,191
"3390","chr11",17815614,17815638,25,144,7,176
"3391","chr11",18054503,18054554,52,29,91,172
"3392","chr11",18105984,18106001,18,23,22,63
"3393","chr11",18317258,18317275,18,10,10,38
"3394","chr11",18453833,18453851,19,75,134,228
"3395","chr11",18617626,18617650,25,3,74,102
"3396","chr11",18692471,18692497,27,4,125,156
"3397","chr11",18698869,18698886,18,9,38,65
"3398","chr11",18726899,18726921,23,13,55,91
"3399","chr11",19071621,19071643,23,82,94,199
"3400","chr11",19131015,19131037,23,9,141,173
"3401","chr11",19241321,19241341,21,2,45,68
"3402","chr11",20115632,20115655,24,145,74,243
"3403","chr11",20213473,20213493,21,49,74,144
"3404","chr11",20453319,20453340,22,87,29,138
"3405","chr11",20650656,20650684,29,8,112,149
"3406","chr11",22152513,22152530,18,29,74,121
"3407","chr11",22601929,22601950,22,28,25,75
"3408","chr11",22773387,22773411,25,8,57,90
"3409","chr11",23403537,23403554,18,111,129,258
"3410","chr11",24175743,24175770,28,9,90,127
"3411","chr11",25113719,25113743,25,106,67,198
"3412","chr11",25857941,25857966,26,22,146,194
"3413","chr11",26306126,26306147,22,29,143,194
"3414","chr11",26383889,26383915,27,7,32,66
"3415","chr11",26977494,26977535,42,29,87,158
"3416","chr11",27474835,27474864,30,36,75,141
"3417","chr11",27546751,27546777,27,42,112,181
"3418","chr11",27700521,27700547,27,38,40,105
"3419","chr11",29005061,29005082,22,145,26,193
"3420","chr11",30018540,30018583,44,58,11,113
"3421","chr11",30584342,30584386,45,114,8,167
"3422","chr11",30623824,30623841,18,76,124,218
"3423","chr11",31210711,31210763,53,11,74,138
"3424","chr11",31390396,31390420,25,142,74,241
"3425","chr11",31533815,31533853,39,76,18,133
"3426","chr11",31821610,31821663,54,45,106,205
"3427","chr11",32092311,32092334,24,127,2,153
"3428","chr11",32204584,32204605,22,117,51,190
"3429","chr11",32311289,32311314,26,113,30,169
"3430","chr11",32351330,32351356,27,82,8,117
"3431","chr11",32430405,32430491,87,27,114,228
"3432","chr11",32431435,32431452,18,6,8,32
"3433","chr11",32435414,32435431,18,4,21,43
"3434","chr11",32495265,32495296,32,77,86,195
"3435","chr11",32514631,32514649,19,8,36,63
"3436","chr11",32530115,32530193,79,42,61,182
"3437","chr11",32558762,32558834,73,90,76,239
"3438","chr11",32572743,32572764,22,70,1,93
"3439","chr11",32584608,32584628,21,46,6,73
"3440","chr11",32607081,32607110,30,8,6,44
"3441","chr11",32849362,32849379,18,144,71,233
"3442","chr11",32852940,32852961,22,29,143,194
"3443","chr11",32870064,32870095,32,141,73,246
"3444","chr11",33154492,33154514,23,76,125,224
"3445","chr11",33229063,33229099,37,10,74,121
"3446","chr11",33234029,33234049,21,8,27,56
"3447","chr11",33234331,33234363,33,144,11,188
"3448","chr11",33257658,33257687,30,5,53,88
"3449","chr11",33263314,33263331,18,75,1,94
"3450","chr11",33270304,33270324,21,6,38,65
"3451","chr11",33407343,33407360,18,77,52,147
"3452","chr11",33408782,33408800,19,32,94,145
"3453","chr11",33439570,33439592,23,44,75,142
"3454","chr11",33700508,33700534,27,132,41,200
"3455","chr11",33774522,33774553,32,35,137,204
"3456","chr11",33849635,33849674,40,74,143,257
"3457","chr11",33860783,33860810,28,8,61,97
"3458","chr11",33869482,33869511,30,10,75,115
"3459","chr11",33879460,33879479,20,146,31,197
"3460","chr11",33940967,33940992,26,58,8,92
"3461","chr11",34039758,34039781,24,75,67,166
"3462","chr11",34174325,34174360,36,40,6,82
"3463","chr11",34265662,34265687,26,148,70,244
"3464","chr11",34358217,34358247,31,1,2,34
"3465","chr11",35420136,35420153,18,28,145,191
"3466","chr11",35553446,35553466,21,69,104,194
"3467","chr11",35592945,35593062,118,115,36,269
"3468","chr11",35853770,35853797,28,56,125,209
"3469","chr11",36094532,36094551,20,123,64,207
"3470","chr11",36103237,36103254,18,75,67,160
"3471","chr11",36350134,36350338,205,136,130,471
"3472","chr11",36376295,36376376,82,110,134,326
"3473","chr11",36376508,36376535,28,74,59,161
"3474","chr11",37982475,37982512,38,83,46,167
"3475","chr11",38939840,38939866,27,37,106,170
"3476","chr11",39364903,39364928,26,9,48,83
"3477","chr11",39580869,39580891,23,9,139,171
"3478","chr11",39676711,39676729,19,77,77,173
"3479","chr11",40097404,40097423,20,8,14,42
"3480","chr11",40293198,40293223,26,1,48,75
"3481","chr11",40713056,40713073,18,35,106,159
"3482","chr11",41093928,41093950,23,68,31,122
"3483","chr11",41239152,41239172,21,145,35,201
"3484","chr11",43362150,43362194,45,31,73,149
"3485","chr11",43432990,43433018,29,27,120,176
"3486","chr11",43583336,43583364,29,18,124,171
"3487","chr11",43616977,43617008,32,148,1,181
"3488","chr11",43809820,43809853,34,3,6,43
"3489","chr11",43942036,43942076,41,7,114,162
"3490","chr11",43945681,43945698,18,145,36,199
"3491","chr11",43978004,43978027,24,76,108,208
"3492","chr11",44299355,44299377,23,7,112,142
"3493","chr11",44309714,44309774,61,50,100,211
"3494","chr11",44341533,44341558,26,36,35,97
"3495","chr11",44554447,44554464,18,84,8,110
"3496","chr11",44594389,44594416,28,136,53,217
"3497","chr11",44613824,44613855,32,85,5,122
"3498","chr11",44717556,44717580,25,24,71,120
"3499","chr11",44717624,44717647,24,91,3,118
"3500","chr11",44727043,44727126,84,8,49,141
"3501","chr11",44949626,44949645,20,40,53,113
"3502","chr11",44950767,44950835,69,4,75,148
"3503","chr11",45146966,45147001,36,27,10,73
"3504","chr11",45180687,45180714,28,35,18,81
"3505","chr11",45900345,45900383,39,135,47,221
"3506","chr11",45922924,45922947,24,69,71,164
"3507","chr11",45923986,45924023,38,137,6,181
"3508","chr11",46120123,46120158,36,9,11,56
"3509","chr11",46121520,46121558,39,6,68,113
"3510","chr11",46121975,46121993,19,51,85,155
"3511","chr11",46328655,46328708,54,70,6,130
"3512","chr11",46359771,46359789,19,27,143,189
"3513","chr11",46517471,46517497,27,92,123,242
"3514","chr11",46568453,46568488,36,11,11,58
"3515","chr11",46595536,46595583,48,26,7,81
"3516","chr11",46599337,46599365,29,142,42,213
"3517","chr11",46602669,46602692,24,10,49,83
"3518","chr11",46826822,46826844,23,97,96,216
"3519","chr11",46921539,46921582,44,6,19,69
"3520","chr11",46937884,46937908,25,92,98,215
"3521","chr11",46967791,46967842,52,48,29,129
"3522","chr11",47297763,47297805,43,7,128,178
"3523","chr11",47396997,47397038,42,72,75,189
"3524","chr11",47404722,47404755,34,147,3,184
"3525","chr11",47408642,47408659,18,38,17,73
"3526","chr11",47421250,47421275,26,18,74,118
"3527","chr11",47456776,47456797,22,14,74,110
"3528","chr11",47456835,47456856,22,5,15,42
"3529","chr11",47519480,47519526,47,90,8,145
"3530","chr11",47536370,47536401,32,72,70,174
"3531","chr11",47557207,47557234,28,6,110,144
"3532","chr11",47564172,47564194,23,144,26,193
"3533","chr11",47609458,47609480,23,80,4,107
"3534","chr11",47633506,47633527,22,49,49,120
"3535","chr11",47633527,47633550,24,72,28,124
"3536","chr11",47646782,47646805,24,73,87,184
"3537","chr11",47668209,47668226,18,24,6,48
"3538","chr11",47697541,47697563,23,8,8,39
"3539","chr11",47707025,47707048,24,76,47,147
"3540","chr11",47763493,47763519,27,77,27,131
"3541","chr11",47849843,47849880,38,77,8,123
"3542","chr11",47882668,47882701,34,75,68,177
"3543","chr11",47978908,47978927,20,19,91,130
"3544","chr11",47980972,47980997,26,11,27,64
"3545","chr11",48002137,48002155,19,76,52,147
"3546","chr11",48047499,48047521,23,76,78,177
"3547","chr11",48059111,48059136,26,5,78,109
"3548","chr11",48071608,48071626,19,76,19,114
"3549","chr11",48161181,48161198,18,29,143,190
"3550","chr11",49177786,49177804,19,136,33,188
"3551","chr11",49209299,49209331,33,98,43,174
"3552","chr11",49271065,49271086,22,8,48,78
"3553","chr11",55311031,55311067,37,4,32,73
"3554","chr11",57304873,57304895,23,23,73,119
"3555","chr11",57324891,57324929,39,43,55,137
"3556","chr11",57528484,57528517,34,79,28,141
"3557","chr11",57655818,57655841,24,74,8,106
"3558","chr11",57790553,57790575,23,8,126,157
"3559","chr11",57858379,57858397,19,7,65,91
"3560","chr11",58096704,58096721,18,76,119,213
"3561","chr11",58959066,58959088,23,11,74,108
"3562","chr11",59142884,59142907,24,128,119,271
"3563","chr11",59530493,59530523,31,76,12,119
"3564","chr11",59543181,59543198,18,148,3,169
"3565","chr11",59668900,59668939,40,8,57,105
"3566","chr11",59755784,59755802,19,27,100,146
"3567","chr11",60637504,60637525,22,74,27,123
"3568","chr11",60784407,60784428,22,126,52,200
"3569","chr11",60830109,60830130,22,20,5,47
"3570","chr11",60924502,60924525,24,25,56,105
"3571","chr11",60980844,60980862,19,63,70,152
"3572","chr11",61011179,61011204,26,74,46,146
"3573","chr11",61143969,61143986,18,8,136,162
"3574","chr11",61277446,61277463,18,145,35,198
"3575","chr11",61317493,61317524,32,76,63,171
"3576","chr11",61344360,61344380,21,75,12,108
"3577","chr11",61351285,61351307,23,126,113,262
"3578","chr11",61374144,61374165,22,76,9,107
"3579","chr11",61387031,61387058,28,7,1,36
"3580","chr11",61391253,61391282,30,65,107,202
"3581","chr11",61459619,61459638,20,76,141,237
"3582","chr11",61488302,61488322,21,8,44,73
"3583","chr11",61504600,61504625,26,27,74,127
"3584","chr11",61508644,61508662,19,54,49,122
"3585","chr11",61531892,61531915,24,89,8,121
"3586","chr11",61580982,61581009,28,3,3,34
"3587","chr11",61660711,61660740,30,5,6,41
"3588","chr11",61688315,61688333,19,32,6,57
"3589","chr11",61696595,61696618,24,118,3,145
"3590","chr11",61799116,61799152,37,120,40,197
"3591","chr11",61845785,61845804,20,72,14,106
"3592","chr11",61852256,61852279,24,9,6,39
"3593","chr11",61929885,61929909,25,4,146,175
"3594","chr11",61955085,61955105,21,30,97,148
"3595","chr11",62095025,62095043,19,82,6,107
"3596","chr11",62095448,62095491,44,8,88,140
"3597","chr11",62100550,62100602,53,106,4,163
"3598","chr11",62100991,62101013,23,8,80,111
"3599","chr11",62122847,62122870,24,97,137,258
"3600","chr11",62206841,62206887,47,75,25,147
"3601","chr11",62208087,62208109,23,22,72,117
"3602","chr11",62311699,62311726,28,72,5,105
"3603","chr11",62311896,62311932,37,71,59,167
"3604","chr11",62333424,62333462,39,8,12,59
"3605","chr11",62371954,62371974,21,69,6,96
"3606","chr11",62415765,62415783,19,5,11,35
"3607","chr11",62421492,62421526,35,5,66,106
"3608","chr11",62460988,62461009,22,30,75,127
"3609","chr11",62503583,62503610,28,104,6,138
"3610","chr11",62506014,62506036,23,103,19,145
"3611","chr11",62536930,62536962,33,67,109,209
"3612","chr11",62536940,62536971,32,76,99,207
"3613","chr11",62590637,62590659,23,74,6,103
"3614","chr11",62653777,62653853,77,26,61,164
"3615","chr11",62679725,62679749,25,8,79,112
"3616","chr11",62680357,62680384,28,75,113,216
"3617","chr11",62697385,62697405,21,46,16,83
"3618","chr11",62706387,62706411,25,79,63,167
"3619","chr11",62726895,62726934,40,67,3,110
"3620","chr11",62728033,62728050,18,99,116,233
"3621","chr11",62738042,62738078,37,140,63,240
"3622","chr11",62768908,62768928,21,145,72,238
"3623","chr11",62779188,62779211,24,7,143,174
"3624","chr11",62788401,62788420,20,145,8,173
"3625","chr11",62848811,62848836,26,42,11,79
"3626","chr11",62856816,62856842,27,9,14,50
"3627","chr11",62901427,62901445,19,25,69,113
"3628","chr11",62924419,62924443,25,24,64,113
"3629","chr11",62924630,62924669,40,54,90,184
"3630","chr11",62924669,62924703,35,88,51,174
"3631","chr11",62925008,62925027,20,67,133,220
"3632","chr11",62962096,62962116,21,147,7,175
"3633","chr11",63514573,63514604,32,148,41,221
"3634","chr11",63588051,63588080,30,69,34,133
"3635","chr11",63684130,63684166,37,9,63,109
"3636","chr11",63724485,63724508,24,7,8,39
"3637","chr11",63763374,63763401,28,80,22,130
"3638","chr11",63763738,63763774,37,1,77,115
"3639","chr11",63764042,63764083,42,44,107,193
"3640","chr11",63765843,63765882,40,62,144,246
"3641","chr11",63784047,63784081,35,138,82,255
"3642","chr11",63808042,63808060,19,130,74,223
"3643","chr11",63819100,63819127,28,124,31,183
"3644","chr11",63848550,63848568,19,76,143,238
"3645","chr11",63854187,63854220,34,79,44,157
"3646","chr11",63894701,63894722,22,28,69,119
"3647","chr11",63913163,63913185,23,57,38,118
"3648","chr11",63913185,63913203,19,75,16,110
"3649","chr11",63916968,63916997,30,66,48,144
"3650","chr11",63929120,63929141,22,143,7,172
"3651","chr11",63936499,63936546,48,7,143,198
"3652","chr11",63940041,63940067,27,7,25,59
"3653","chr11",64016959,64016985,27,6,24,57
"3654","chr11",64055676,64055721,46,21,116,183
"3655","chr11",64060679,64060711,33,22,105,160
"3656","chr11",64060938,64060956,19,119,30,168
"3657","chr11",64159321,64159339,19,137,5,161
"3658","chr11",64163123,64163153,31,75,4,110
"3659","chr11",64190167,64190186,20,3,144,167
"3660","chr11",64205397,64205417,21,30,72,123
"3661","chr11",64222564,64222585,22,67,75,164
"3662","chr11",64234573,64234621,49,33,89,171
"3663","chr11",64234649,64234673,25,14,13,52
"3664","chr11",64236717,64236744,28,95,6,129
"3665","chr11",64251473,64251507,35,14,84,133
"3666","chr11",64280323,64280359,37,66,71,174
"3667","chr11",64282882,64282906,25,70,4,99
"3668","chr11",64368262,64368285,24,120,2,146
"3669","chr11",64369301,64369319,19,103,64,186
"3670","chr11",64371102,64371126,25,40,8,73
"3671","chr11",64399888,64399913,26,39,3,68
"3672","chr11",64466814,64466831,18,78,75,171
"3673","chr11",64496859,64496876,18,8,75,101
"3674","chr11",64536658,64536681,24,132,108,264
"3675","chr11",64563611,64563638,28,147,17,192
"3676","chr11",64636394,64636417,24,132,54,210
"3677","chr11",64642712,64642738,27,4,87,118
"3678","chr11",64662091,64662108,18,77,33,128
"3679","chr11",64713708,64713737,30,17,36,83
"3680","chr11",64744848,64744889,42,17,73,132
"3681","chr11",64778074,64778185,112,10,16,138
"3682","chr11",64803203,64803227,25,18,24,67
"3683","chr11",64861020,64861037,18,146,7,171
"3684","chr11",64874302,64874321,20,15,8,43
"3685","chr11",64939095,64939114,20,3,144,167
"3686","chr11",64956300,64956322,23,60,73,156
"3687","chr11",64961468,64961493,26,8,144,178
"3688","chr11",64966930,64966957,28,30,78,136
"3689","chr11",64972463,64972486,24,99,126,249
"3690","chr11",65028689,65028707,19,43,6,68
"3691","chr11",65029097,65029129,33,28,68,129
"3692","chr11",65040881,65040898,18,93,39,150
"3693","chr11",65138406,65138441,36,140,4,180
"3694","chr11",65181855,65181882,28,70,47,145
"3695","chr11",65207915,65207934,20,70,4,94
"3696","chr11",65249079,65249200,122,140,39,301
"3697","chr11",65260195,65260219,25,37,74,136
"3698","chr11",65276791,65276809,19,76,40,135
"3699","chr11",65318422,65318441,20,8,75,103
"3700","chr11",65347313,65347348,36,41,12,89
"3701","chr11",65376070,65376092,23,5,66,94
"3702","chr11",65455895,65455919,25,108,27,160
"3703","chr11",65483133,65483155,23,142,34,199
"3704","chr11",65557855,65557894,40,8,51,99
"3705","chr11",65558636,65558653,18,67,75,160
"3706","chr11",65647810,65647848,39,85,9,133
"3707","chr11",65647823,65647875,53,112,21,186
"3708","chr11",65680795,65680830,36,67,141,244
"3709","chr11",65681245,65681263,19,8,6,33
"3710","chr11",65710779,65710802,24,84,75,183
"3711","chr11",65787526,65787544,19,33,118,170
"3712","chr11",65804928,65804947,20,11,1,32
"3713","chr11",65811767,65811799,33,26,76,135
"3714","chr11",65872508,65872541,34,49,63,146
"3715","chr11",65919009,65919029,21,46,15,82
"3716","chr11",65993584,65993605,22,100,7,129
"3717","chr11",66022333,66022353,21,60,81,162
"3718","chr11",66024272,66024295,24,121,2,147
"3719","chr11",66027314,66027336,23,5,5,33
"3720","chr11",66027489,66027507,19,114,143,276
"3721","chr11",66070574,66070619,46,15,57,118
"3722","chr11",66090006,66090025,20,104,74,198
"3723","chr11",66167334,66167351,18,75,10,103
"3724","chr11",66169567,66169584,18,25,143,186
"3725","chr11",66223055,66223078,24,44,108,176
"3726","chr11",66278546,66278566,21,1,14,36
"3727","chr11",66291851,66291874,24,50,2,76
"3728","chr11",66304527,66304544,18,124,70,212
"3729","chr11",66311072,66311112,41,17,3,61
"3730","chr11",66347679,66347716,38,8,53,99
"3731","chr11",66374605,66374652,48,73,111,232
"3732","chr11",66384161,66384182,22,8,33,63
"3733","chr11",66420058,66420081,24,94,64,182
"3734","chr11",66453158,66453190,33,78,139,250
"3735","chr11",66507479,66507505,27,61,62,150
"3736","chr11",66510166,66510188,23,22,74,119
"3737","chr11",66578863,66578899,37,34,135,206
"3738","chr11",66586976,66587006,31,107,147,285
"3739","chr11",66634087,66634105,19,35,136,190
"3740","chr11",66634983,66635002,20,72,97,189
"3741","chr11",66657683,66657708,26,43,74,143
"3742","chr11",66722893,66722914,22,103,41,166
"3743","chr11",66728060,66728087,28,24,12,64
"3744","chr11",66843358,66843377,20,23,29,72
"3745","chr11",66850937,66850954,18,104,81,203
"3746","chr11",66859239,66859257,19,65,3,87
"3747","chr11",66913676,66913694,19,134,2,155
"3748","chr11",66932019,66932053,35,88,6,129
"3749","chr11",66943756,66943785,30,96,1,127
"3750","chr11",67059548,67059573,26,35,1,62
"3751","chr11",67061633,67061650,18,143,5,166
"3752","chr11",67064106,67064124,19,13,6,38
"3753","chr11",67128010,67128033,24,122,7,153
"3754","chr11",67129734,67129762,29,146,6,181
"3755","chr11",67145977,67146010,34,77,93,204
"3756","chr11",67205598,67205629,32,3,112,147
"3757","chr11",67235145,67235167,23,130,74,227
"3758","chr11",67261602,67261621,20,51,44,115
"3759","chr11",67266395,67266462,68,97,1,166
"3760","chr11",67266652,67266676,25,57,3,85
"3761","chr11",67289324,67289346,23,3,91,117
"3762","chr11",67311765,67311799,35,119,135,289
"3763","chr11",67328233,67328251,19,84,120,223
"3764","chr11",67372617,67372647,31,1,68,100
"3765","chr11",67388254,67388276,23,10,98,131
"3766","chr11",67391041,67391061,21,146,46,213
"3767","chr11",67420853,67420888,36,75,85,196
"3768","chr11",67422172,67422201,30,8,145,183
"3769","chr11",67443961,67443985,25,24,26,75
"3770","chr11",67629965,67629988,24,15,26,65
"3771","chr11",67630281,67630303,23,5,129,157
"3772","chr11",67736072,67736091,20,69,97,186
"3773","chr11",67754074,67754094,21,83,46,150
"3774","chr11",67810136,67810153,18,119,51,188
"3775","chr11",68023304,68023321,18,8,112,138
"3776","chr11",68036018,68036042,25,71,74,170
"3777","chr11",68120688,68120783,96,5,140,241
"3778","chr11",68120945,68121022,78,17,20,115
"3779","chr11",68121304,68121334,31,17,2,50
"3780","chr11",68122706,68122733,28,29,75,132
"3781","chr11",68126988,68127010,23,9,128,160
"3782","chr11",68149412,68149434,23,17,6,46
"3783","chr11",68212936,68213013,78,52,91,221
"3784","chr11",68236869,68236893,25,23,132,180
"3785","chr11",68308924,68308947,24,4,67,95
"3786","chr11",68312747,68312774,28,69,36,133
"3787","chr11",68417450,68417479,30,9,31,70
"3788","chr11",68439921,68439949,29,100,56,185
"3789","chr11",68482223,68482240,18,53,23,94
"3790","chr11",68497033,68497065,33,9,139,181
"3791","chr11",68508122,68508146,25,8,127,160
"3792","chr11",68520763,68520786,24,5,83,112
"3793","chr11",68535800,68535822,23,145,34,202
"3794","chr11",68692024,68692049,26,127,14,167
"3795","chr11",68692457,68692476,20,9,35,64
"3796","chr11",68709065,68709100,36,28,131,195
"3797","chr11",68752126,68752148,23,45,71,139
"3798","chr11",68838918,68838936,19,4,94,117
"3799","chr11",68841793,68841832,40,2,9,51
"3800","chr11",68853227,68853270,44,72,75,191
"3801","chr11",68904789,68904817,29,77,29,135
"3802","chr11",68953359,68953378,20,46,139,205
"3803","chr11",68958701,68958735,35,76,88,199
"3804","chr11",69006620,69006640,21,7,89,117
"3805","chr11",69013293,69013325,33,78,4,115
"3806","chr11",69022998,69023021,24,69,10,103
"3807","chr11",69056835,69056853,19,6,141,166
"3808","chr11",69229054,69229088,35,54,117,206
"3809","chr11",69305702,69305721,20,54,6,80
"3810","chr11",69326631,69326648,18,13,74,105
"3811","chr11",69471936,69471965,30,47,31,108
"3812","chr11",69641014,69641051,38,130,61,229
"3813","chr11",69651208,69651235,28,20,69,117
"3814","chr11",69686224,69686256,33,75,27,135
"3815","chr11",69701607,69701629,23,41,1,65
"3816","chr11",69754095,69754115,21,56,5,82
"3817","chr11",69766845,69766888,44,144,65,253
"3818","chr11",69819113,69819143,31,13,42,86
"3819","chr11",69830772,69830790,19,81,83,183
"3820","chr11",69894913,69894938,26,65,89,180
"3821","chr11",69972058,69972080,23,137,141,301
"3822","chr11",69972187,69972209,23,85,12,120
"3823","chr11",69972885,69972926,42,75,79,196
"3824","chr11",70100828,70100845,18,5,108,131
"3825","chr11",70137332,70137377,46,42,109,197
"3826","chr11",70153750,70153784,35,45,146,226
"3827","chr11",70157367,70157384,18,79,74,171
"3828","chr11",70177573,70177617,45,76,19,140
"3829","chr11",70214370,70214389,20,76,72,168
"3830","chr11",70277482,70277508,27,8,132,167
"3831","chr11",70386682,70386702,21,80,140,241
"3832","chr11",70423112,70423130,19,88,50,157
"3833","chr11",70599606,70599642,37,27,7,71
"3834","chr11",70645404,70645436,33,64,53,150
"3835","chr11",71261967,71261991,25,107,71,203
"3836","chr11",71329052,71329074,23,77,7,107
"3837","chr11",71518750,71518779,30,81,79,190
"3838","chr11",71606141,71606170,30,137,2,169
"3839","chr11",72033365,72033389,25,121,38,184
"3840","chr11",72130876,72130895,20,37,75,132
"3841","chr11",72223837,72223860,24,20,95,139
"3842","chr11",72244012,72244029,18,19,52,89
"3843","chr11",72244041,72244071,31,35,23,89
"3844","chr11",72373961,72373982,22,80,6,108
"3845","chr11",72434808,72434828,21,121,44,186
"3846","chr11",72449395,72449414,20,45,143,208
"3847","chr11",72642385,72642412,28,51,64,143
"3848","chr11",72642482,72642511,30,76,69,175
"3849","chr11",72752486,72752504,19,81,31,131
"3850","chr11",72760218,72760239,22,3,128,153
"3851","chr11",72765267,72765293,27,54,6,87
"3852","chr11",72792042,72792067,26,8,124,158
"3853","chr11",72850058,72850080,23,124,40,187
"3854","chr11",73142812,73142871,60,67,15,142
"3855","chr11",73377270,73377293,24,87,29,140
"3856","chr11",73690698,73690717,20,80,105,205
"3857","chr11",73692789,73692811,23,145,33,201
"3858","chr11",73754917,73754936,20,72,75,167
"3859","chr11",73761139,73761165,27,106,118,251
"3860","chr11",73762116,73762142,27,148,70,245
"3861","chr11",73769734,73769763,30,67,23,120
"3862","chr11",73786350,73786369,20,78,7,105
"3863","chr11",73790375,73790402,28,76,5,109
"3864","chr11",73794185,73794230,46,104,76,226
"3865","chr11",73800798,73800828,31,7,100,138
"3866","chr11",74040759,74040789,31,147,120,298
"3867","chr11",74297104,74297127,24,29,138,191
"3868","chr11",74389948,74389969,22,77,27,126
"3869","chr11",74398449,74398477,29,21,29,79
"3870","chr11",74482153,74482177,25,131,6,162
"3871","chr11",74535297,74535320,24,9,18,51
"3872","chr11",74596175,74596200,26,7,137,170
"3873","chr11",74795220,74795237,18,121,35,174
"3874","chr11",75240230,75240248,19,28,10,57
"3875","chr11",75242129,75242152,24,94,103,221
"3876","chr11",75334307,75334326,20,140,89,249
"3877","chr11",75351734,75351776,43,132,4,179
"3878","chr11",75815234,75815271,38,57,94,189
"3879","chr11",76127650,76127674,25,12,7,44
"3880","chr11",76290060,76290081,22,51,39,112
"3881","chr11",76784022,76784039,18,36,90,144
"3882","chr11",76860956,76860974,19,4,66,89
"3883","chr11",76907872,76907891,20,85,5,110
"3884","chr11",77043707,77043726,20,144,6,170
"3885","chr11",77067127,77067147,21,63,11,95
"3886","chr11",77435658,77435681,24,29,78,131
"3887","chr11",77474139,77474212,74,125,53,252
"3888","chr11",77501151,77501182,32,3,6,41
"3889","chr11",77534911,77534928,18,88,72,178
"3890","chr11",77587702,77587740,39,80,26,145
"3891","chr11",77617368,77617392,25,77,74,176
"3892","chr11",77637267,77637310,44,52,39,135
"3893","chr11",77637292,77637329,38,71,14,123
"3894","chr11",77638840,77638880,41,95,6,142
"3895","chr11",77794516,77794539,24,94,125,243
"3896","chr11",77941634,77941679,46,29,140,215
"3897","chr11",78005678,78005696,19,145,54,218
"3898","chr11",78191842,78191861,20,8,139,167
"3899","chr11",78417849,78417866,18,53,27,98
"3900","chr11",78431702,78431732,31,88,74,193
"3901","chr11",78521790,78521814,25,147,6,178
"3902","chr11",79298522,79298554,33,136,67,236
"3903","chr11",79648751,79648813,63,13,21,97
"3904","chr11",80215801,80215824,24,6,6,36
"3905","chr11",81070446,81070463,18,148,54,220
"3906","chr11",81677581,81677601,21,31,75,127
"3907","chr11",83127455,83127473,19,8,141,168
"3908","chr11",84010294,84010318,25,142,5,172
"3909","chr11",84033883,84033926,44,22,22,88
"3910","chr11",84332509,84332530,22,86,13,121
"3911","chr11",85905443,85905460,18,77,5,100
"3912","chr11",86008938,86008975,38,13,24,75
"3913","chr11",86824006,86824031,26,18,6,50
"3914","chr11",86834507,86834614,108,143,29,280
"3915","chr11",86853243,86853274,32,48,56,136
"3916","chr11",86929323,86929346,24,133,4,161
"3917","chr11",86955571,86955589,19,103,53,175
"3918","chr11",86956740,86956783,44,70,24,138
"3919","chr11",87222182,87222205,24,138,74,236
"3920","chr11",88026563,88026587,25,65,74,164
"3921","chr11",88593731,88593761,31,26,21,78
"3922","chr11",89467350,89467377,28,24,75,127
"3923","chr11",89491728,89491766,39,71,28,138
"3924","chr11",89536134,89536164,31,8,2,41
"3925","chr11",90055957,90055976,20,8,83,111
"3926","chr11",90122973,90122997,25,8,127,160
"3927","chr11",90477763,90477785,23,8,97,128
"3928","chr11",92224981,92225000,20,38,27,85
"3929","chr11",92715242,92715259,18,78,35,131
"3930","chr11",93205866,93205893,28,12,2,42
"3931","chr11",93543236,93543305,70,27,20,117
"3932","chr11",94129089,94129109,21,30,95,146
"3933","chr11",94543836,94543863,28,81,139,248
"3934","chr11",94570892,94570923,32,118,74,224
"3935","chr11",94741206,94741265,60,65,84,209
"3936","chr11",95337487,95337540,54,49,60,163
"3937","chr11",95882890,95882920,31,30,75,136
"3938","chr11",96039964,96039982,19,70,68,157
"3939","chr11",96041976,96041994,19,76,143,238
"3940","chr11",96121951,96121982,32,28,78,138
"3941","chr11",96202178,96202201,24,77,27,128
"3942","chr11",96389853,96389880,28,31,83,142
"3943","chr11",96743946,96743968,23,37,75,135
"3944","chr11",97900455,97900499,45,147,6,198
"3945","chr11",98006728,98006747,20,90,3,113
"3946","chr11",98090508,98090532,25,8,79,112
"3947","chr11",98470796,98470815,20,65,43,128
"3948","chr11",99462932,99462958,27,145,110,282
"3949","chr11",99878923,99878945,23,66,7,96
"3950","chr11",100710539,100710557,19,76,140,235
"3951","chr11",100820949,100820971,23,114,93,230
"3952","chr11",101230081,101230099,19,140,42,201
"3953","chr11",101954021,101954047,27,78,7,112
"3954","chr11",102014253,102014270,18,5,1,24
"3955","chr11",102123933,102123969,37,36,139,212
"3956","chr11",102317589,102317631,43,79,44,166
"3957","chr11",102602117,102602141,25,29,75,129
"3958","chr11",104139874,104139901,28,136,35,199
"3959","chr11",104296726,104296750,25,10,1,36
"3960","chr11",105267037,105267066,30,109,45,184
"3961","chr11",107590333,107590439,107,54,135,296
"3962","chr11",107645090,107645110,21,29,26,76
"3963","chr11",107728259,107728281,23,78,47,148
"3964","chr11",107781935,107781961,27,29,143,199
"3965","chr11",107799868,107799906,39,8,136,183
"3966","chr11",107844623,107844672,50,127,8,185
"3967","chr11",107888139,107888161,23,72,64,159
"3968","chr11",107888461,107888489,29,75,129,233
"3969","chr11",107896260,107896288,29,78,1,108
"3970","chr11",107926864,107926882,19,70,133,222
"3971","chr11",107989757,107989785,29,77,69,175
"3972","chr11",108126787,108126811,25,77,136,238
"3973","chr11",108404575,108404601,27,28,143,198
"3974","chr11",108497956,108497974,19,23,90,132
"3975","chr11",108519951,108519977,27,65,74,166
"3976","chr11",108626672,108626696,25,76,7,108
"3977","chr11",109108694,109108723,30,70,48,148
"3978","chr11",109422123,109422160,38,11,110,159
"3979","chr11",109834329,109834373,45,27,16,88
"3980","chr11",110201904,110201956,53,32,140,225
"3981","chr11",111514721,111514745,25,50,115,190
"3982","chr11",111867097,111867124,28,132,72,232
"3983","chr11",111919469,111919486,18,89,78,185
"3984","chr11",111928016,111928038,23,44,74,141
"3985","chr11",111936987,111937032,46,56,130,232
"3986","chr11",111943488,111943517,30,76,101,207
"3987","chr11",111945935,111945954,20,8,143,171
"3988","chr11",111958295,111958312,18,18,45,81
"3989","chr11",112035791,112035808,18,76,8,102
"3990","chr11",112072550,112072578,29,9,4,42
"3991","chr11",112094398,112094425,28,127,74,229
"3992","chr11",112560993,112561012,20,7,126,153
"3993","chr11",112960260,112960299,40,100,72,212
"3994","chr11",113475291,113475332,42,1,23,66
"3995","chr11",113523628,113523692,65,70,10,145
"3996","chr11",113558409,113558428,20,81,47,148
"3997","chr11",113772819,113772837,19,77,25,121
"3998","chr11",113874142,113874160,19,3,73,95
"3999","chr11",113911228,113911247,20,75,43,138
"4000","chr11",113920368,113920394,27,77,36,140
"4001","chr11",114059445,114059495,51,18,82,151
"4002","chr11",114080003,114080026,24,79,119,222
"4003","chr11",114210163,114210193,31,54,43,128
"4004","chr11",114249458,114249483,26,13,7,46
"4005","chr11",114695831,114695867,37,76,33,146
"4006","chr11",114821847,114821885,39,50,35,124
"4007","chr11",114999973,114999995,23,145,7,175
"4008","chr11",115149979,115150017,39,8,35,82
"4009","chr11",115484947,115484973,27,132,6,165
"4010","chr11",115504335,115504358,24,19,66,109
"4011","chr11",115668511,115668553,43,29,70,142
"4012","chr11",115736766,115736784,19,75,115,209
"4013","chr11",115772845,115772867,23,63,75,161
"4014","chr11",116444826,116444852,27,25,144,196
"4015","chr11",116580729,116580754,26,76,3,105
"4016","chr11",116657331,116657348,18,142,22,182
"4017","chr11",116805958,116805987,30,5,7,42
"4018","chr11",116824773,116824796,24,54,121,199
"4019","chr11",116824796,116824818,23,8,98,129
"4020","chr11",116831173,116831370,198,64,93,355
"4021","chr11",117070747,117070769,23,75,144,242
"4022","chr11",117086995,117087014,20,4,73,97
"4023","chr11",117144738,117144770,33,86,29,148
"4024","chr11",117473507,117473527,21,7,64,92
"4025","chr11",117630659,117630684,26,123,46,195
"4026","chr11",117975208,117975227,20,74,2,96
"4027","chr11",118040045,118040066,22,145,6,173
"4028","chr11",118049340,118049366,27,8,40,75
"4029","chr11",118211242,118211264,23,130,43,196
"4030","chr11",118422548,118422584,37,9,69,115
"4031","chr11",118430374,118430395,22,136,74,232
"4032","chr11",118433558,118433580,23,78,21,122
"4033","chr11",118436692,118436714,23,24,9,56
"4034","chr11",118436780,118436802,23,53,8,84
"4035","chr11",118462313,118462346,34,58,86,178
"4036","chr11",118462555,118462573,19,5,34,58
"4037","chr11",118547723,118547764,42,8,6,56
"4038","chr11",118551671,118551690,20,31,77,128
"4039","chr11",118560435,118560477,43,1,115,159
"4040","chr11",118603645,118603662,18,18,10,46
"4041","chr11",118744980,118744998,19,73,146,238
"4042","chr11",118830024,118830046,23,31,7,61
"4043","chr11",118837285,118837310,26,8,5,39
"4044","chr11",118901388,118901432,45,13,49,107
"4045","chr11",118903294,118903318,25,64,144,233
"4046","chr11",118925509,118925534,26,28,43,97
"4047","chr11",118925555,118925578,24,13,2,39
"4048","chr11",118925585,118925603,19,9,45,73
"4049","chr11",119018676,119018701,26,112,80,218
"4050","chr11",119085173,119085201,29,37,57,123
"4051","chr11",119094816,119094838,23,46,25,94
"4052","chr11",119149206,119149241,36,43,30,109
"4053","chr11",119206290,119206323,34,6,26,66
"4054","chr11",119206523,119206544,22,73,9,104
"4055","chr11",119244582,119244599,18,76,143,237
"4056","chr11",119277242,119277271,30,68,11,109
"4057","chr11",119345837,119345869,33,142,61,236
"4058","chr11",119389488,119389507,20,97,7,124
"4059","chr11",119664968,119664992,25,127,32,184
"4060","chr11",120122121,120122164,44,120,4,168
"4061","chr11",120211311,120211351,41,107,2,150
"4062","chr11",120678623,120678652,30,77,46,153
"4063","chr11",120777937,120777960,24,56,6,86
"4064","chr11",120917248,120917313,66,21,73,160
"4065","chr11",120917270,120917318,49,26,51,126
"4066","chr11",120986290,120986320,31,13,124,168
"4067","chr11",121210237,121210257,21,102,4,127
"4068","chr11",121518939,121518966,28,77,108,213
"4069","chr11",121831216,121831235,20,120,74,214
"4070","chr11",122407222,122407241,20,139,74,233
"4071","chr11",122440805,122440843,39,17,9,65
"4072","chr11",122519501,122519547,47,40,7,94
"4073","chr11",122636213,122636232,20,15,74,109
"4074","chr11",122696325,122696352,28,100,70,198
"4075","chr11",122877804,122877827,24,90,71,185
"4076","chr11",122882902,122882920,19,55,36,110
"4077","chr11",122949822,122949852,31,9,115,155
"4078","chr11",122972266,122972287,22,145,36,203
"4079","chr11",123025040,123025059,20,8,6,34
"4080","chr11",123025209,123025257,49,84,75,208
"4081","chr11",123049557,123049587,31,37,75,143
"4082","chr11",123054281,123054299,19,15,5,39
"4083","chr11",123125447,123125584,138,39,124,301
"4084","chr11",123157723,123157746,24,82,39,145
"4085","chr11",123497901,123497921,21,51,74,146
"4086","chr11",123572675,123572696,22,2,79,103
"4087","chr11",123715948,123715968,21,8,12,41
"4088","chr11",123741499,123741535,37,3,102,142
"4089","chr11",124580841,124580892,52,26,7,85
"4090","chr11",124828620,124828645,26,4,11,41
"4091","chr11",124843083,124843109,27,2,53,82
"4092","chr11",124843116,124843147,32,40,20,92
"4093","chr11",125165147,125165169,23,97,46,166
"4094","chr11",125197656,125197675,20,52,18,90
"4095","chr11",125212450,125212472,23,76,24,123
"4096","chr11",125314725,125314748,24,90,36,150
"4097","chr11",125341050,125341072,23,144,43,210
"4098","chr11",125374935,125374958,24,97,84,205
"4099","chr11",125401762,125401799,38,105,19,162
"4100","chr11",125434943,125434964,22,118,62,202
"4101","chr11",125474192,125474211,20,29,75,124
"4102","chr11",125496222,125496244,23,67,81,171
"4103","chr11",125599714,125599743,30,71,139,240
"4104","chr11",126237216,126237238,23,76,11,110
"4105","chr11",126276287,126276315,29,117,95,241
"4106","chr11",126355874,126355894,21,27,13,61
"4107","chr11",126392961,126392978,18,28,72,118
"4108","chr11",126402452,126402469,18,41,10,69
"4109","chr11",126530823,126530848,26,76,53,155
"4110","chr11",126552551,126552581,31,79,115,225
"4111","chr11",126585221,126585247,27,4,9,40
"4112","chr11",126693425,126693461,37,91,2,130
"4113","chr11",126712265,126712285,21,17,113,151
"4114","chr11",127266739,127266777,39,6,117,162
"4115","chr11",127927591,127927609,19,53,79,151
"4116","chr11",128242111,128242141,31,57,6,94
"4117","chr11",128741399,128741416,18,93,68,179
"4118","chr11",128821372,128821395,24,14,75,113
"4119","chr11",129279241,129279277,37,15,21,73
"4120","chr11",129574921,129574958,38,77,61,176
"4121","chr11",129766217,129766235,19,14,6,39
"4122","chr11",130040244,130040291,48,26,8,82
"4123","chr11",130041824,130041852,29,86,74,189
"4124","chr11",130079084,130079114,31,74,128,233
"4125","chr11",130094048,130094070,23,75,142,240
"4126","chr11",130147256,130147273,18,76,114,208
"4127","chr11",130206538,130206583,46,19,40,105
"4128","chr11",130293472,130293489,18,139,125,282
"4129","chr11",130314445,130314462,18,23,53,94
"4130","chr11",130377275,130377296,22,50,75,147
"4131","chr11",130428218,130428247,30,30,77,137
"4132","chr11",130465855,130465885,31,71,8,110
"4133","chr11",130468765,130468784,20,129,6,155
"4134","chr11",130718871,130718907,37,63,37,137
"4135","chr11",130926883,130926906,24,88,6,118
"4136","chr11",131222132,131222155,24,5,6,35
"4137","chr11",131411541,131411588,48,35,70,153
"4138","chr11",131639957,131640009,53,89,5,147
"4139","chr11",131768122,131768139,18,11,15,44
"4140","chr11",132605569,132605593,25,100,69,194
"4141","chr11",132619684,132619702,19,77,27,123
"4142","chr11",132688957,132688984,28,33,67,128
"4143","chr11",132796566,132796591,26,4,79,109
"4144","chr11",132996619,132996636,18,113,67,198
"4145","chr11",133083111,133083165,55,47,43,145
"4146","chr11",133833060,133833080,21,45,118,184
"4147","chr11",133864301,133864318,18,36,73,127
"4148","chr11",134147460,134147478,19,50,68,137
"4149","chr11",134328015,134328034,20,126,87,233
"4150","chr11",134342432,134342455,24,67,75,166
"4151","chr11",134411671,134411705,35,23,35,93
"4152","chr11",134412253,134412300,48,6,68,122
"4153","chr11",134881911,134881939,29,124,45,198
"4154","chr11",135008892,135008915,24,142,34,200
"4155","chr12",76087,76132,46,37,15,98
"4156","chr12",107398,107427,30,8,140,178
"4157","chr12",163229,163246,18,12,55,85
"4158","chr12",163261,163278,18,26,23,67
"4159","chr12",163293,163310,18,58,53,129
"4160","chr12",454102,454129,28,21,7,56
"4161","chr12",456428,456517,90,77,39,206
"4162","chr12",552293,552336,44,54,19,117
"4163","chr12",554790,554817,28,25,74,127
"4164","chr12",570676,570705,30,43,55,128
"4165","chr12",631359,631381,23,76,1,100
"4166","chr12",641845,641862,18,12,6,36
"4167","chr12",690064,690117,54,7,71,132
"4168","chr12",721843,721875,33,76,5,114
"4169","chr12",740141,740177,37,17,2,56
"4170","chr12",935858,935899,42,25,1,68
"4171","chr12",953307,953326,20,56,72,148
"4172","chr12",990935,990967,33,15,120,168
"4173","chr12",996250,996275,26,16,109,151
"4174","chr12",1042339,1042364,26,67,143,236
"4175","chr12",1255622,1255650,29,76,4,109
"4176","chr12",1394016,1394044,29,73,43,145
"4177","chr12",1440200,1440218,19,4,100,123
"4178","chr12",1473630,1473649,20,94,34,148
"4179","chr12",1530983,1531002,20,10,44,74
"4180","chr12",1594157,1594183,27,4,30,61
"4181","chr12",1594397,1594432,36,49,25,110
"4182","chr12",1721206,1721235,30,78,68,176
"4183","chr12",1738210,1738230,21,108,116,245
"4184","chr12",2052894,2052943,50,39,29,118
"4185","chr12",2053036,2053070,35,39,8,82
"4186","chr12",2072170,2072213,44,73,31,148
"4187","chr12",2450554,2450578,25,68,6,99
"4188","chr12",2687539,2687556,18,75,12,105
"4189","chr12",2794792,2794814,23,119,19,161
"4190","chr12",2810856,2810883,28,3,25,56
"4191","chr12",2851653,2851691,39,71,135,245
"4192","chr12",2875928,2875945,18,40,75,133
"4193","chr12",2901286,2901328,43,5,119,167
"4194","chr12",2901374,2901397,24,74,31,129
"4195","chr12",2918112,2918133,22,38,20,80
"4196","chr12",2945240,2945267,28,103,74,205
"4197","chr12",2952378,2952416,39,47,74,160
"4198","chr12",2952652,2952670,19,27,18,64
"4199","chr12",2959239,2959286,48,85,107,240
"4200","chr12",2959808,2959826,19,14,7,40
"4201","chr12",2962264,2962347,84,70,135,289
"4202","chr12",3003887,3003905,19,1,17,37
"4203","chr12",3076640,3076658,19,112,4,135
"4204","chr12",3077281,3077345,65,30,12,107
"4205","chr12",3077388,3077407,20,29,90,139
"4206","chr12",3118257,3118280,24,9,61,94
"4207","chr12",3200497,3200514,18,3,63,84
"4208","chr12",3209959,3209986,28,145,6,179
"4209","chr12",3235183,3235218,36,7,59,102
"4210","chr12",3235218,3235271,54,60,24,138
"4211","chr12",3337573,3337601,29,54,19,102
"4212","chr12",3345072,3345091,20,76,84,180
"4213","chr12",3491294,3491312,19,44,21,84
"4214","chr12",3491833,3491889,57,20,65,142
"4215","chr12",3839153,3839183,31,90,125,246
"4216","chr12",3839189,3839211,23,118,89,230
"4217","chr12",3909331,3909359,29,60,27,116
"4218","chr12",3952332,3952358,27,76,40,143
"4219","chr12",4005149,4005184,36,8,35,79
"4220","chr12",4011000,4011026,27,9,31,67
"4221","chr12",4011175,4011193,19,82,75,176
"4222","chr12",4118527,4118568,42,8,88,138
"4223","chr12",4118586,4118614,29,54,29,112
"4224","chr12",4122332,4122350,19,73,70,162
"4225","chr12",4272028,4272056,29,140,57,226
"4226","chr12",4333468,4333486,19,76,64,159
"4227","chr12",4431898,4431915,18,78,124,220
"4228","chr12",5235156,5235186,31,21,76,128
"4229","chr12",5372788,5372819,32,75,146,253
"4230","chr12",5394167,5394189,23,112,6,141
"4231","chr12",5887829,5887851,23,33,147,203
"4232","chr12",6057481,6057527,47,48,26,121
"4233","chr12",6223262,6223279,18,76,23,117
"4234","chr12",6246329,6246350,22,76,142,240
"4235","chr12",6248563,6248581,19,8,105,132
"4236","chr12",6267013,6267044,32,120,60,212
"4237","chr12",6268024,6268042,19,114,73,206
"4238","chr12",6281989,6282012,24,23,9,56
"4239","chr12",6289179,6289201,23,142,28,193
"4240","chr12",6292313,6292339,27,25,71,123
"4241","chr12",6385905,6385922,18,67,7,92
"4242","chr12",6429522,6429541,20,31,73,124
"4243","chr12",6555481,6555500,20,6,27,53
"4244","chr12",6659508,6659526,19,115,73,207
"4245","chr12",6706106,6706128,23,76,21,120
"4246","chr12",6739114,6739135,22,77,5,104
"4247","chr12",6756469,6756488,20,76,48,144
"4248","chr12",6756831,6756859,29,12,81,122
"4249","chr12",6766569,6766606,38,58,18,114
"4250","chr12",6766683,6766702,20,54,83,157
"4251","chr12",6778911,6778941,31,81,81,193
"4252","chr12",6793959,6794080,122,66,145,333
"4253","chr12",6794776,6794802,27,5,41,73
"4254","chr12",6821774,6821808,35,67,49,151
"4255","chr12",6828461,6828483,23,30,114,167
"4256","chr12",6840894,6840914,21,56,2,79
"4257","chr12",6867707,6867732,26,55,113,194
"4258","chr12",6914608,6914631,24,17,18,59
"4259","chr12",6927600,6927619,20,125,94,239
"4260","chr12",7098272,7098295,24,83,5,112
"4261","chr12",7315613,7315643,31,114,4,149
"4262","chr12",7629525,7629550,26,6,61,93
"4263","chr12",7676054,7676071,18,144,74,236
"4264","chr12",7692010,7692034,25,31,3,59
"4265","chr12",7706516,7706561,46,8,5,59
"4266","chr12",7712746,7712770,25,52,11,88
"4267","chr12",7714693,7714728,36,6,64,106
"4268","chr12",7757765,7757792,28,34,5,67
"4269","chr12",7783575,7783703,129,15,93,237
"4270","chr12",7824729,7824746,18,42,127,187
"4271","chr12",7824810,7824830,21,126,46,193
"4272","chr12",7827271,7827292,22,75,33,130
"4273","chr12",7874678,7875257,580,44,37,661
"4274","chr12",7883566,7883610,45,18,145,208
"4275","chr12",7901983,7902008,26,76,142,244
"4276","chr12",7931881,7931898,18,8,19,45
"4277","chr12",7937547,7937572,26,145,28,199
"4278","chr12",7955562,7955588,27,147,6,180
"4279","chr12",7968826,7968851,26,77,74,177
"4280","chr12",7998150,7998169,20,6,61,87
"4281","chr12",8002422,8002441,20,78,74,172
"4282","chr12",8032722,8032753,32,2,36,70
"4283","chr12",8062950,8062975,26,8,4,38
"4284","chr12",8653193,8653225,33,28,73,134
"4285","chr12",8670027,8670051,25,113,6,144
"4286","chr12",8682773,8682820,48,40,5,93
"4287","chr12",8705477,8705494,18,141,6,165
"4288","chr12",8743355,8743377,23,147,5,175
"4289","chr12",8831736,8831766,31,7,83,121
"4290","chr12",9060182,9060206,25,40,133,198
"4291","chr12",9065152,9065177,26,122,28,176
"4292","chr12",9315602,9315630,29,23,6,58
"4293","chr12",9416158,9416198,41,8,27,76
"4294","chr12",9514865,9514883,19,8,59,86
"4295","chr12",9585813,9585834,22,26,75,123
"4296","chr12",10120738,10120769,32,73,135,240
"4297","chr12",10136237,10136260,24,73,5,102
"4298","chr12",10709829,10709851,23,12,57,92
"4299","chr12",10723070,10723092,23,30,23,76
"4300","chr12",10916883,10916929,47,80,36,163
"4301","chr12",11517605,11517632,28,31,135,194
"4302","chr12",11649955,11649973,19,124,8,151
"4303","chr12",11871198,11871215,18,17,48,83
"4304","chr12",12110420,12110448,29,69,114,212
"4305","chr12",12202543,12202569,27,70,7,104
"4306","chr12",12271557,12271579,23,13,74,110
"4307","chr12",12271863,12271882,20,124,4,148
"4308","chr12",12288552,12288574,23,4,5,32
"4309","chr12",12322906,12323224,319,1,74,394
"4310","chr12",12448210,12448228,19,3,31,53
"4311","chr12",12562926,12562963,38,97,10,145
"4312","chr12",12657308,12657329,22,119,6,147
"4313","chr12",12657327,12657354,28,144,55,227
"4314","chr12",12665820,12665853,34,29,23,86
"4315","chr12",12760328,12760349,22,5,141,168
"4316","chr12",12766842,12766887,46,10,81,137
"4317","chr12",12783621,12783655,35,12,137,184
"4318","chr12",12796531,12796563,33,11,100,144
"4319","chr12",12805677,12805706,30,83,74,187
"4320","chr12",12886828,12886864,37,76,65,178
"4321","chr12",12895822,12895843,22,145,28,195
"4322","chr12",12915611,12915643,33,142,30,205
"4323","chr12",13353116,13353140,25,74,97,196
"4324","chr12",13981884,13981908,25,126,18,169
"4325","chr12",13982023,13982041,19,3,60,82
"4326","chr12",14312047,14312086,40,76,73,189
"4327","chr12",14567616,14567642,27,114,39,180
"4328","chr12",14665219,14665237,19,130,121,270
"4329","chr12",14752715,14752733,19,76,36,131
"4330","chr12",14982039,14982057,19,76,140,235
"4331","chr12",15940338,15940362,25,69,1,95
"4332","chr12",16583047,16583066,20,51,6,77
"4333","chr12",16805579,16805617,39,49,5,93
"4334","chr12",17431603,17431624,22,119,67,208
"4335","chr12",17961126,17961145,20,29,78,127
"4336","chr12",18226947,18226964,18,9,50,77
"4337","chr12",18254854,18254874,21,75,72,168
"4338","chr12",19130684,19130708,25,24,31,80
"4339","chr12",19266303,19266341,39,39,79,157
"4340","chr12",19360606,19360651,46,90,72,208
"4341","chr12",19408903,19408944,42,113,74,229
"4342","chr12",19439378,19439437,60,137,4,201
"4343","chr12",19439808,19439850,43,23,107,173
"4344","chr12",19439879,19439914,36,87,36,159
"4345","chr12",19762591,19762618,28,7,4,39
"4346","chr12",19775917,19775940,24,76,14,114
"4347","chr12",20845028,20845047,20,44,76,140
"4348","chr12",21249954,21249977,24,8,9,41
"4349","chr12",22232836,22232868,33,64,9,106
"4350","chr12",22335336,22335378,43,104,109,256
"4351","chr12",23320643,23320666,24,13,1,38
"4352","chr12",23917380,23917403,24,78,32,134
"4353","chr12",24370477,24370495,19,105,6,130
"4354","chr12",25246559,25246577,19,90,73,182
"4355","chr12",25250861,25250926,66,110,4,180
"4356","chr12",25370637,25370658,22,8,25,55
"4357","chr12",25810179,25810201,23,77,71,171
"4358","chr12",25958634,25958662,29,59,7,95
"4359","chr12",26122283,26122314,32,84,7,123
"4360","chr12",26358386,26358422,37,13,6,56
"4361","chr12",26771486,26771530,45,74,76,195
"4362","chr12",26811685,26811704,20,76,76,172
"4363","chr12",26811854,26811872,19,138,6,163
"4364","chr12",26884150,26884356,207,106,146,459
"4365","chr12",27012996,27013014,19,104,76,199
"4366","chr12",27313366,27313385,20,62,1,83
"4367","chr12",27327362,27327394,33,35,24,92
"4368","chr12",27464717,27464739,23,5,6,34
"4369","chr12",27595853,27595885,33,95,7,135
"4370","chr12",27919322,27919346,25,61,40,126
"4371","chr12",27949474,27949500,27,75,6,108
"4372","chr12",27970338,27970370,33,4,13,50
"4373","chr12",29074613,29074648,36,11,5,52
"4374","chr12",29074618,29074655,38,18,68,124
"4375","chr12",29174424,29174452,29,22,49,100
"4376","chr12",30616889,30616908,20,80,74,174
"4377","chr12",30754989,30755033,45,91,51,187
"4378","chr12",30797384,30797403,20,75,78,173
"4379","chr12",30922402,30922427,26,48,72,146
"4380","chr12",30980543,30980565,23,127,81,231
"4381","chr12",31017759,31017960,202,71,62,335
"4382","chr12",31175750,31175769,20,61,6,87
"4383","chr12",31305697,31305717,21,8,49,78
"4384","chr12",31329552,31329579,28,4,5,37
"4385","chr12",31365421,31365438,18,73,72,163
"4386","chr12",31371849,31371874,26,16,76,118
"4387","chr12",31405512,31405561,50,72,132,254
"4388","chr12",31407108,31407130,23,58,1,82
"4389","chr12",31454813,31454836,24,8,79,111
"4390","chr12",31590854,31590871,18,114,81,213
"4391","chr12",31592767,31592790,24,110,33,167
"4392","chr12",31636903,31636953,51,11,104,166
"4393","chr12",31638540,31638559,20,29,75,124
"4394","chr12",31648558,31648581,24,78,86,188
"4395","chr12",31659987,31660009,23,137,33,193
"4396","chr12",31680193,31680216,24,74,4,102
"4397","chr12",31777315,31777360,46,5,98,149
"4398","chr12",31798588,31798618,31,68,21,120
"4399","chr12",31827516,31827550,35,143,4,182
"4400","chr12",31898173,31898226,54,57,10,121
"4401","chr12",31914302,31914322,21,78,125,224
"4402","chr12",31946673,31946692,20,102,73,195
"4403","chr12",32026800,32026820,21,20,74,115
"4404","chr12",32038767,32038788,22,75,143,240
"4405","chr12",32298871,32298889,19,85,5,109
"4406","chr12",32399402,32399426,25,63,59,147
"4407","chr12",32402118,32402146,29,53,27,109
"4408","chr12",32407122,32407142,21,75,134,230
"4409","chr12",32481128,32481157,30,148,47,225
"4410","chr12",32599535,32599564,30,6,33,69
"4411","chr12",32676348,32676368,21,75,138,234
"4412","chr12",32678877,32678911,35,21,6,62
"4413","chr12",32678890,32678915,26,25,61,112
"4414","chr12",32685360,32685378,19,7,22,48
"4415","chr12",32896966,32896987,22,30,18,70
"4416","chr12",32919148,32919189,42,68,20,130
"4417","chr12",33440021,33440041,21,123,76,220
"4418","chr12",34124916,34124956,41,125,30,196
"4419","chr12",34233059,34233084,26,147,10,183
"4420","chr12",34340087,34340137,51,27,26,104
"4421","chr12",38055971,38055989,19,5,4,28
"4422","chr12",38056181,38056198,18,59,104,181
"4423","chr12",38076368,38076401,34,6,43,83
"4424","chr12",39186838,39186860,23,57,5,85
"4425","chr12",40031219,40031242,24,78,106,208
"4426","chr12",40691011,40691033,23,37,125,185
"4427","chr12",41033883,41033900,18,145,27,190
"4428","chr12",41713183,41713202,20,27,78,125
"4429","chr12",41791890,41791908,19,77,63,159
"4430","chr12",42286286,42286306,21,29,143,193
"4431","chr12",42292757,42292784,28,72,67,167
"4432","chr12",42455637,42455655,19,74,60,153
"4433","chr12",42484012,42484048,37,107,99,243
"4434","chr12",42499726,42499745,20,76,5,101
"4435","chr12",42564254,42564290,37,113,76,226
"4436","chr12",42653280,42653322,43,67,75,185
"4437","chr12",42788664,42788683,20,78,9,107
"4438","chr12",42830175,42830201,27,1,30,58
"4439","chr12",44600128,44600188,61,31,144,236
"4440","chr12",44877147,44877167,21,34,8,63
"4441","chr12",45142628,45142647,20,8,33,61
"4442","chr12",45729289,45729306,18,28,9,55
"4443","chr12",45729580,45729664,85,62,26,173
"4444","chr12",45729666,45729709,44,107,6,157
"4445","chr12",45730874,45730895,22,85,92,199
"4446","chr12",46032823,46032847,25,8,139,172
"4447","chr12",46383591,46383646,56,64,38,158
"4448","chr12",47080788,47080846,59,41,59,159
"4449","chr12",47212075,47212094,20,41,6,67
"4450","chr12",47292923,47292945,23,144,36,203
"4451","chr12",47405229,47405287,59,5,140,204
"4452","chr12",47405287,47405311,25,29,82,136
"4453","chr12",47405546,47405572,27,14,37,78
"4454","chr12",47790467,47790503,37,24,71,132
"4455","chr12",47819651,47819696,46,4,43,93
"4456","chr12",47842624,47842643,20,28,144,192
"4457","chr12",47855340,47855371,32,146,62,240
"4458","chr12",47942342,47942371,30,133,79,242
"4459","chr12",48350994,48351055,62,48,28,138
"4460","chr12",48587450,48587475,26,94,2,122
"4461","chr12",48743934,48743963,30,10,72,112
"4462","chr12",48770064,48770084,21,36,8,65
"4463","chr12",48788962,48788980,19,6,50,75
"4464","chr12",48871973,48871994,22,55,5,82
"4465","chr12",48878241,48878272,32,3,122,157
"4466","chr12",48902167,48902200,34,78,1,113
"4467","chr12",48913480,48913509,30,6,66,102
"4468","chr12",48925376,48925395,20,95,96,211
"4469","chr12",48928819,48928840,22,76,23,121
"4470","chr12",48951566,48951597,32,147,28,207
"4471","chr12",48971629,48971657,29,70,105,204
"4472","chr12",48992071,48992097,27,8,145,180
"4473","chr12",49033867,49033912,46,103,31,180
"4474","chr12",49045644,49045661,18,87,6,111
"4475","chr12",49073142,49073172,31,34,8,73
"4476","chr12",49076839,49076862,24,73,3,100
"4477","chr12",49077964,49077986,23,58,6,87
"4478","chr12",49091854,49091871,18,6,47,71
"4479","chr12",49112649,49112679,31,137,6,174
"4480","chr12",49119368,49119404,37,77,71,185
"4481","chr12",49119555,49119581,27,52,5,84
"4482","chr12",49122365,49122384,20,6,1,27
"4483","chr12",49219032,49219067,36,4,74,114
"4484","chr12",49253087,49253107,21,108,71,200
"4485","chr12",49265958,49265982,25,128,14,167
"4486","chr12",49266262,49266280,19,77,31,127
"4487","chr12",49280502,49280519,18,102,33,153
"4488","chr12",49290831,49290858,28,8,64,100
"4489","chr12",49292313,49292358,46,52,64,162
"4490","chr12",49334194,49334217,24,117,41,182
"4491","chr12",49376710,49376735,26,75,136,237
"4492","chr12",49383014,49383033,20,42,1,63
"4493","chr12",49409593,49409619,27,7,23,57
"4494","chr12",49539015,49539032,18,7,131,156
"4495","chr12",49544139,49544164,26,71,139,236
"4496","chr12",49545404,49545423,20,22,128,170
"4497","chr12",49551575,49551603,29,75,7,111
"4498","chr12",49555285,49555302,18,82,27,127
"4499","chr12",49569398,49569416,19,38,61,118
"4500","chr12",49729576,49729597,22,144,6,172
"4501","chr12",49732975,49732999,25,105,87,217
"4502","chr12",50023734,50023760,27,28,42,97
"4503","chr12",50029387,50029422,36,75,73,184
"4504","chr12",50031479,50031500,22,5,6,33
"4505","chr12",50037123,50037146,24,63,31,118
"4506","chr12",50054535,50054555,21,147,6,174
"4507","chr12",50074315,50074347,33,91,11,135
"4508","chr12",50113031,50113050,20,31,121,172
"4509","chr12",50113304,50113321,18,8,16,42
"4510","chr12",50113608,50113646,39,72,6,117
"4511","chr12",50126464,50126482,19,77,146,242
"4512","chr12",50139486,50139511,26,60,1,87
"4513","chr12",50155737,50155762,26,90,74,190
"4514","chr12",50171381,50171406,26,8,142,176
"4515","chr12",50175036,50175077,42,10,115,167
"4516","chr12",50267064,50267086,23,7,122,152
"4517","chr12",50346176,50346265,90,92,2,184
"4518","chr12",50361961,50361989,29,75,55,159
"4519","chr12",50457202,50457222,21,74,145,240
"4520","chr12",50459823,50459846,24,5,75,104
"4521","chr12",50489590,50489613,24,74,132,230
"4522","chr12",50505002,50505024,23,2,109,134
"4523","chr12",50505215,50505232,18,114,52,184
"4524","chr12",50525358,50525375,18,138,74,230
"4525","chr12",50754336,50754353,18,4,74,96
"4526","chr12",50763640,50763662,23,3,50,76
"4527","chr12",50924530,50924555,26,23,112,161
"4528","chr12",51016848,51016871,24,117,5,146
"4529","chr12",51046388,51046411,24,10,14,48
"4530","chr12",51047592,51047620,29,111,7,147
"4531","chr12",51056631,51056671,41,75,84,200
"4532","chr12",51066454,51066471,18,125,73,216
"4533","chr12",51074108,51074135,28,76,43,147
"4534","chr12",51084328,51084346,19,86,6,111
"4535","chr12",51180635,51180661,27,129,61,217
"4536","chr12",51217721,51217744,24,8,17,49
"4537","chr12",51260368,51260390,23,4,65,92
"4538","chr12",51270006,51270042,37,26,11,74
"4539","chr12",51290934,51290957,24,103,18,145
"4540","chr12",51295393,51295413,21,77,27,125
"4541","chr12",51298372,51298395,24,69,74,167
"4542","chr12",51316329,51316346,18,145,55,218
"4543","chr12",51323964,51323981,18,60,142,220
"4544","chr12",51392573,51392613,41,79,56,176
"4545","chr12",51426921,51426956,36,8,102,146
"4546","chr12",51500861,51500879,19,10,68,97
"4547","chr12",51610170,51610192,23,119,6,148
"4548","chr12",51681007,51681026,20,10,3,33
"4549","chr12",51720076,51720095,20,79,6,105
"4550","chr12",51848772,51848789,18,22,113,153
"4551","chr12",51890756,51890781,26,1,131,158
"4552","chr12",51939258,51939296,39,10,65,114
"4553","chr12",51951714,51951735,22,8,32,62
"4554","chr12",51978830,51978849,20,66,7,93
"4555","chr12",51993766,51993804,39,95,75,209
"4556","chr12",52000375,52000399,25,8,60,93
"4557","chr12",52028203,52028229,27,83,5,115
"4558","chr12",52089598,52089636,39,89,11,139
"4559","chr12",52096475,52096541,67,56,40,163
"4560","chr12",52120440,52120482,43,77,39,159
"4561","chr12",52129481,52129507,27,8,43,78
"4562","chr12",52903845,52903890,46,6,77,129
"4563","chr12",52948488,52948515,28,14,21,63
"4564","chr12",52958439,52958471,33,10,22,65
"4565","chr12",52973825,52974012,188,56,116,360
"4566","chr12",52994351,52994392,42,76,145,263
"4567","chr12",52994701,52994720,20,8,118,146
"4568","chr12",53003691,53003716,26,12,6,44
"4569","chr12",53005695,53005720,26,115,74,215
"4570","chr12",53012586,53012619,34,4,42,80
"4571","chr12",53027138,53027157,20,82,91,193
"4572","chr12",53047176,53047203,28,44,118,190
"4573","chr12",53054840,53054866,27,73,77,177
"4574","chr12",53066347,53066399,53,112,141,306
"4575","chr12",53141613,53141640,28,9,6,43
"4576","chr12",53141924,53141954,31,106,8,145
"4577","chr12",53150275,53150306,32,107,42,181
"4578","chr12",53173266,53173310,45,55,16,116
"4579","chr12",53178785,53178809,25,14,16,55
"4580","chr12",53238647,53238669,23,6,128,157
"4581","chr12",53252048,53252073,26,1,135,162
"4582","chr12",53266443,53266461,19,97,74,190
"4583","chr12",53322342,53322359,18,71,62,151
"4584","chr12",53351893,53351913,21,76,45,142
"4585","chr12",53352200,53352218,19,70,142,231
"4586","chr12",53369042,53369072,31,22,30,83
"4587","chr12",53380401,53380418,18,22,2,42
"4588","chr12",53384268,53384289,22,63,12,97
"4589","chr12",53396569,53396592,24,109,5,138
"4590","chr12",53442875,53442897,23,31,7,61
"4591","chr12",53452151,53452184,34,22,23,79
"4592","chr12",53452224,53452259,36,5,51,92
"4593","chr12",53469761,53469779,19,28,40,87
"4594","chr12",53499495,53499528,34,93,19,146
"4595","chr12",53555813,53555831,19,74,8,101
"4596","chr12",53622305,53622329,25,138,71,234
"4597","chr12",53741850,53741883,34,66,11,111
"4598","chr12",53955353,53955389,37,23,73,133
"4599","chr12",53975455,53975477,23,16,73,112
"4600","chr12",53975458,53975484,27,23,70,120
"4601","chr12",53984866,53984889,24,88,42,154
"4602","chr12",54009025,54009073,49,22,67,138
"4603","chr12",54079823,54079856,34,83,51,168
"4604","chr12",54129972,54130006,35,45,15,95
"4605","chr12",54129990,54130035,46,74,69,189
"4606","chr12",54185474,54185529,56,146,68,270
"4607","chr12",54188268,54188340,73,142,54,269
"4608","chr12",54219608,54219629,22,77,28,127
"4609","chr12",54219771,54219815,45,16,14,75
"4610","chr12",54220094,54220120,27,85,6,118
"4611","chr12",54250812,54250844,33,57,67,157
"4612","chr12",54251517,54251541,25,83,76,184
"4613","chr12",54308950,54308967,18,17,123,158
"4614","chr12",54308986,54309026,41,8,87,136
"4615","chr12",54320322,54320348,27,8,100,135
"4616","chr12",54321929,54321948,20,45,6,71
"4617","chr12",54323047,54323069,23,147,75,245
"4618","chr12",54326125,54326154,30,5,4,39
"4619","chr12",54354428,54354451,24,77,134,235
"4620","chr12",54354597,54354615,19,26,78,123
"4621","chr12",54419099,54419127,29,44,43,116
"4622","chr12",54676109,54676128,20,78,74,172
"4623","chr12",55743124,55743170,47,46,26,119
"4624","chr12",55743401,55743440,40,99,24,163
"4625","chr12",55759584,55759612,29,27,69,125
"4626","chr12",55771102,55771131,30,29,78,137
"4627","chr12",55829445,55829477,33,13,74,120
"4628","chr12",55845003,55845025,23,74,62,159
"4629","chr12",55859220,55859249,30,36,73,139
"4630","chr12",55864872,55864890,19,7,85,111
"4631","chr12",55878971,55878994,24,48,2,74
"4632","chr12",55881492,55881522,31,8,29,68
"4633","chr12",56006625,56006650,26,8,10,44
"4634","chr12",56052851,56052878,28,7,121,156
"4635","chr12",56054115,56054140,26,75,75,176
"4636","chr12",56151221,56151253,33,33,76,142
"4637","chr12",56152690,56152723,34,70,17,121
"4638","chr12",56203703,56203724,22,9,1,32
"4639","chr12",56211975,56211992,18,138,3,159
"4640","chr12",56251739,56251760,22,9,83,114
"4641","chr12",56257965,56257983,19,41,110,170
"4642","chr12",56258303,56258321,19,25,25,69
"4643","chr12",56263364,56263383,20,76,12,108
"4644","chr12",56290203,56290227,25,6,138,169
"4645","chr12",56309552,56309570,19,145,4,168
"4646","chr12",56345173,56345198,26,109,125,260
"4647","chr12",56429668,56429696,29,37,143,209
"4648","chr12",56448407,56448442,36,8,5,49
"4649","chr12",56488264,56488281,18,55,20,93
"4650","chr12",56491193,56491230,38,79,2,119
"4651","chr12",56502689,56502719,31,75,88,194
"4652","chr12",56538467,56538493,27,69,12,108
"4653","chr12",56634966,56634983,18,94,44,156
"4654","chr12",56681538,56681561,24,142,6,172
"4655","chr12",56685771,56685794,24,45,74,143
"4656","chr12",56700262,56700281,20,8,56,84
"4657","chr12",56726286,56726304,19,16,13,48
"4658","chr12",56727335,56727354,20,78,36,134
"4659","chr12",56778669,56778692,24,8,53,85
"4660","chr12",57023520,57023542,23,75,141,239
"4661","chr12",57075391,57075433,43,120,71,234
"4662","chr12",57077331,57077348,18,145,7,170
"4663","chr12",57088951,57088980,30,43,35,108
"4664","chr12",57182517,57182534,18,13,67,98
"4665","chr12",57302276,57302299,24,63,124,211
"4666","chr12",57364953,57364972,20,52,6,78
"4667","chr12",57441043,57441070,28,146,23,197
"4668","chr12",57487851,57487874,24,12,54,90
"4669","chr12",57522717,57522778,62,14,123,199
"4670","chr12",57672449,57672470,22,11,75,108
"4671","chr12",57729176,57729209,34,39,6,79
"4672","chr12",57737517,57737541,25,46,18,89
"4673","chr12",57755080,57755097,18,9,111,138
"4674","chr12",57846488,57846505,18,3,116,137
"4675","chr12",57885046,57885091,46,36,74,156
"4676","chr12",58438991,58439013,23,107,76,206
"4677","chr12",59458967,59458988,22,27,14,63
"4678","chr12",59526177,59526196,20,29,73,122
"4679","chr12",59614825,59614853,29,77,31,137
"4680","chr12",60084976,60084999,24,77,22,123
"4681","chr12",60556174,60556195,22,29,75,126
"4682","chr12",60869683,60869750,68,41,51,160
"4683","chr12",61851775,61851818,44,40,43,127
"4684","chr12",62059130,62059170,41,64,16,121
"4685","chr12",62072300,62072317,18,143,36,197
"4686","chr12",62072473,62072490,18,139,2,159
"4687","chr12",62793741,62793762,22,82,57,161
"4688","chr12",62819131,62819148,18,9,135,162
"4689","chr12",62838921,62838951,31,114,6,151
"4690","chr12",63141494,63141512,19,19,66,104
"4691","chr12",63591979,63592064,86,1,39,126
"4692","chr12",63594638,63594671,34,2,17,53
"4693","chr12",63738413,63738436,24,77,128,229
"4694","chr12",63821898,63821918,21,127,50,198
"4695","chr12",63883650,63883676,27,8,55,90
"4696","chr12",64152912,64152936,25,125,81,231
"4697","chr12",64155545,64155579,35,5,5,45
"4698","chr12",64379928,64379951,24,73,27,124
"4699","chr12",64404467,64404499,33,6,3,42
"4700","chr12",64404548,64404569,22,76,17,115
"4701","chr12",64404567,64404586,20,93,88,201
"4702","chr12",64454673,64454694,22,8,19,49
"4703","chr12",64454979,64455005,27,77,8,112
"4704","chr12",64648803,64648822,20,7,123,150
"4705","chr12",64749249,64749270,22,8,135,165
"4706","chr12",64759301,64759318,18,80,91,189
"4707","chr12",64824593,64824613,21,20,112,153
"4708","chr12",65121822,65121869,48,127,37,212
"4709","chr12",65122554,65122576,23,66,40,129
"4710","chr12",65148098,65148133,36,76,91,203
"4711","chr12",65278446,65278539,94,88,6,188
"4712","chr12",65278805,65278836,32,39,55,126
"4713","chr12",65337254,65337283,30,76,63,169
"4714","chr12",65633759,65633796,38,74,97,209
"4715","chr12",65739001,65739030,30,25,73,128
"4716","chr12",65740096,65740119,24,30,25,79
"4717","chr12",65741567,65741634,68,2,47,117
"4718","chr12",65824709,65824769,61,44,91,196
"4719","chr12",65824970,65824999,30,58,56,144
"4720","chr12",65825036,65825064,29,48,113,190
"4721","chr12",65875590,65875630,41,35,144,220
"4722","chr12",66173785,66173810,26,9,20,55
"4723","chr12",66220515,66220538,24,8,66,98
"4724","chr12",66303454,66303473,20,22,45,87
"4725","chr12",66377495,66377512,18,29,75,122
"4726","chr12",67069309,67069332,24,2,6,32
"4727","chr12",67069330,67069353,24,23,30,77
"4728","chr12",67297103,67297120,18,89,112,219
"4729","chr12",68161587,68161609,23,26,78,127
"4730","chr12",68273447,68273479,33,29,5,67
"4731","chr12",68570467,68570496,30,13,73,116
"4732","chr12",68769242,68769261,20,34,74,128
"4733","chr12",68840495,68840533,39,86,94,219
"4734","chr12",68897737,68897755,19,72,6,97
"4735","chr12",68931745,68931766,22,87,82,191
"4736","chr12",68931764,68931792,29,113,63,205
"4737","chr12",69239611,69239631,21,14,38,73
"4738","chr12",69477710,69477755,46,5,17,68
"4739","chr12",69588923,69588941,19,71,74,164
"4740","chr12",69632458,69632480,23,58,13,94
"4741","chr12",70116689,70116714,26,56,7,89
"4742","chr12",70169244,70169289,46,77,74,197
"4743","chr12",70242991,70243025,35,138,11,184
"4744","chr12",70366181,70366211,31,45,22,98
"4745","chr12",70366626,70366651,26,13,79,118
"4746","chr12",70920836,70920869,34,1,62,97
"4747","chr12",71480361,71480379,19,115,9,143
"4748","chr12",71497343,71497389,47,112,14,173
"4749","chr12",71663476,71663493,18,32,100,150
"4750","chr12",71681647,71681686,40,13,99,152
"4751","chr12",71681723,71681745,23,72,23,118
"4752","chr12",71864486,71864525,40,45,27,112
"4753","chr12",74113125,74113149,25,82,133,240
"4754","chr12",75138980,75139006,27,114,75,216
"4755","chr12",75778584,75778611,28,144,70,242
"4756","chr12",75952203,75952221,19,5,19,43
"4757","chr12",76027762,76027780,19,137,6,162
"4758","chr12",76541857,76541881,25,139,73,237
"4759","chr12",76677158,76677182,25,8,101,134
"4760","chr12",76731465,76731496,32,8,11,51
"4761","chr12",76763529,76763562,34,97,3,134
"4762","chr12",76923532,76923551,20,78,138,236
"4763","chr12",77065844,77065870,27,63,71,161
"4764","chr12",77622535,77622560,26,29,69,124
"4765","chr12",79245303,79245325,23,77,34,134
"4766","chr12",79249089,79249115,27,69,51,147
"4767","chr12",79307615,79307632,18,49,99,166
"4768","chr12",79613932,79613980,49,28,78,155
"4769","chr12",79613980,79614027,48,75,30,153
"4770","chr12",79691010,79691050,41,1,53,95
"4771","chr12",79694318,79694344,27,29,75,131
"4772","chr12",79762855,79762879,25,37,73,135
"4773","chr12",79909728,79909746,19,34,80,133
"4774","chr12",79909789,79909815,27,32,19,78
"4775","chr12",80578385,80578408,24,8,9,41
"4776","chr12",81145068,81145089,22,29,75,126
"4777","chr12",81759346,81759379,34,82,33,149
"4778","chr12",81946662,81946681,20,4,6,30
"4779","chr12",82337632,82337649,18,148,19,185
"4780","chr12",82686970,82686999,30,71,8,109
"4781","chr12",82722567,82722592,26,145,6,177
"4782","chr12",82735970,82736003,34,117,77,228
"4783","chr12",84460500,84460517,18,37,75,130
"4784","chr12",85116139,85116161,23,77,71,171
"4785","chr12",85818957,85818980,24,111,8,143
"4786","chr12",85859507,85859528,22,114,37,173
"4787","chr12",86212725,86212742,18,77,35,130
"4788","chr12",86782172,86782199,28,8,63,99
"4789","chr12",89360438,89360461,24,77,25,126
"4790","chr12",90393576,90393626,51,75,32,158
"4791","chr12",90712102,90712120,19,28,69,116
"4792","chr12",91792258,91792283,26,127,70,223
"4793","chr12",92653295,92653314,20,42,6,68
"4794","chr12",92922960,92922997,38,79,72,189
"4795","chr12",93182951,93182982,32,7,8,47
"4796","chr12",93286948,93286971,24,13,6,43
"4797","chr12",93300111,93300128,18,12,70,100
"4798","chr12",93378291,93378310,20,9,17,46
"4799","chr12",93378533,93378577,45,42,18,105
"4800","chr12",93537648,93537669,22,27,78,127
"4801","chr12",93571520,93571564,45,121,143,309
"4802","chr12",94014104,94014127,24,72,147,243
"4803","chr12",94014606,94014624,19,8,133,160
"4804","chr12",94436827,94436878,52,7,78,137
"4805","chr12",94553162,94553184,23,35,75,133
"4806","chr12",94562514,94562543,30,76,49,155
"4807","chr12",94716514,94716544,31,74,84,189
"4808","chr12",94804521,94804546,26,11,74,111
"4809","chr12",94902715,94902736,22,134,5,161
"4810","chr12",94929355,94929375,21,137,71,229
"4811","chr12",95023129,95023159,31,146,18,195
"4812","chr12",95285086,95285108,23,98,74,195
"4813","chr12",95347548,95347570,23,73,10,106
"4814","chr12",95355466,95355491,26,146,73,245
"4815","chr12",95376646,95376665,20,27,143,190
"4816","chr12",95410067,95410092,26,133,6,165
"4817","chr12",95463687,95463706,20,45,116,181
"4818","chr12",95522779,95522800,22,65,73,160
"4819","chr12",95563818,95563848,31,145,27,203
"4820","chr12",95568615,95568643,29,69,94,192
"4821","chr12",95638795,95638820,26,62,6,94
"4822","chr12",95895755,95895776,22,148,72,242
"4823","chr12",95971751,95971770,20,34,4,58
"4824","chr12",96132733,96132764,32,23,33,88
"4825","chr12",96152649,96152704,56,8,22,86
"4826","chr12",96228417,96228444,28,92,75,195
"4827","chr12",96284463,96284484,22,4,72,98
"4828","chr12",96400596,96400639,44,1,13,58
"4829","chr12",96539067,96539090,24,20,135,179
"4830","chr12",96738609,96738629,21,127,18,166
"4831","chr12",96850217,96850238,22,145,33,200
"4832","chr12",96978486,96978513,28,8,139,175
"4833","chr12",97463062,97463108,47,14,72,133
"4834","chr12",98457029,98457056,28,58,34,120
"4835","chr12",98508634,98508660,27,77,61,165
"4836","chr12",98600402,98600429,28,7,143,178
"4837","chr12",98619874,98619895,22,17,43,82
"4838","chr12",98619913,98619936,24,58,4,86
"4839","chr12",98620094,98620113,20,48,85,153
"4840","chr12",98830941,98830965,25,8,10,43
"4841","chr12",98894985,98895009,25,41,16,82
"4842","chr12",99959055,99959073,19,71,49,139
"4843","chr12",100030102,100030124,23,8,132,163
"4844","chr12",100203646,100203668,23,76,103,202
"4845","chr12",100295764,100295801,38,35,49,122
"4846","chr12",100979896,100979913,18,29,74,121
"4847","chr12",101531816,101531837,22,76,119,217
"4848","chr12",101811639,101811656,18,76,108,202
"4849","chr12",101874016,101874052,37,8,5,50
"4850","chr12",101876725,101876757,33,4,146,183
"4851","chr12",102184047,102184066,20,89,34,143
"4852","chr12",102958374,102958430,57,33,56,146
"4853","chr12",103790695,103790718,24,20,135,179
"4854","chr12",103957893,103958056,164,135,17,316
"4855","chr12",104070802,104070822,21,76,136,233
"4856","chr12",104266525,104266544,20,10,75,105
"4857","chr12",104266963,104267000,38,61,5,104
"4858","chr12",104408936,104408979,44,28,40,112
"4859","chr12",104457039,104457070,32,93,14,139
"4860","chr12",104457786,104457818,33,4,50,87
"4861","chr12",104497910,104497934,25,73,23,121
"4862","chr12",104587757,104587795,39,64,86,189
"4863","chr12",104789462,104789486,25,8,113,146
"4864","chr12",105032175,105032195,21,8,33,62
"4865","chr12",105084231,105084253,23,14,75,112
"4866","chr12",105331592,105331624,33,89,41,163
"4867","chr12",105362385,105362409,25,37,7,69
"4868","chr12",105387739,105387759,21,28,137,186
"4869","chr12",105977039,105977058,20,79,9,108
"4870","chr12",106139196,106139217,22,21,71,114
"4871","chr12",106247570,106247601,32,14,19,65
"4872","chr12",106248274,106248310,37,9,31,77
"4873","chr12",106315006,106315023,18,83,40,141
"4874","chr12",106318887,106318922,36,69,66,171
"4875","chr12",106477892,106477921,30,75,45,150
"4876","chr12",106718955,106718972,18,145,27,190
"4877","chr12",106746356,106746375,20,70,56,146
"4878","chr12",107009564,107009602,39,122,49,210
"4879","chr12",107070868,107070885,18,37,75,130
"4880","chr12",107154745,107154769,25,4,21,50
"4881","chr12",107179395,107179419,25,49,6,80
"4882","chr12",107286978,107286998,21,9,75,105
"4883","chr12",107375423,107375466,44,46,69,159
"4884","chr12",108166699,108166820,122,36,29,187
"4885","chr12",108632390,108632428,39,22,25,86
"4886","chr12",108689033,108689050,18,77,31,126
"4887","chr12",108762245,108762315,71,1,11,83
"4888","chr12",108857600,108857623,24,2,112,138
"4889","chr12",108881957,108882000,44,107,94,245
"4890","chr12",109052622,109052639,18,43,35,96
"4891","chr12",109097059,109097077,19,98,41,158
"4892","chr12",109244756,109244774,19,4,79,102
"4893","chr12",109244777,109244805,29,35,58,122
"4894","chr12",109244799,109244826,28,56,36,120
"4895","chr12",109309939,109309994,56,64,20,140
"4896","chr12",109312382,109312415,34,35,73,142
"4897","chr12",109353394,109353419,26,131,6,163
"4898","chr12",109406468,109406500,33,77,4,114
"4899","chr12",109412954,109412982,29,64,142,235
"4900","chr12",109418542,109418566,25,13,49,87
"4901","chr12",109557552,109557570,19,1,29,49
"4902","chr12",109604832,109604859,28,115,8,151
"4903","chr12",109633551,109633588,38,5,21,64
"4904","chr12",109682122,109682142,21,19,132,172
"4905","chr12",109714197,109714230,34,31,47,112
"4906","chr12",109820517,109820541,25,10,26,61
"4907","chr12",109915443,109915466,24,20,122,166
"4908","chr12",109988849,109988871,23,22,78,123
"4909","chr12",109997205,109997229,25,145,11,181
"4910","chr12",110000756,110000774,19,7,32,58
"4911","chr12",110069441,110069464,24,48,41,113
"4912","chr12",110098056,110098073,18,126,10,154
"4913","chr12",110124175,110124284,110,40,140,290
"4914","chr12",110174278,110174307,30,145,74,249
"4915","chr12",110265625,110265665,41,108,20,169
"4916","chr12",110293368,110293388,21,20,145,186
"4917","chr12",110293386,110293412,27,44,127,198
"4918","chr12",110380651,110380668,18,143,74,235
"4919","chr12",110393868,110393889,22,146,73,241
"4920","chr12",110414655,110414718,64,15,16,95
"4921","chr12",110430928,110430958,31,19,6,56
"4922","chr12",110519410,110519448,39,8,139,186
"4923","chr12",110521556,110521574,19,9,43,71
"4924","chr12",110574943,110574961,19,26,146,191
"4925","chr12",110582935,110582954,20,8,8,36
"4926","chr12",110583283,110583300,18,116,82,216
"4927","chr12",110608457,110608479,23,133,72,228
"4928","chr12",110689169,110689211,43,39,45,127
"4929","chr12",110747127,110747144,18,22,7,47
"4930","chr12",110828150,110828326,177,44,51,272
"4931","chr12",110828186,110828354,169,72,15,256
"4932","chr12",110829935,110829959,25,77,25,127
"4933","chr12",110836364,110836401,38,91,75,204
"4934","chr12",110895108,110895129,22,6,49,77
"4935","chr12",110917491,110917521,31,90,60,181
"4936","chr12",110984090,110984110,21,78,106,205
"4937","chr12",111033971,111034003,33,43,54,130
"4938","chr12",111034713,111034756,44,14,18,76
"4939","chr12",111034861,111034894,34,15,50,99
"4940","chr12",111035956,111035978,23,75,25,123
"4941","chr12",111042074,111042092,19,32,68,119
"4942","chr12",111205142,111205160,19,114,93,226
"4943","chr12",111362902,111363018,117,1,44,162
"4944","chr12",111415923,111415959,37,76,144,257
"4945","chr12",111429016,111429070,55,78,2,135
"4946","chr12",111465768,111465792,25,55,8,88
"4947","chr12",111545563,111545585,23,52,39,114
"4948","chr12",111586389,111586412,24,85,75,184
"4949","chr12",111598950,111599019,70,9,9,88
"4950","chr12",111600936,111600962,27,93,9,129
"4951","chr12",111678250,111678269,20,40,45,105
"4952","chr12",111697585,111697602,18,76,18,112
"4953","chr12",111802412,111802431,20,145,74,239
"4954","chr12",111842282,111842305,24,51,73,148
"4955","chr12",111859628,111859664,37,5,81,123
"4956","chr12",111894038,111894058,21,6,123,150
"4957","chr12",111942247,111942286,40,72,136,248
"4958","chr12",111968993,111969037,45,12,6,63
"4959","chr12",112045487,112045508,22,8,12,42
"4960","chr12",112104835,112104869,35,145,75,255
"4961","chr12",112128016,112128038,23,22,3,48
"4962","chr12",112187623,112187644,22,8,60,90
"4963","chr12",112294946,112294963,18,35,116,169
"4964","chr12",112313482,112313505,24,8,143,175
"4965","chr12",112331065,112331090,26,78,88,192
"4966","chr12",112355288,112355308,21,74,131,226
"4967","chr12",112381474,112381492,19,16,143,178
"4968","chr12",112382088,112382118,31,98,84,213
"4969","chr12",112382328,112382360,33,4,128,165
"4970","chr12",112399255,112399321,67,61,5,133
"4971","chr12",112401515,112401561,47,14,1,62
"4972","chr12",112410002,112410024,23,146,15,184
"4973","chr12",112413585,112413613,29,17,27,73
"4974","chr12",112440564,112440591,28,76,117,221
"4975","chr12",112440950,112440981,32,7,65,104
"4976","chr12",112455233,112455253,21,76,32,129
"4977","chr12",112480367,112480384,18,76,99,193
"4978","chr12",113056911,113056931,21,105,20,146
"4979","chr12",113079695,113079737,43,34,143,220
"4980","chr12",113205903,113205924,22,137,60,219
"4981","chr12",113245601,113245631,31,7,6,44
"4982","chr12",113282088,113282108,21,76,143,240
"4983","chr12",113339469,113339492,24,81,4,109
"4984","chr12",113358372,113358392,21,22,69,112
"4985","chr12",113358645,113358683,39,100,5,144
"4986","chr12",113386171,113386190,20,60,25,105
"4987","chr12",113386186,113386203,18,6,10,34
"4988","chr12",113476943,113477164,222,14,53,289
"4989","chr12",113479867,113479890,24,109,113,246
"4990","chr12",113787893,113788358,466,38,70,574
"4991","chr12",113799245,113799264,20,76,85,181
"4992","chr12",114207631,114207675,45,126,68,239
"4993","chr12",114403266,114403303,38,1,46,85
"4994","chr12",114474468,114474490,23,8,143,174
"4995","chr12",114480236,114480256,21,131,134,286
"4996","chr12",114666384,114666417,34,99,69,202
"4997","chr12",114692488,114692521,34,143,83,260
"4998","chr12",114716212,114716235,24,75,14,113
"4999","chr12",114723264,114723291,28,6,26,60
"5000","chr12",114737042,114737081,40,109,28,177
"5001","chr12",114787080,114787113,34,133,75,242
"5002","chr12",114932863,114932890,28,123,7,158
"5003","chr12",114988020,114988038,19,8,75,102
"5004","chr12",115091909,115091932,24,122,141,287
"5005","chr12",115157738,115157770,33,39,7,79
"5006","chr12",115217131,115217152,22,89,3,114
"5007","chr12",115482020,115482041,22,80,26,128
"5008","chr12",115837900,115837941,42,146,64,252
"5009","chr12",115942693,115942745,53,142,32,227
"5010","chr12",116250610,116250627,18,145,25,188
"5011","chr12",116277398,116277433,36,87,4,127
"5012","chr12",116277801,116277818,18,1,18,37
"5013","chr12",116277869,116277895,27,18,35,80
"5014","chr12",116292345,116292383,39,24,48,111
"5015","chr12",116341811,116341831,21,21,145,187
"5016","chr12",116369575,116369598,24,12,8,44
"5017","chr12",116404890,116404931,42,65,75,182
"5018","chr12",116411298,116411324,27,6,84,117
"5019","chr12",116435198,116435225,28,76,108,212
"5020","chr12",116451958,116451978,21,69,7,97
"5021","chr12",116580243,116580266,24,106,7,137
"5022","chr12",116695636,116695666,31,42,92,165
"5023","chr12",116698164,116698183,20,36,41,97
"5024","chr12",116923703,116923720,18,108,63,189
"5025","chr12",116923718,116923737,20,7,48,75
"5026","chr12",117009067,117009085,19,60,74,153
"5027","chr12",117035735,117035761,27,78,76,181
"5028","chr12",117100239,117100264,26,91,44,161
"5029","chr12",117137301,117137323,23,60,120,203
"5030","chr12",117204487,117204507,21,75,25,121
"5031","chr12",117470063,117470130,68,52,37,157
"5032","chr12",117767785,117767806,22,64,74,160
"5033","chr12",117935760,117935781,22,27,7,56
"5034","chr12",118118314,118118342,29,75,92,196
"5035","chr12",118135502,118135521,20,128,6,154
"5036","chr12",118253736,118253770,35,45,75,155
"5037","chr12",118452850,118452869,20,59,74,153
"5038","chr12",118474810,118474838,29,62,3,94
"5039","chr12",118529591,118529608,18,36,6,60
"5040","chr12",118604635,118604657,23,69,1,93
"5041","chr12",119156612,119156652,41,49,37,127
"5042","chr12",119345983,119346004,22,122,77,221
"5043","chr12",119548609,119548630,22,120,74,216
"5044","chr12",119628493,119628517,25,8,113,146
"5045","chr12",119669117,119669144,28,36,6,70
"5046","chr12",119687795,119687845,51,87,35,173
"5047","chr12",119777670,119777696,27,112,74,213
"5048","chr12",119845653,119845670,18,15,6,39
"5049","chr12",119865865,119865883,19,38,79,136
"5050","chr12",119875978,119876001,24,51,16,91
"5051","chr12",119981066,119981085,20,12,127,159
"5052","chr12",119989455,119989489,35,132,40,207
"5053","chr12",120019045,120019066,22,64,6,92
"5054","chr12",120051928,120051956,29,73,75,177
"5055","chr12",120166402,120166422,21,141,76,238
"5056","chr12",120246855,120246877,23,144,74,241
"5057","chr12",120265750,120265784,35,51,33,119
"5058","chr12",120268937,120268991,55,118,4,177
"5059","chr12",120275319,120275345,27,69,64,160
"5060","chr12",120279941,120279964,24,2,6,32
"5061","chr12",120285624,120285642,19,145,58,222
"5062","chr12",120290465,120290488,24,29,75,128
"5063","chr12",120298909,120298945,37,9,4,50
"5064","chr12",120301360,120301382,23,12,59,94
"5065","chr12",120309715,120309733,19,8,7,34
"5066","chr12",120313944,120313971,28,9,146,183
"5067","chr12",120326579,120326625,47,84,6,137
"5068","chr12",120369121,120369147,27,19,22,68
"5069","chr12",120392889,120392916,28,113,75,216
"5070","chr12",120410662,120410680,19,7,91,117
"5071","chr12",120487273,120487310,38,4,12,54
"5072","chr12",120496742,120496760,19,7,51,77
"5073","chr12",120549786,120549819,34,16,5,55
"5074","chr12",120559382,120559403,22,101,110,233
"5075","chr12",120591572,120591595,24,50,74,148
"5076","chr12",120640535,120640567,33,56,26,115
"5077","chr12",120640798,120640821,24,6,7,37
"5078","chr12",120640904,120640927,24,22,13,59
"5079","chr12",120647561,120647585,25,76,98,199
"5080","chr12",120681091,120681118,28,146,74,248
"5081","chr12",120687345,120687363,19,92,36,147
"5082","chr12",120696349,120696380,32,108,11,151
"5083","chr12",120710357,120710392,36,18,144,198
"5084","chr12",120904361,120904378,18,83,56,157
"5085","chr12",120912536,120912557,22,113,62,197
"5086","chr12",120931774,120931795,22,76,75,173
"5087","chr12",120933023,120933041,19,67,5,91
"5088","chr12",120953121,120953141,21,139,34,194
"5089","chr12",121041885,121041902,18,58,20,96
"5090","chr12",121242736,121242760,25,8,11,44
"5091","chr12",121281518,121281539,22,21,56,99
"5092","chr12",121296681,121296699,19,43,11,73
"5093","chr12",121309147,121309168,22,147,76,245
"5094","chr12",121396967,121396992,26,6,72,104
"5095","chr12",121439381,121439399,19,9,19,47
"5096","chr12",121466514,121466537,24,17,15,56
"5097","chr12",121467301,121467329,29,19,13,61
"5098","chr12",121486334,121486360,27,3,17,47
"5099","chr12",121537915,121537933,19,32,24,75
"5100","chr12",121539327,121539355,29,96,125,250
"5101","chr12",121554034,121554085,52,124,30,206
"5102","chr12",121566622,121566644,23,130,123,276
"5103","chr12",121595218,121595255,38,8,76,122
"5104","chr12",121596948,121596990,43,8,64,115
"5105","chr12",121609253,121609274,22,6,68,96
"5106","chr12",121614299,121614318,20,59,6,85
"5107","chr12",121617346,121617370,25,91,66,182
"5108","chr12",121618074,121618101,28,59,80,167
"5109","chr12",121636687,121636704,18,77,12,107
"5110","chr12",121658566,121658587,22,6,6,34
"5111","chr12",121659517,121659543,27,67,22,116
"5112","chr12",121672749,121672784,36,74,35,145
"5113","chr12",121698417,121698434,18,50,24,92
"5114","chr12",121699909,121699930,22,66,7,95
"5115","chr12",121712716,121712742,27,25,82,134
"5116","chr12",121714249,121714275,27,10,95,132
"5117","chr12",121714558,121714580,23,77,8,108
"5118","chr12",121716552,121716580,29,8,62,99
"5119","chr12",121726036,121726059,24,70,7,101
"5120","chr12",121739799,121739821,23,33,122,178
"5121","chr12",121757338,121757356,19,5,134,158
"5122","chr12",121803928,121803978,51,17,39,107
"5123","chr12",121804066,121804103,38,30,147,215
"5124","chr12",121804311,121804334,24,31,3,58
"5125","chr12",121828092,121828123,32,123,54,209
"5126","chr12",121851886,121851904,19,37,66,122
"5127","chr12",121855973,121855994,22,34,3,59
"5128","chr12",121924427,121924448,22,74,133,229
"5129","chr12",121977962,121978004,43,41,3,87
"5130","chr12",122021917,122021972,56,38,16,110
"5131","chr12",122043400,122043419,20,77,106,203
"5132","chr12",122046061,122046083,23,91,35,149
"5133","chr12",122078766,122078783,18,35,94,147
"5134","chr12",122084915,122084944,30,40,78,148
"5135","chr12",122113985,122114002,18,5,145,168
"5136","chr12",122116054,122116088,35,81,71,187
"5137","chr12",122183159,122183182,24,22,36,82
"5138","chr12",122197973,122197996,24,6,16,46
"5139","chr12",122293788,122293822,35,44,135,214
"5140","chr12",122294329,122294355,27,22,6,55
"5141","chr12",122389759,122389783,25,54,6,85
"5142","chr12",122422716,122422746,31,13,33,77
"5143","chr12",122463434,122463471,38,91,3,132
"5144","chr12",122500541,122500563,23,105,103,231
"5145","chr12",122593249,122593282,34,9,114,157
"5146","chr12",122652833,122652850,18,84,75,177
"5147","chr12",122710321,122710347,27,61,16,104
"5148","chr12",122743945,122743965,21,35,76,132
"5149","chr12",122752389,122752410,22,96,108,226
"5150","chr12",122775094,122775116,23,55,6,84
"5151","chr12",122786142,122786166,25,9,96,130
"5152","chr12",122820841,122820859,19,42,9,70
"5153","chr12",122835643,122835692,50,1,31,82
"5154","chr12",122907899,122907921,23,36,7,66
"5155","chr12",122908110,122908132,23,69,76,168
"5156","chr12",122973571,122973615,45,49,67,161
"5157","chr12",122973862,122973891,30,73,5,108
"5158","chr12",122981665,122981701,37,29,100,166
"5159","chr12",122981746,122981782,37,110,19,166
"5160","chr12",123032478,123032508,31,41,42,114
"5161","chr12",123052078,123052098,21,132,99,252
"5162","chr12",123151160,123151183,24,16,3,43
"5163","chr12",123240210,123240227,18,80,25,123
"5164","chr12",123271666,123271684,19,9,48,76
"5165","chr12",123280780,123280801,22,77,23,122
"5166","chr12",123362436,123362468,33,96,6,135
"5167","chr12",123367336,123367376,41,34,9,84
"5168","chr12",123378074,123378093,20,63,52,135
"5169","chr12",123383300,123383320,21,47,114,182
"5170","chr12",123388743,123388770,28,39,48,115
"5171","chr12",123389464,123389486,23,11,40,74
"5172","chr12",123416324,123416346,23,136,74,233
"5173","chr12",123485307,123485324,18,31,139,188
"5174","chr12",123493785,123493802,18,76,44,138
"5175","chr12",123526308,123526350,43,18,4,65
"5176","chr12",123533618,123533666,49,114,84,247
"5177","chr12",123533721,123533755,35,29,107,171
"5178","chr12",123601513,123601546,34,21,7,62
"5179","chr12",123603784,123603809,26,65,50,141
"5180","chr12",123632271,123632299,29,73,3,105
"5181","chr12",123647153,123647172,20,132,6,158
"5182","chr12",123666688,123666708,21,77,75,173
"5183","chr12",123973111,123973147,37,72,104,213
"5184","chr12",124052647,124052678,32,8,113,153
"5185","chr12",124217386,124217404,19,34,7,60
"5186","chr12",124295522,124295542,21,79,20,120
"5187","chr12",124296071,124296207,137,116,91,344
"5188","chr12",124327729,124327751,23,26,96,145
"5189","chr12",124338506,124338524,19,145,8,172
"5190","chr12",124361123,124361142,20,87,74,181
"5191","chr12",124388866,124388911,46,75,6,127
"5192","chr12",124402439,124402480,42,58,66,166
"5193","chr12",124402513,124402564,52,11,9,72
"5194","chr12",124428045,124428088,44,82,20,146
"5195","chr12",124536087,124536110,24,24,86,134
"5196","chr12",124564521,124564542,22,23,29,74
"5197","chr12",124567497,124567542,46,25,12,83
"5198","chr12",124567591,124567638,48,59,20,127
"5199","chr12",124615825,124615853,29,37,5,71
"5200","chr12",124766356,124766388,33,76,139,248
"5201","chr12",124845538,124845555,18,145,28,191
"5202","chr12",124878440,124878458,19,11,6,36
"5203","chr12",124879562,124879579,18,78,29,125
"5204","chr12",124934731,124934773,43,5,106,154
"5205","chr12",124948749,124948772,24,46,6,76
"5206","chr12",124980724,124980750,27,87,21,135
"5207","chr12",124993836,124993864,29,3,37,69
"5208","chr12",124998125,124998142,18,28,73,119
"5209","chr12",125066451,125066468,18,77,65,160
"5210","chr12",125077075,125077095,21,35,7,63
"5211","chr12",125078821,125078845,25,100,74,199
"5212","chr12",125080671,125080708,38,75,22,135
"5213","chr12",125186315,125186362,48,55,9,112
"5214","chr12",125186369,125186402,34,11,33,78
"5215","chr12",125186432,125186453,22,62,12,96
"5216","chr12",125186490,125186508,19,10,26,55
"5217","chr12",125589482,125589506,25,136,6,167
"5218","chr12",125691478,125691497,20,146,50,216
"5219","chr12",125806169,125806199,31,8,131,170
"5220","chr12",125967345,125967364,20,140,35,195
"5221","chr12",126248724,126248751,28,65,140,233
"5222","chr12",126501663,126501694,32,49,74,155
"5223","chr12",127056381,127056398,18,76,145,239
"5224","chr12",127089061,127089108,48,7,6,61
"5225","chr12",127472322,127472355,34,75,40,149
"5226","chr12",127739757,127739789,33,81,124,238
"5227","chr12",128095739,128095760,22,18,75,115
"5228","chr12",128267085,128267136,52,35,25,112
"5229","chr12",128288056,128288073,18,73,57,148
"5230","chr12",128327362,128327401,40,9,136,185
"5231","chr12",128532641,128532667,27,11,4,42
"5232","chr12",128681818,128681841,24,27,78,129
"5233","chr12",128783122,128783148,27,135,74,236
"5234","chr12",128788833,128788853,21,148,119,288
"5235","chr12",128823360,128823377,18,49,15,82
"5236","chr12",128823864,128823898,35,25,132,192
"5237","chr12",128825522,128825549,28,65,120,213
"5238","chr12",128831469,128831486,18,5,39,62
"5239","chr12",128908318,128908537,220,17,40,277
"5240","chr12",128924427,128924453,27,55,73,155
"5241","chr12",128924460,128924478,19,80,40,139
"5242","chr12",128939400,128939417,18,125,33,176
"5243","chr12",128946636,128946666,31,76,21,128
"5244","chr12",129295428,129295447,20,75,22,117
"5245","chr12",129343748,129343783,36,141,35,212
"5246","chr12",129410350,129410376,27,75,63,165
"5247","chr12",129420307,129420330,24,58,46,128
"5248","chr12",129490597,129490626,30,29,74,133
"5249","chr12",129513805,129513851,47,72,125,244
"5250","chr12",129524913,129524944,32,77,16,125
"5251","chr12",129832036,129832061,26,97,76,199
"5252","chr12",129842098,129842121,24,29,143,196
"5253","chr12",129999147,129999173,27,8,106,141
"5254","chr12",130014114,130014138,25,48,66,139
"5255","chr12",130056115,130056139,25,8,28,61
"5256","chr12",130144273,130144293,21,21,6,48
"5257","chr12",130409333,130409360,28,8,38,74
"5258","chr12",130461340,130461357,18,76,78,172
"5259","chr12",130595550,130595592,43,19,14,76
"5260","chr12",130601336,130601360,25,144,52,221
"5261","chr12",130642267,130642302,36,76,135,247
"5262","chr12",130825042,130825059,18,126,9,153
"5263","chr12",130878968,130879007,40,82,58,180
"5264","chr12",130897373,130897407,35,142,29,206
"5265","chr12",130954942,130954990,49,89,48,186
"5266","chr12",131163415,131163442,28,20,87,135
"5267","chr12",131231753,131231948,196,80,119,395
"5268","chr12",131247231,131247260,30,79,34,143
"5269","chr12",131279161,131279186,26,1,75,102
"5270","chr12",131285333,131285471,139,35,35,209
"5271","chr12",131350741,131350764,24,49,74,147
"5272","chr12",131680998,131681231,234,55,82,371
"5273","chr12",131828554,131828587,34,9,24,67
"5274","chr12",131855329,131855362,34,86,19,139
"5275","chr12",131858957,131858974,18,76,15,109
"5276","chr12",131881137,131881167,31,6,126,163
"5277","chr12",131886752,131886774,23,69,6,98
"5278","chr12",131894710,131894736,27,3,3,33
"5279","chr12",131894882,131894931,50,72,7,129
"5280","chr12",131928357,131928375,19,14,141,174
"5281","chr12",131928661,131928683,23,55,1,79
"5282","chr12",131931549,131931570,22,30,55,107
"5283","chr12",132021221,132021247,27,138,95,260
"5284","chr12",132084174,132084199,26,13,39,78
"5285","chr12",132119541,132119573,33,74,10,117
"5286","chr12",132125431,132125462,32,7,122,161
"5287","chr12",132387442,132387461,20,69,80,169
"5288","chr12",132446970,132446995,26,143,71,240
"5289","chr12",132460029,132460063,35,76,97,208
"5290","chr12",132490059,132490093,35,34,1,70
"5291","chr12",132559920,132559961,42,16,37,95
"5292","chr12",132571414,132571463,50,91,121,262
"5293","chr12",132599260,132599311,52,23,6,81
"5294","chr12",132599344,132599364,21,76,122,219
"5295","chr12",132606198,132606231,34,137,38,209
"5296","chr12",132618654,132618689,36,135,27,198
"5297","chr12",132619071,132619305,235,38,10,283
"5298","chr12",132696808,132696825,18,77,66,161
"5299","chr12",132709396,132709413,18,29,79,126
"5300","chr12",132720650,132720672,23,114,101,238
"5301","chr12",132803059,132803093,35,47,2,84
"5302","chr12",132821608,132821625,18,66,114,198
"5303","chr12",132870351,132870381,31,77,75,183
"5304","chr12",132904418,132904440,23,7,53,83
"5305","chr12",132907851,132907883,33,29,144,206
"5306","chr12",132935893,132935911,19,145,6,170
"5307","chr12",133128636,133128654,19,88,4,111
"5308","chr12",133223446,133223463,18,76,20,114
"5309","chr13",18259636,18259659,24,85,30,139
"5310","chr13",18297590,18297623,34,12,60,106
"5311","chr13",18329567,18329585,19,127,1,147
"5312","chr13",18609545,18609562,18,111,23,152
"5313","chr13",18680612,18680634,23,114,31,168
"5314","chr13",19175253,19175281,29,125,5,159
"5315","chr13",19182652,19182678,27,61,21,109
"5316","chr13",19365213,19365242,30,9,6,45
"5317","chr13",19565208,19565227,20,8,56,84
"5318","chr13",19812909,19812939,31,8,75,114
"5319","chr13",19820425,19820454,30,122,146,298
"5320","chr13",19830834,19830857,24,8,122,154
"5321","chr13",19844138,19844158,21,75,74,170
"5322","chr13",19847804,19847827,24,30,75,129
"5323","chr13",19886143,19886181,39,7,36,82
"5324","chr13",19954127,19954147,21,77,52,150
"5325","chr13",19958915,19958940,26,99,33,158
"5326","chr13",19985878,19985900,23,145,4,172
"5327","chr13",20057270,20057307,38,25,143,206
"5328","chr13",20127250,20127300,51,17,68,136
"5329","chr13",20137354,20137381,28,49,143,220
"5330","chr13",20218536,20218666,131,66,90,287
"5331","chr13",20235439,20235461,23,9,34,66
"5332","chr13",20366871,20366912,42,23,72,137
"5333","chr13",20564100,20564117,18,13,74,105
"5334","chr13",20569864,20569893,30,143,36,209
"5335","chr13",20910514,20910550,37,133,3,173
"5336","chr13",20950033,20950083,51,9,83,143
"5337","chr13",20988344,20988372,29,1,54,84
"5338","chr13",21023647,21023683,37,139,37,213
"5339","chr13",21081859,21081903,45,8,12,65
"5340","chr13",21105417,21105439,23,137,6,166
"5341","chr13",21109913,21109940,28,8,142,178
"5342","chr13",21110224,21110246,23,8,9,40
"5343","chr13",21124466,21124493,28,145,39,212
"5344","chr13",21125777,21125796,20,76,144,240
"5345","chr13",21192849,21192878,30,74,114,218
"5346","chr13",21395487,21395513,27,70,24,121
"5347","chr13",21477019,21477051,33,30,142,205
"5348","chr13",21484854,21485008,155,69,42,266
"5349","chr13",21577805,21577828,24,31,74,129
"5350","chr13",21763796,21763820,25,78,75,178
"5351","chr13",21792173,21792208,36,20,127,183
"5352","chr13",22479282,22479303,22,5,37,64
"5353","chr13",22610868,22610892,25,63,4,92
"5354","chr13",22844804,22844857,54,32,66,152
"5355","chr13",22890075,22890116,42,76,111,229
"5356","chr13",22926403,22926439,37,99,109,245
"5357","chr13",23058345,23058375,31,58,3,92
"5358","chr13",23139308,23139331,24,7,11,42
"5359","chr13",23322772,23322789,18,35,11,64
"5360","chr13",23582225,23582251,27,77,27,131
"5361","chr13",23707160,23707177,18,7,56,81
"5362","chr13",23898662,23898681,20,25,143,188
"5363","chr13",24228109,24228131,23,8,38,69
"5364","chr13",24637589,24637634,46,20,77,143
"5365","chr13",24680638,24680660,23,6,70,99
"5366","chr13",24763370,24763390,21,30,143,194
"5367","chr13",24871959,24871984,26,74,32,132
"5368","chr13",24923998,24924015,18,38,73,129
"5369","chr13",25004147,25004175,29,146,26,201
"5370","chr13",25016727,25016754,28,140,16,184
"5371","chr13",25140876,25140895,20,39,7,66
"5372","chr13",25301915,25301933,19,34,35,88
"5373","chr13",25357810,25357831,22,76,60,158
"5374","chr13",25386996,25387024,29,34,7,70
"5375","chr13",25414187,25414208,22,76,53,151
"5376","chr13",25519519,25519537,19,137,91,247
"5377","chr13",25731243,25731264,22,103,96,221
"5378","chr13",25731277,25731307,31,146,62,239
"5379","chr13",26130439,26130459,21,28,142,191
"5380","chr13",26254181,26254201,21,28,18,67
"5381","chr13",26369527,26369548,22,10,45,77
"5382","chr13",26369696,26369729,34,25,143,202
"5383","chr13",26760443,26760461,19,3,62,84
"5384","chr13",27171447,27171488,42,72,7,121
"5385","chr13",27193622,27193644,23,69,62,154
"5386","chr13",27272289,27272312,24,35,137,196
"5387","chr13",27451102,27451121,20,132,40,192
"5388","chr13",27476510,27476542,33,12,11,56
"5389","chr13",27503332,27503349,18,103,74,195
"5390","chr13",27620497,27620520,24,47,46,117
"5391","chr13",27920254,27920280,27,2,3,32
"5392","chr13",28084974,28084993,20,77,7,104
"5393","chr13",28111069,28111089,21,5,67,93
"5394","chr13",28113929,28113965,37,11,6,54
"5395","chr13",28124542,28124565,24,77,27,128
"5396","chr13",28124715,28124733,19,101,6,126
"5397","chr13",28124750,28124772,23,140,39,202
"5398","chr13",28493520,28493538,19,120,24,163
"5399","chr13",28531237,28531268,32,74,131,237
"5400","chr13",28796645,28796663,19,76,137,232
"5401","chr13",29495182,29495206,25,75,77,177
"5402","chr13",29595507,29595529,23,16,13,52
"5403","chr13",29740204,29740233,30,40,6,76
"5404","chr13",29849785,29849803,19,38,56,113
"5405","chr13",30099288,30099326,39,8,23,70
"5406","chr13",30330143,30330166,24,35,74,133
"5407","chr13",30422319,30422369,51,7,13,71
"5408","chr13",30464762,30464788,27,30,52,109
"5409","chr13",30465184,30465210,27,29,102,158
"5410","chr13",30466125,30466144,20,69,72,161
"5411","chr13",30471655,30471685,31,75,145,251
"5412","chr13",30475526,30475543,18,70,132,220
"5413","chr13",30614874,30614891,18,37,65,120
"5414","chr13",30626314,30626349,36,73,6,115
"5415","chr13",30679279,30679307,29,108,82,219
"5416","chr13",31003585,31003605,21,35,75,131
"5417","chr13",31013317,31013353,37,7,142,186
"5418","chr13",31206585,31206603,19,43,27,89
"5419","chr13",31846770,31846803,34,37,91,162
"5420","chr13",32130055,32130073,19,23,95,137
"5421","chr13",32355709,32355733,25,80,24,129
"5422","chr13",32427753,32427779,27,1,20,48
"5423","chr13",32434244,32434270,27,28,75,130
"5424","chr13",32441691,32441737,47,123,67,237
"5425","chr13",32441889,32441929,41,80,26,147
"5426","chr13",32586991,32587015,25,45,3,73
"5427","chr13",33016452,33016485,34,92,2,128
"5428","chr13",33325984,33326006,23,109,7,139
"5429","chr13",33622615,33622639,25,14,98,137
"5430","chr13",33691835,33691853,19,99,4,122
"5431","chr13",34500218,34500532,315,90,21,426
"5432","chr13",34942512,34942550,39,7,46,92
"5433","chr13",35522476,35522506,31,95,66,192
"5434","chr13",35566362,35566384,23,47,73,143
"5435","chr13",36285585,36285659,75,113,39,227
"5436","chr13",36432355,36432453,99,101,41,241
"5437","chr13",36856799,36856818,20,74,136,230
"5438","chr13",36919820,36919848,29,129,62,220
"5439","chr13",36920188,36920216,29,22,13,64
"5440","chr13",37005863,37005885,23,75,7,105
"5441","chr13",37057974,37057993,20,22,6,48
"5442","chr13",38004831,38004855,25,74,31,130
"5443","chr13",38238861,38238891,31,5,60,96
"5444","chr13",38425781,38425799,19,38,103,160
"5445","chr13",38687431,38687451,21,20,7,48
"5446","chr13",38709987,38710037,51,143,28,222
"5447","chr13",38866496,38866519,24,146,76,246
"5448","chr13",38977751,38977777,27,76,146,249
"5449","chr13",39382383,39382423,41,24,115,180
"5450","chr13",40213188,40213207,20,75,75,170
"5451","chr13",40479235,40479253,19,24,16,59
"5452","chr13",40535223,40535240,18,12,65,95
"5453","chr13",40544963,40544989,27,138,137,302
"5454","chr13",40615529,40615577,49,123,12,184
"5455","chr13",40664808,40664835,28,16,91,135
"5456","chr13",40665920,40665943,24,7,35,66
"5457","chr13",40699230,40699248,19,98,74,191
"5458","chr13",40722234,40722276,43,41,11,95
"5459","chr13",40745231,40745269,39,7,136,182
"5460","chr13",40771810,40771833,24,114,33,171
"5461","chr13",40771839,40771863,25,144,4,173
"5462","chr13",40822852,40822874,23,8,7,38
"5463","chr13",41343696,41343721,26,36,144,206
"5464","chr13",41573487,41573593,107,34,5,146
"5465","chr13",42040758,42040775,18,1,73,92
"5466","chr13",42049152,42049202,51,112,40,203
"5467","chr13",42272052,42272073,22,35,143,200
"5468","chr13",42441087,42441117,31,140,6,177
"5469","chr13",42569548,42569589,42,20,6,68
"5470","chr13",42784662,42784684,23,145,27,195
"5471","chr13",42878033,42878051,19,100,1,120
"5472","chr13",42974337,42974366,30,138,5,173
"5473","chr13",43024338,43024361,24,8,17,49
"5474","chr13",43542432,43542450,19,42,20,81
"5475","chr13",43879741,43879847,107,32,55,194
"5476","chr13",44581532,44581557,26,74,6,106
"5477","chr13",44707123,44707145,23,5,33,61
"5478","chr13",44808974,44808998,25,76,27,128
"5479","chr13",44877660,44877697,38,3,28,69
"5480","chr13",45034954,45034974,21,8,92,121
"5481","chr13",45050640,45050669,30,64,114,208
"5482","chr13",45071595,45071618,24,22,42,88
"5483","chr13",45077865,45077885,21,112,5,138
"5484","chr13",45083551,45083584,34,128,4,166
"5485","chr13",45127939,45127979,41,9,145,195
"5486","chr13",45294066,45294100,35,73,1,109
"5487","chr13",45309965,45309984,20,8,134,162
"5488","chr13",45311326,45311358,33,26,49,108
"5489","chr13",45313078,45313112,35,36,13,84
"5490","chr13",45316252,45316360,109,48,10,167
"5491","chr13",45328356,45328377,22,8,133,163
"5492","chr13",45346657,45346682,26,9,93,128
"5493","chr13",45352923,45352954,32,76,93,201
"5494","chr13",45418941,45418984,44,80,7,131
"5495","chr13",45494839,45494878,40,91,50,181
"5496","chr13",45902368,45902390,23,5,109,137
"5497","chr13",46320206,46320232,27,77,37,141
"5498","chr13",46553149,46553171,23,136,17,176
"5499","chr13",46553474,46553504,31,40,64,135
"5500","chr13",46651867,46651906,40,22,76,138
"5501","chr13",46652054,46652095,42,9,76,127
"5502","chr13",47773903,47773925,23,139,69,231
"5503","chr13",48233115,48233135,21,13,83,117
"5504","chr13",48878978,48879000,23,100,5,128
"5505","chr13",48915163,48915180,18,78,64,160
"5506","chr13",48976583,48976615,33,97,24,154
"5507","chr13",49220201,49220218,18,59,27,104
"5508","chr13",49496109,49496131,23,54,14,91
"5509","chr13",49562777,49562806,30,105,146,281
"5510","chr13",49564584,49564609,26,13,7,46
"5511","chr13",49585658,49585678,21,35,31,87
"5512","chr13",49619285,49619306,22,72,43,137
"5513","chr13",49676597,49676631,35,139,1,175
"5514","chr13",49689866,49689883,18,1,68,87
"5515","chr13",49792539,49792562,24,23,3,50
"5516","chr13",49847225,49847242,18,135,89,242
"5517","chr13",49868101,49868122,22,106,100,228
"5518","chr13",49996872,49997003,132,27,28,187
"5519","chr13",51222287,51222314,28,10,137,175
"5520","chr13",51293918,51293942,25,22,143,190
"5521","chr13",51444253,51444284,32,35,66,133
"5522","chr13",51451721,51451752,32,142,3,177
"5523","chr13",52196672,52196710,39,24,6,69
"5524","chr13",52361783,52361806,24,8,75,107
"5525","chr13",52371151,52371177,27,69,143,239
"5526","chr13",52431763,52431782,20,109,74,203
"5527","chr13",52445940,52445968,29,147,6,182
"5528","chr13",52455636,52455675,40,141,81,262
"5529","chr13",52600454,52600479,26,47,41,114
"5530","chr13",52724418,52724441,24,78,19,121
"5531","chr13",52724593,52724621,29,19,71,119
"5532","chr13",53173075,53173096,22,5,140,167
"5533","chr13",53201091,53201132,42,8,134,184
"5534","chr13",54422877,54422894,18,77,17,112
"5535","chr13",55074388,55074409,22,117,28,167
"5536","chr13",55826352,55826372,21,30,143,194
"5537","chr13",55983064,55983084,21,30,69,120
"5538","chr13",56024167,56024187,21,77,24,122
"5539","chr13",56155062,56155095,34,107,69,210
"5540","chr13",56470984,56471007,24,81,26,131
"5541","chr13",56805334,56805354,21,60,61,142
"5542","chr13",57991465,57991495,31,76,97,204
"5543","chr13",58470931,58470952,22,77,67,166
"5544","chr13",58534542,58534563,22,145,34,201
"5545","chr13",58772735,58772759,25,11,55,91
"5546","chr13",59492639,59492670,32,75,33,140
"5547","chr13",59749210,59749234,25,143,78,246
"5548","chr13",60397258,60397284,27,4,16,47
"5549","chr13",60397601,60397618,18,2,70,90
"5550","chr13",61331311,61331338,28,13,6,47
"5551","chr13",61633001,61633023,23,135,6,164
"5552","chr13",61729952,61730002,51,61,79,191
"5553","chr13",61730168,61730200,33,25,74,132
"5554","chr13",62070763,62070798,36,9,25,70
"5555","chr13",62229637,62229672,36,5,54,95
"5556","chr13",62394077,62394103,27,76,80,183
"5557","chr13",63708064,63708337,274,74,25,373
"5558","chr13",64490730,64490751,22,76,41,139
"5559","chr13",65363752,65363779,28,69,114,211
"5560","chr13",66380537,66380561,25,8,116,149
"5561","chr13",66698896,66698917,22,30,136,188
"5562","chr13",66698916,66698933,18,9,116,143
"5563","chr13",67006228,67006246,19,41,73,133
"5564","chr13",67495717,67495745,29,145,32,206
"5565","chr13",67909413,67909451,39,105,6,150
"5566","chr13",68216896,68216918,23,37,75,135
"5567","chr13",70084623,70084648,26,30,78,134
"5568","chr13",71693470,71693491,22,29,143,194
"5569","chr13",71866407,71866431,25,32,8,65
"5570","chr13",71866471,71866551,81,52,34,167
"5571","chr13",71866567,71866585,19,86,133,238
"5572","chr13",72154433,72154464,32,77,23,132
"5573","chr13",72273917,72273937,21,134,6,161
"5574","chr13",72550841,72550921,81,64,111,256
"5575","chr13",72901024,72901056,33,21,72,126
"5576","chr13",72966912,72966932,21,55,70,146
"5577","chr13",72985372,72985393,22,81,27,130
"5578","chr13",72986677,72986701,25,69,35,129
"5579","chr13",73060158,73060179,22,107,55,184
"5580","chr13",73094186,73094210,25,80,27,132
"5581","chr13",73162345,73162391,47,148,74,269
"5582","chr13",73176340,73176366,27,43,69,139
"5583","chr13",74058354,74058374,21,9,58,88
"5584","chr13",74134159,74134180,22,55,28,105
"5585","chr13",74134523,74134549,27,131,102,260
"5586","chr13",74660145,74660165,21,77,35,133
"5587","chr13",74901271,74901290,20,95,37,152
"5588","chr13",75270733,75270784,52,5,7,64
"5589","chr13",75358867,75358889,23,34,70,127
"5590","chr13",75480868,75480906,39,4,22,65
"5591","chr13",75482432,75482450,19,110,26,155
"5592","chr13",75559031,75559057,27,76,143,246
"5593","chr13",75672241,75672258,18,75,50,143
"5594","chr13",75866449,75866467,19,8,37,64
"5595","chr13",76314871,76314902,32,93,37,162
"5596","chr13",76327915,76327950,36,87,72,195
"5597","chr13",76327948,76327970,23,107,39,169
"5598","chr13",76886255,76886302,48,45,58,151
"5599","chr13",76979696,76979718,23,77,32,132
"5600","chr13",77026724,77026747,24,29,107,160
"5601","chr13",77210194,77210218,25,16,8,49
"5602","chr13",77326612,77326629,18,100,81,199
"5603","chr13",77326779,77326803,25,82,27,134
"5604","chr13",77326920,77326951,32,5,48,85
"5605","chr13",77698099,77698125,27,112,21,160
"5606","chr13",78504584,78504613,30,25,10,65
"5607","chr13",78602144,78602215,72,31,29,132
"5608","chr13",78602248,78602281,34,97,43,174
"5609","chr13",78602349,78602377,29,87,17,133
"5610","chr13",78603164,78603190,27,112,37,176
"5611","chr13",78603459,78603484,26,20,79,125
"5612","chr13",78822974,78822993,20,70,5,95
"5613","chr13",80207148,80207169,22,117,5,144
"5614","chr13",80252416,80252436,21,5,7,33
"5615","chr13",80328658,80328679,22,77,106,205
"5616","chr13",80341017,80341050,34,127,120,281
"5617","chr13",80341176,80341213,38,98,1,137
"5618","chr13",80902589,80902631,43,42,109,194
"5619","chr13",81291014,81291043,30,7,57,94
"5620","chr13",83578177,83578202,26,147,1,174
"5621","chr13",83704709,83704736,28,40,7,75
"5622","chr13",83883207,83883238,32,17,66,115
"5623","chr13",83983884,83983916,33,7,9,49
"5624","chr13",85372608,85372629,22,77,29,128
"5625","chr13",86862951,86862986,36,69,66,171
"5626","chr13",87080887,87080916,30,85,2,117
"5627","chr13",87258301,87258325,25,34,76,135
"5628","chr13",87967851,87967880,30,29,73,132
"5629","chr13",88313310,88313334,25,77,26,128
"5630","chr13",89699870,89699890,21,77,27,125
"5631","chr13",90697929,90697981,53,70,101,224
"5632","chr13",91173915,91173944,30,38,26,94
"5633","chr13",91319885,91319939,55,108,16,179
"5634","chr13",93506877,93506911,35,80,25,140
"5635","chr13",93507062,93507090,29,147,5,181
"5636","chr13",93592361,93592428,68,36,16,120
"5637","chr13",93609382,93609406,25,74,124,223
"5638","chr13",93655004,93655023,20,30,75,125
"5639","chr13",94639947,94639974,28,78,43,149
"5640","chr13",94706069,94706110,42,39,127,208
"5641","chr13",94711553,94711590,38,37,85,160
"5642","chr13",95176225,95176245,21,9,29,59
"5643","chr13",95319696,95319747,52,121,12,185
"5644","chr13",95343783,95343802,20,110,141,271
"5645","chr13",95552655,95552680,26,1,35,62
"5646","chr13",95645959,95646013,55,98,6,159
"5647","chr13",95931542,95931565,24,6,43,73
"5648","chr13",96090816,96090835,20,89,2,111
"5649","chr13",96158653,96158675,23,101,6,130
"5650","chr13",97287919,97287953,35,35,136,206
"5651","chr13",97291237,97291257,21,74,87,182
"5652","chr13",97310783,97310802,20,99,91,210
"5653","chr13",97434101,97434125,25,10,81,116
"5654","chr13",97434438,97434463,26,69,35,130
"5655","chr13",97808867,97808895,29,34,71,134
"5656","chr13",97950095,97950116,22,137,73,232
"5657","chr13",97976280,97976312,33,97,58,188
"5658","chr13",98039856,98039882,27,106,73,206
"5659","chr13",98068995,98069016,22,69,10,101
"5660","chr13",98132679,98132701,23,76,19,118
"5661","chr13",98142940,98142980,41,1,70,112
"5662","chr13",98179860,98179883,24,25,71,120
"5663","chr13",98222795,98222816,22,32,69,123
"5664","chr13",98226932,98226950,19,68,80,167
"5665","chr13",98246088,98246114,27,9,134,170
"5666","chr13",98395574,98395608,35,26,64,125
"5667","chr13",98431462,98431479,18,8,18,44
"5668","chr13",98597710,98597745,36,75,146,257
"5669","chr13",98631279,98631299,21,76,40,137
"5670","chr13",99021639,99021658,20,9,6,35
"5671","chr13",99026077,99026099,23,111,119,253
"5672","chr13",99038289,99038320,32,6,108,146
"5673","chr13",99086365,99086382,18,33,68,119
"5674","chr13",99155262,99155290,29,132,3,164
"5675","chr13",99234172,99234200,29,3,128,160
"5676","chr13",99431925,99431958,34,78,6,118
"5677","chr13",99485908,99485925,18,27,31,76
"5678","chr13",99585124,99585187,64,67,14,145
"5679","chr13",99608062,99608086,25,4,79,108
"5680","chr13",99711404,99711426,23,10,86,119
"5681","chr13",99716377,99716407,31,82,78,191
"5682","chr13",99754088,99754115,28,135,72,235
"5683","chr13",99970408,99970449,42,16,142,200
"5684","chr13",99970579,99970612,34,123,25,182
"5685","chr13",99971158,99971189,32,9,69,110
"5686","chr13",99981792,99981848,57,16,12,85
"5687","chr13",99982754,99982782,29,149,12,190
"5688","chr13",99985449,99985494,46,11,7,64
"5689","chr13",99985551,99985607,57,124,108,289
"5690","chr13",99990304,99990323,20,89,79,188
"5691","chr13",100025493,100025531,39,4,19,62
"5692","chr13",100044319,100044342,24,77,137,238
"5693","chr13",100111012,100111030,19,77,129,225
"5694","chr13",100220427,100220445,19,113,75,207
"5695","chr13",100444432,100444460,29,76,82,187
"5696","chr13",100453851,100453880,30,13,123,166
"5697","chr13",101615791,101615816,26,35,121,182
"5698","chr13",102059853,102059885,33,54,72,159
"5699","chr13",102059872,102059902,31,71,53,155
"5700","chr13",102059900,102059928,29,97,25,151
"5701","chr13",102625165,102625182,18,8,138,164
"5702","chr13",102891681,102891707,27,125,18,170
"5703","chr13",103723441,103723472,32,113,33,178
"5704","chr13",103971144,103971182,39,78,142,259
"5705","chr13",104227513,104227530,18,34,108,160
"5706","chr13",104260329,104260351,23,59,73,155
"5707","chr13",104306118,104306139,22,77,23,122
"5708","chr13",105632033,105632053,21,77,27,125
"5709","chr13",106046189,106046228,40,77,28,145
"5710","chr13",106290817,106290976,160,24,92,276
"5711","chr13",106392520,106392546,27,32,4,63
"5712","chr13",106395478,106395495,18,76,23,117
"5713","chr13",106823827,106823851,25,37,115,177
"5714","chr13",106917697,106917724,28,53,43,124
"5715","chr13",107062757,107062775,19,8,24,51
"5716","chr13",107217534,107217582,49,62,37,148
"5717","chr13",107298352,107298380,29,7,4,40
"5718","chr13",107866168,107866186,19,145,124,288
"5719","chr13",107866300,107866385,86,136,42,264
"5720","chr13",107866711,107866802,92,8,86,186
"5721","chr13",107867119,107867170,52,65,36,153
"5722","chr13",107867128,107867197,70,92,27,189
"5723","chr13",107867305,107867336,32,88,83,203
"5724","chr13",108207176,108207199,24,77,6,107
"5725","chr13",108482170,108482209,40,77,9,126
"5726","chr13",108559447,108559492,46,9,90,145
"5727","chr13",108700333,108700350,18,43,6,67
"5728","chr13",108849178,108849206,29,74,124,227
"5729","chr13",109140995,109141018,24,13,28,65
"5730","chr13",109291199,109291253,55,76,30,161
"5731","chr13",109396861,109396884,24,61,6,91
"5732","chr13",109731398,109731416,19,89,53,161
"5733","chr13",109755215,109755241,27,70,39,136
"5734","chr13",109782231,109782253,23,3,39,65
"5735","chr13",109783950,109783974,25,46,91,162
"5736","chr13",109785970,109785994,25,60,74,159
"5737","chr13",109786502,109786536,35,139,19,193
"5738","chr13",109880192,109880221,30,128,70,228
"5739","chr13",110578803,110578820,18,75,8,101
"5740","chr13",110679534,110679568,35,69,2,106
"5741","chr13",110706171,110706195,25,31,117,173
"5742","chr13",110714959,110714977,19,23,49,91
"5743","chr13",110719020,110719054,35,19,144,198
"5744","chr13",110815382,110815400,19,26,138,183
"5745","chr13",110907080,110907099,20,8,100,128
"5746","chr13",111067226,111067263,38,33,7,78
"5747","chr13",111115115,111115137,23,63,55,141
"5748","chr13",111115435,111115454,20,90,3,113
"5749","chr13",111600392,111600430,39,26,46,111
"5750","chr13",111965048,111965070,23,7,24,54
"5751","chr13",112067743,112067788,46,2,7,55
"5752","chr13",112068122,112068145,24,59,33,116
"5753","chr13",112068246,112068269,24,112,141,277
"5754","chr13",112072699,112072725,27,13,22,62
"5755","chr13",112150590,112150665,76,3,21,100
"5756","chr13",112254803,112254831,29,146,34,209
"5757","chr13",112534548,112534568,21,22,4,47
"5758","chr13",112691484,112691507,24,28,54,106
"5759","chr13",112710965,112710985,21,116,145,282
"5760","chr13",112808022,112808039,18,9,102,129
"5761","chr13",113034526,113034611,86,9,56,151
"5762","chr13",113050713,113050780,68,106,99,273
"5763","chr13",113090802,113090819,18,41,27,86
"5764","chr13",113105201,113105226,26,56,78,160
"5765","chr13",113201816,113201834,19,40,2,61
"5766","chr13",113209507,113209526,20,1,15,36
"5767","chr13",113297465,113297493,29,18,53,100
"5768","chr13",113315383,113315407,25,76,68,169
"5769","chr13",113343322,113343340,19,105,120,244
"5770","chr13",113368261,113368278,18,69,16,103
"5771","chr13",113372088,113372126,39,3,29,71
"5772","chr13",113377500,113377521,22,120,97,239
"5773","chr13",113398880,113398911,32,61,6,99
"5774","chr13",113400126,113400147,22,60,51,133
"5775","chr13",113409889,113409908,20,121,6,147
"5776","chr13",113448466,113448491,26,11,124,161
"5777","chr13",113490616,113490639,24,6,39,69
"5778","chr13",113585152,113585181,30,1,99,130
"5779","chr13",113759536,113759586,51,7,6,64
"5780","chr13",113861696,113861716,21,112,123,256
"5781","chr13",113863852,113863870,19,27,26,72
"5782","chr13",113864030,113864058,29,26,19,74
"5783","chr13",114234994,114235013,20,1,17,38
"5784","chr13",114281900,114281927,28,35,39,102
"5785","chr13",114281903,114281933,31,2,36,69
"5786","chr13",114289114,114289131,18,35,73,126
"5787","chr13",114316148,114316176,29,3,133,165
"5788","chr14",16029397,16029480,84,3,5,92
"5789","chr14",16036064,16036093,30,15,113,158
"5790","chr14",16038573,16038648,76,106,50,232
"5791","chr14",16040739,16041509,771,55,9,835
"5792","chr14",16043289,16043329,41,122,94,257
"5793","chr14",18307338,18307361,24,84,73,181
"5794","chr14",18646065,18646082,18,52,3,73
"5795","chr14",18677047,18677074,28,135,9,172
"5796","chr14",19157605,19157635,31,37,23,91
"5797","chr14",19240670,19240697,28,43,65,136
"5798","chr14",19242375,19242394,20,25,29,74
"5799","chr14",20343039,20343065,27,21,137,185
"5800","chr14",20400138,20400162,25,133,118,276
"5801","chr14",20461391,20461420,30,42,3,75
"5802","chr14",20494365,20494390,26,84,6,116
"5803","chr14",20529127,20529145,19,10,85,114
"5804","chr14",20686040,20686059,20,121,6,147
"5805","chr14",20725951,20726002,52,29,140,221
"5806","chr14",21028242,21028270,29,77,21,127
"5807","chr14",21098324,21098381,58,17,34,109
"5808","chr14",21098421,21098489,69,36,15,120
"5809","chr14",21098669,21098692,24,41,49,114
"5810","chr14",21190002,21190028,27,81,14,122
"5811","chr14",21229086,21229105,20,10,5,35
"5812","chr14",21254061,21254079,19,128,81,228
"5813","chr14",21260200,21260217,18,145,6,169
"5814","chr14",21282606,21282627,22,8,74,104
"5815","chr14",21320596,21320616,21,7,5,33
"5816","chr14",21337754,21337778,25,81,134,240
"5817","chr14",21361312,21361334,23,8,20,51
"5818","chr14",21438513,21438546,34,141,30,205
"5819","chr14",21438529,21438552,24,147,14,185
"5820","chr14",21457629,21457663,35,33,5,73
"5821","chr14",21494750,21494769,20,77,6,103
"5822","chr14",21547784,21547806,23,42,79,144
"5823","chr14",22244617,22244640,24,8,69,101
"5824","chr14",22578176,22578197,22,1,83,106
"5825","chr14",22582208,22582232,25,3,5,33
"5826","chr14",22598350,22598372,23,71,41,135
"5827","chr14",22647809,22647834,26,76,134,236
"5828","chr14",22655986,22656018,33,6,143,182
"5829","chr14",22707083,22707109,27,9,78,114
"5830","chr14",22806896,22806915,20,8,118,146
"5831","chr14",22813790,22813807,18,75,75,168
"5832","chr14",22822776,22822798,23,90,90,203
"5833","chr14",22868225,22868246,22,141,65,228
"5834","chr14",22869458,22869480,23,12,9,44
"5835","chr14",22869767,22869795,29,49,2,80
"5836","chr14",22872318,22872335,18,16,12,46
"5837","chr14",22914324,22914343,20,146,75,241
"5838","chr14",22936993,22937024,32,64,12,108
"5839","chr14",22943502,22943522,21,137,6,164
"5840","chr14",23057662,23057684,23,66,18,107
"5841","chr14",23096509,23096534,26,16,16,58
"5842","chr14",23226739,23226762,24,25,78,127
"5843","chr14",23241715,23241733,19,79,86,184
"5844","chr14",23292586,23292608,23,57,4,84
"5845","chr14",23306619,23306639,21,16,116,153
"5846","chr14",23306802,23306847,46,9,116,171
"5847","chr14",23321472,23321492,21,55,100,176
"5848","chr14",23321656,23321681,26,13,20,59
"5849","chr14",23468075,23468099,25,77,35,137
"5850","chr14",23551653,23551726,74,42,96,212
"5851","chr14",24133581,24133598,18,77,25,120
"5852","chr14",24198003,24198020,18,8,90,116
"5853","chr14",24198307,24198331,25,13,6,44
"5854","chr14",24274907,24274927,21,73,146,240
"5855","chr14",24368637,24368654,18,3,1,22
"5856","chr14",24443018,24443044,27,55,44,126
"5857","chr14",24627426,24627449,24,111,74,209
"5858","chr14",24697811,24697845,35,10,11,56
"5859","chr14",25036215,25036241,27,3,76,106
"5860","chr14",26597201,26597252,52,35,121,208
"5861","chr14",26598362,26598385,24,112,31,167
"5862","chr14",26807061,26807088,28,77,35,140
"5863","chr14",28387167,28387192,26,41,48,115
"5864","chr14",28762022,28762056,35,123,58,216
"5865","chr14",28766883,28766914,32,55,109,196
"5866","chr14",28766917,28766936,20,77,75,172
"5867","chr14",28767024,28767052,29,54,136,219
"5868","chr14",28829667,28829717,51,9,14,74
"5869","chr14",28829879,28829906,28,37,77,142
"5870","chr14",29544447,29544471,25,8,78,111
"5871","chr14",30128669,30128692,24,30,143,197
"5872","chr14",30343906,30343928,23,126,55,204
"5873","chr14",30434627,30434656,30,30,75,135
"5874","chr14",30816479,30816498,20,7,14,41
"5875","chr14",31137122,31137146,25,6,10,41
"5876","chr14",31214049,31214068,20,9,6,35
"5877","chr14",31227202,31227220,19,95,71,185
"5878","chr14",31264801,31264826,26,6,75,107
"5879","chr14",31264978,31265001,24,29,75,128
"5880","chr14",31290366,31290387,22,16,53,91
"5881","chr14",31406978,31406996,19,136,63,218
"5882","chr14",31417398,31417432,35,74,34,143
"5883","chr14",31455551,31455569,19,46,74,139
"5884","chr14",32214853,32214886,34,74,132,240
"5885","chr14",32551643,32551676,34,7,3,44
"5886","chr14",32938453,32938524,72,22,122,216
"5887","chr14",32938835,32938882,48,64,19,131
"5888","chr14",32939115,32939141,27,27,4,58
"5889","chr14",32939139,32939173,35,59,45,139
"5890","chr14",32939411,32939434,24,17,4,45
"5891","chr14",32939624,32939676,53,85,36,174
"5892","chr14",33636904,33636927,24,68,9,101
"5893","chr14",33800393,33800421,29,1,75,105
"5894","chr14",33800597,33800630,34,44,17,95
"5895","chr14",34339522,34339561,40,69,24,133
"5896","chr14",34405836,34405865,30,25,46,101
"5897","chr14",34405846,34405868,23,28,36,87
"5898","chr14",34447226,34447250,25,69,4,98
"5899","chr14",34545554,34545606,53,66,1,120
"5900","chr14",34546159,34546315,157,3,48,208
"5901","chr14",34553635,34553660,26,12,1,39
"5902","chr14",34556788,34556944,157,50,1,208
"5903","chr14",34557497,34557555,59,3,64,126
"5904","chr14",34575197,34575215,19,73,5,97
"5905","chr14",34630043,34630069,27,46,41,114
"5906","chr14",34630186,34630209,24,115,46,185
"5907","chr14",34647923,34647942,20,63,71,154
"5908","chr14",34648690,34648711,22,73,34,129
"5909","chr14",34659353,34659381,29,147,38,214
"5910","chr14",34684217,34684257,41,5,41,87
"5911","chr14",34758116,34758134,19,35,76,130
"5912","chr14",34863153,34863181,29,8,47,84
"5913","chr14",34909176,34909197,22,37,35,94
"5914","chr14",34909895,34909917,23,7,5,35
"5915","chr14",34935881,34935907,27,142,3,172
"5916","chr14",34980204,34980227,24,51,7,82
"5917","chr14",35046224,35046248,25,50,128,203
"5918","chr14",35084182,35084200,19,74,90,183
"5919","chr14",35095675,35095698,24,143,55,222
"5920","chr14",35296320,35296348,29,8,116,153
"5921","chr14",35345755,35345778,24,17,134,175
"5922","chr14",35389600,35389627,28,30,105,163
"5923","chr14",35434416,35434433,18,28,75,121
"5924","chr14",35534562,35534584,23,4,48,75
"5925","chr14",35832350,35832369,20,145,26,191
"5926","chr14",35909073,35909097,25,6,74,105
"5927","chr14",35909141,35909166,26,7,6,39
"5928","chr14",36508375,36508400,26,95,60,181
"5929","chr14",36704657,36704704,48,100,74,222
"5930","chr14",37185211,37185252,42,75,4,121
"5931","chr14",37595134,37595166,33,105,119,257
"5932","chr14",38452418,38452469,52,98,22,172
"5933","chr14",39046476,39046494,19,118,3,140
"5934","chr14",39073604,39073627,24,76,135,235
"5935","chr14",39153695,39153718,24,72,9,105
"5936","chr14",39211233,39211251,19,68,145,232
"5937","chr14",39432565,39432614,50,142,57,249
"5938","chr14",40001201,40001237,37,104,7,148
"5939","chr14",40125393,40125427,35,77,8,120
"5940","chr14",40213397,40213425,29,64,72,165
"5941","chr14",40527658,40527683,26,8,131,165
"5942","chr14",41606868,41606890,23,38,65,126
"5943","chr14",42698612,42698634,23,76,4,103
"5944","chr14",44396998,44397023,26,73,39,138
"5945","chr14",44429767,44429804,38,34,39,111
"5946","chr14",44600789,44600839,51,3,49,103
"5947","chr14",44897472,44897494,23,14,108,145
"5948","chr14",44987005,44987040,36,88,7,131
"5949","chr14",45087741,45087760,20,29,143,192
"5950","chr14",45146059,45146082,24,68,6,98
"5951","chr14",46427643,46427665,23,5,140,168
"5952","chr14",46551340,46551363,24,145,26,195
"5953","chr14",47249317,47249334,18,121,145,284
"5954","chr14",47298678,47298702,25,8,78,111
"5955","chr14",47603616,47603634,19,10,16,45
"5956","chr14",47636785,47636814,30,69,6,105
"5957","chr14",47674798,47674826,29,71,1,101
"5958","chr14",47674990,47675007,18,118,40,176
"5959","chr14",47675958,47676013,56,4,18,78
"5960","chr14",48689155,48689194,40,141,29,210
"5961","chr14",49588877,49588902,26,69,97,192
"5962","chr14",49626800,49626823,24,8,14,46
"5963","chr14",49675437,49675458,22,85,92,199
"5964","chr14",49712950,49712967,18,8,135,161
"5965","chr14",49742673,49742691,19,141,74,234
"5966","chr14",49758135,49758162,28,77,74,179
"5967","chr14",49761213,49761230,18,17,72,107
"5968","chr14",49768004,49768027,24,4,5,33
"5969","chr14",50001325,50001361,37,50,48,135
"5970","chr14",50123381,50123398,18,75,110,203
"5971","chr14",50201533,50201551,19,53,5,77
"5972","chr14",50207901,50207933,33,66,79,178
"5973","chr14",50231680,50231699,20,52,8,80
"5974","chr14",50312364,50312383,20,118,114,252
"5975","chr14",50312620,50312642,23,24,136,183
"5976","chr14",50532573,50532593,21,64,15,100
"5977","chr14",50674904,50674931,28,71,101,200
"5978","chr14",50830712,50830739,28,28,15,71
"5979","chr14",50882374,50882394,21,8,7,36
"5980","chr14",52128245,52128268,24,103,6,133
"5981","chr14",52218999,52219030,32,11,128,171
"5982","chr14",52290362,52290397,36,86,6,128
"5983","chr14",52299272,52299289,18,4,72,94
"5984","chr14",52334993,52335012,20,40,75,135
"5985","chr14",52411737,52411754,18,26,7,51
"5986","chr14",52581196,52581213,18,109,6,133
"5987","chr14",52641446,52641464,19,145,27,191
"5988","chr14",52695949,52695981,33,74,1,108
"5989","chr14",52702760,52702797,38,8,68,114
"5990","chr14",52706034,52706058,25,9,6,40
"5991","chr14",52732267,52732284,18,3,78,99
"5992","chr14",52796232,52796249,18,74,7,99
"5993","chr14",52832521,52832568,48,56,34,138
"5994","chr14",52833839,52833866,28,136,22,186
"5995","chr14",52901106,52901131,26,77,131,234
"5996","chr14",52951249,52951310,62,5,85,152
"5997","chr14",53956886,53956921,36,80,31,147
"5998","chr14",53976247,53976287,41,36,73,150
"5999","chr14",54487540,54487562,23,144,1,168
"6000","chr14",54489119,54489154,36,63,40,139
"6001","chr14",54653302,54653353,52,72,50,174
"6002","chr14",54883372,54883398,27,147,6,180
"6003","chr14",54886612,54886636,25,64,6,95
"6004","chr14",55067065,55067085,21,37,143,201
"6005","chr14",55114173,55114190,18,77,142,237
"6006","chr14",55174677,55174706,30,6,37,73
"6007","chr14",55194403,55194422,20,7,73,100
"6008","chr14",55202593,55202641,49,37,34,120
"6009","chr14",55209123,55209180,58,77,104,239
"6010","chr14",55395354,55395373,20,7,97,124
"6011","chr14",55428120,55428147,28,8,122,158
"6012","chr14",55580190,55580207,18,15,8,41
"6013","chr14",55580254,55580280,27,12,19,58
"6014","chr14",56118610,56118647,38,37,89,164
"6015","chr14",56769466,56769488,23,40,74,137
"6016","chr14",57150236,57150273,38,29,143,210
"6017","chr14",57325384,57325402,19,88,71,178
"6018","chr14",57865990,57866014,25,40,43,108
"6019","chr14",58107764,58107785,22,25,6,53
"6020","chr14",58132582,58132604,23,77,36,136
"6021","chr14",58152155,58152181,27,75,13,115
"6022","chr14",58831535,58831552,18,38,72,128
"6023","chr14",59141291,59141327,37,31,80,148
"6024","chr14",59374970,59374996,27,102,6,135
"6025","chr14",59539902,59539920,19,125,18,162
"6026","chr14",59583216,59583238,23,21,27,71
"6027","chr14",59749091,59750710,1620,15,141,1776
"6028","chr14",60249224,60249248,25,60,25,110
"6029","chr14",60723770,60723787,18,28,63,109
"6030","chr14",60762706,60762725,20,31,42,93
"6031","chr14",61121402,61121424,23,48,143,214
"6032","chr14",61188607,61188655,49,149,53,251
"6033","chr14",61188705,61188739,35,10,102,147
"6034","chr14",61320603,61320625,23,55,2,80
"6035","chr14",61812629,61812674,46,2,96,144
"6036","chr14",61910526,61910548,23,76,23,122
"6037","chr14",62016540,62016563,24,77,25,126
"6038","chr14",62116924,62116946,23,5,62,90
"6039","chr14",63550908,63550926,19,77,27,123
"6040","chr14",63576870,63576919,50,133,70,253
"6041","chr14",63688128,63688145,18,56,71,145
"6042","chr14",63728085,63728129,45,51,24,120
"6043","chr14",63748745,63748768,24,23,42,89
"6044","chr14",63749212,63749238,27,37,66,130
"6045","chr14",63799532,63799550,19,141,35,195
"6046","chr14",63832867,63832890,24,144,33,201
"6047","chr14",63964963,63964980,18,8,6,32
"6048","chr14",64305291,64305308,18,67,6,91
"6049","chr14",64348387,64348404,18,11,40,69
"6050","chr14",64348549,64348577,29,70,145,244
"6051","chr14",64359302,64359329,28,77,143,248
"6052","chr14",64498629,64498649,21,74,127,222
"6053","chr14",64503857,64503885,29,2,35,66
"6054","chr14",64579972,64579994,23,37,4,64
"6055","chr14",64601994,64602013,20,84,40,144
"6056","chr14",64699957,64699987,31,4,11,46
"6057","chr14",64738090,64738116,27,54,133,214
"6058","chr14",64823320,64823337,18,22,33,73
"6059","chr14",64972288,64972315,28,77,23,128
"6060","chr14",64973894,64973913,20,148,18,186
"6061","chr14",65038411,65038429,19,6,5,30
"6062","chr14",65043829,65043860,32,105,67,204
"6063","chr14",65102726,65102757,32,18,54,104
"6064","chr14",65223893,65223914,22,85,44,151
"6065","chr14",65238607,65238656,50,10,61,121
"6066","chr14",65280325,65280343,19,85,15,119
"6067","chr14",65347739,65347764,26,34,127,187
"6068","chr14",65508492,65508517,26,75,23,124
"6069","chr14",66504603,66504632,30,62,74,166
"6070","chr14",67086650,67086667,18,61,7,86
"6071","chr14",67325975,67325998,24,29,144,197
"6072","chr14",67515408,67515438,31,8,108,147
"6073","chr14",67596296,67596320,25,35,75,135
"6074","chr14",67623535,67623560,26,77,25,128
"6075","chr14",67687468,67687487,20,6,93,119
"6076","chr14",68754582,68754600,19,12,37,68
"6077","chr14",68805779,68805810,32,132,22,186
"6078","chr14",68979142,68979163,22,124,3,149
"6079","chr14",68979870,68979892,23,110,147,280
"6080","chr14",68996393,68996421,29,33,5,67
"6081","chr14",69021664,69021681,18,32,75,125
"6082","chr14",69140275,69140300,26,96,66,188
"6083","chr14",69471091,69471124,34,77,11,122
"6084","chr14",69503691,69503714,24,77,6,107
"6085","chr14",69540592,69540609,18,40,141,199
"6086","chr14",69573044,69573066,23,40,13,76
"6087","chr14",69573087,69573117,31,14,39,84
"6088","chr14",69601440,69601486,47,113,74,234
"6089","chr14",69761431,69761448,18,77,35,130
"6090","chr14",69771291,69771318,28,49,78,155
"6091","chr14",69809850,69809872,23,6,25,54
"6092","chr14",69956449,69956466,18,78,100,196
"6093","chr14",70086377,70086419,43,58,66,167
"6094","chr14",70161122,70161167,46,104,138,288
"6095","chr14",70187333,70187352,20,9,19,48
"6096","chr14",70187600,70187640,41,80,44,165
"6097","chr14",70450884,70450909,26,136,48,210
"6098","chr14",70641922,70641939,18,31,48,97
"6099","chr14",70642068,70642089,22,16,119,157
"6100","chr14",70776190,70776215,26,81,73,180
"6101","chr14",70784301,70784324,24,11,56,91
"6102","chr14",70809057,70809084,28,123,129,280
"6103","chr14",70841394,70841420,27,137,75,239
"6104","chr14",70907809,70907840,32,149,62,243
"6105","chr14",71327081,71327098,18,74,76,168
"6106","chr14",71338724,71338756,33,7,4,44
"6107","chr14",71367910,71367928,19,110,141,270
"6108","chr14",71760950,71760976,27,8,120,155
"6109","chr14",71890359,71890393,35,119,85,239
"6110","chr14",72843027,72843045,19,80,120,219
"6111","chr14",72846066,72846130,65,123,6,194
"6112","chr14",72952993,72953017,25,7,12,44
"6113","chr14",73093944,73093966,23,73,8,104
"6114","chr14",73194567,73194585,19,7,62,88
"6115","chr14",73389099,73389121,23,77,74,174
"6116","chr14",73458355,73458384,30,52,48,130
"6117","chr14",73479110,73479128,19,71,71,161
"6118","chr14",73536517,73536541,25,80,13,118
"6119","chr14",73538612,73538630,19,82,7,108
"6120","chr14",73597385,73597402,18,76,144,238
"6121","chr14",73598218,73598239,22,76,27,125
"6122","chr14",73614747,73614765,19,98,74,191
"6123","chr14",73638578,73638622,45,22,6,73
"6124","chr14",73714419,73714445,27,84,137,248
"6125","chr14",73806432,73806452,21,30,6,57
"6126","chr14",73821672,73821702,31,56,43,130
"6127","chr14",73821700,73821721,22,75,15,112
"6128","chr14",73938459,73938491,33,14,74,121
"6129","chr14",73989833,73989857,25,145,74,244
"6130","chr14",74021685,74021704,20,92,72,184
"6131","chr14",74090322,74090354,33,77,73,183
"6132","chr14",74256670,74256691,22,8,138,168
"6133","chr14",74310534,74310554,21,99,79,199
"6134","chr14",74320564,74320604,41,76,9,126
"6135","chr14",74332336,74332376,41,12,128,181
"6136","chr14",74378667,74378685,19,6,53,78
"6137","chr14",74379595,74379622,28,25,6,59
"6138","chr14",74426152,74426170,19,19,124,162
"6139","chr14",74426337,74426355,19,136,115,270
"6140","chr14",74612909,74612936,28,54,133,215
"6141","chr14",74612925,74612952,28,70,117,215
"6142","chr14",74721045,74721062,18,126,76,220
"6143","chr14",74769260,74769288,29,74,58,161
"6144","chr14",74851763,74851806,44,102,114,260
"6145","chr14",74883295,74883314,20,22,6,48
"6146","chr14",74910871,74910889,19,76,90,185
"6147","chr14",75068482,75068579,98,140,64,302
"6148","chr14",75074564,75074594,31,13,48,92
"6149","chr14",75164230,75164249,20,8,78,106
"6150","chr14",75190625,75190643,19,14,73,106
"6151","chr14",75191817,75191842,26,77,77,180
"6152","chr14",75192457,75192482,26,77,77,180
"6153","chr14",75211705,75211732,28,91,67,186
"6154","chr14",75293890,75293918,29,68,7,104
"6155","chr14",75303199,75303221,23,8,136,167
"6156","chr14",75488231,75488253,23,8,2,33
"6157","chr14",75545216,75545239,24,44,91,159
"6158","chr14",75662501,75662518,18,35,66,119
"6159","chr14",75790933,75790956,24,145,35,204
"6160","chr14",75963868,75963893,26,76,138,240
"6161","chr14",76123007,76123039,33,68,6,107
"6162","chr14",76128629,76128650,22,145,27,194
"6163","chr14",76368127,76368146,20,29,136,185
"6164","chr14",76534685,76534706,22,88,73,183
"6165","chr14",76789695,76789713,19,77,56,152
"6166","chr14",76789862,76789881,20,8,75,103
"6167","chr14",76874937,76874954,18,6,42,66
"6168","chr14",76898886,76898922,37,15,131,183
"6169","chr14",76908511,76908531,21,8,22,51
"6170","chr14",76941012,76941070,59,144,31,234
"6171","chr14",76949515,76949535,21,77,131,229
"6172","chr14",76973074,76973114,41,3,120,164
"6173","chr14",76993067,76993129,63,67,10,140
"6174","chr14",77040299,77040323,25,103,48,176
"6175","chr14",77050765,77050788,24,11,22,57
"6176","chr14",77084427,77084447,21,35,22,78
"6177","chr14",77159911,77159957,47,73,58,178
"6178","chr14",77240926,77240970,45,10,44,99
"6179","chr14",77345660,77345683,24,8,123,155
"6180","chr14",77405395,77405417,23,48,74,145
"6181","chr14",77616453,77616477,25,57,6,88
"6182","chr14",77697698,77697718,21,139,24,184
"6183","chr14",77712441,77712462,22,8,143,173
"6184","chr14",77770135,77770160,26,25,72,123
"6185","chr14",77799626,77799656,31,63,73,167
"6186","chr14",77807068,77807086,19,8,92,119
"6187","chr14",77807509,77807526,18,7,4,29
"6188","chr14",78045228,78045250,23,140,72,235
"6189","chr14",78080482,78080501,20,76,88,184
"6190","chr14",79897691,79897741,51,8,6,65
"6191","chr14",80613008,80613028,21,28,75,124
"6192","chr14",81210487,81210508,22,62,51,135
"6193","chr14",81220933,81220953,21,36,40,97
"6194","chr14",81436222,81436253,32,27,48,107
"6195","chr14",81465276,81465309,34,34,144,212
"6196","chr14",81679477,81679496,20,62,31,113
"6197","chr14",81697019,81697036,18,8,63,89
"6198","chr14",82664091,82664115,25,90,88,203
"6199","chr14",82742834,82742881,48,40,36,124
"6200","chr14",82885966,82885987,22,95,6,123
"6201","chr14",83784348,83784365,18,79,25,122
"6202","chr14",85230335,85230355,21,9,46,76
"6203","chr14",85504032,85504049,18,13,74,105
"6204","chr14",85533873,85533896,24,147,51,222
"6205","chr14",85826967,85826984,18,141,71,230
"6206","chr14",86874886,86874917,32,69,27,128
"6207","chr14",88267359,88267385,27,5,17,49
"6208","chr14",88554653,88554672,20,10,41,71
"6209","chr14",88792942,88792971,30,11,74,115
"6210","chr14",89132031,89132065,35,7,63,105
"6211","chr14",89162805,89162822,18,24,78,120
"6212","chr14",89311825,89311851,27,34,7,68
"6213","chr14",89427473,89427490,18,28,143,189
"6214","chr14",89434222,89434240,19,3,12,34
"6215","chr14",89441923,89441944,22,126,142,290
"6216","chr14",89460643,89460668,26,67,30,123
"6217","chr14",89502163,89502186,24,10,79,113
"6218","chr14",89611806,89611829,24,64,6,94
"6219","chr14",89691844,89691869,26,71,37,134
"6220","chr14",89701704,89701723,20,20,70,110
"6221","chr14",89738809,89738827,19,12,83,114
"6222","chr14",89909583,89909601,19,109,71,199
"6223","chr14",90050170,90050202,33,85,106,224
"6224","chr14",90061710,90061751,42,61,117,220
"6225","chr14",90069031,90069054,24,76,41,141
"6226","chr14",90073662,90073684,23,41,79,143
"6227","chr14",90315177,90315205,29,61,6,96
"6228","chr14",90340601,90340648,48,141,4,193
"6229","chr14",90356807,90356827,21,77,143,241
"6230","chr14",90397124,90397144,21,39,54,114
"6231","chr14",90411763,90411784,22,6,54,82
"6232","chr14",90706162,90706181,20,77,86,183
"6233","chr14",90758324,90758357,34,1,52,87
"6234","chr14",90801223,90801243,21,77,76,174
"6235","chr14",90804332,90804363,32,30,9,71
"6236","chr14",91128310,91128327,18,133,35,186
"6237","chr14",91143030,91143049,20,12,7,39
"6238","chr14",91150219,91150242,24,66,25,115
"6239","chr14",91501872,91501894,23,28,143,194
"6240","chr14",91510018,91510055,38,11,21,70
"6241","chr14",91510687,91510719,33,8,106,147
"6242","chr14",91578232,91578260,29,88,15,132
"6243","chr14",91709525,91709542,18,145,131,294
"6244","chr14",91951358,91951375,18,21,77,116
"6245","chr14",91951946,91951966,21,10,23,54
"6246","chr14",91993477,91993499,23,100,73,196
"6247","chr14",92041570,92041593,24,144,142,310
"6248","chr14",92054875,92054899,25,8,4,37
"6249","chr14",92060222,92060271,50,3,51,104
"6250","chr14",92069372,92069391,20,76,116,212
"6251","chr14",92086566,92086583,18,145,122,285
"6252","chr14",92186143,92186164,22,134,74,230
"6253","chr14",92359411,92359438,28,16,36,80
"6254","chr14",92363828,92363859,32,72,76,180
"6255","chr14",92522316,92522338,23,47,124,194
"6256","chr14",92536743,92536762,20,142,73,235
"6257","chr14",92555775,92555795,21,5,128,154
"6258","chr14",92687596,92687614,19,1,71,91
"6259","chr14",92687613,92687634,22,115,54,191
"6260","chr14",92691430,92691462,33,78,4,115
"6261","chr14",92815700,92815722,23,77,90,190
"6262","chr14",92845607,92845624,18,142,34,194
"6263","chr14",93041594,93041613,20,1,93,114
"6264","chr14",93103100,93103143,44,19,6,69
"6265","chr14",93112438,93112457,20,8,73,101
"6266","chr14",93154435,93154461,27,99,31,157
"6267","chr14",93164284,93164320,37,30,78,145
"6268","chr14",93200317,93200337,21,146,123,290
"6269","chr14",93229566,93229588,23,140,76,239
"6270","chr14",93290512,93290535,24,126,101,251
"6271","chr14",93361212,93361256,45,77,8,130
"6272","chr14",93558594,93558637,44,112,37,193
"6273","chr14",93782270,93782324,55,116,4,175
"6274","chr14",93927032,93927061,30,61,25,116
"6275","chr14",94065385,94065405,21,66,112,199
"6276","chr14",94129363,94129429,67,3,37,107
"6277","chr14",94291220,94291241,22,44,4,70
"6278","chr14",94562022,94562067,46,26,114,186
"6279","chr14",94582657,94582675,19,65,43,127
"6280","chr14",94745655,94745683,29,12,7,48
"6281","chr14",94768077,94768094,18,119,48,185
"6282","chr14",94845875,94845911,37,61,135,233
"6283","chr14",95010964,95010988,25,147,133,305
"6284","chr14",95386312,95386329,18,8,46,72
"6285","chr14",95535169,95535209,41,86,6,133
"6286","chr14",95686262,95686321,60,20,15,95
"6287","chr14",95711296,95711319,24,77,35,136
"6288","chr14",95804322,95804341,20,17,76,113
"6289","chr14",95832266,95832300,35,101,117,253
"6290","chr14",96039295,96039323,29,75,101,205
"6291","chr14",96069169,96069202,34,18,81,133
"6292","chr14",96279405,96279431,27,105,93,225
"6293","chr14",96500810,96500845,36,30,106,172
"6294","chr14",96505871,96505918,48,73,131,252
"6295","chr14",97384439,97384456,18,145,25,188
"6296","chr14",97426786,97426831,46,109,76,231
"6297","chr14",97428585,97428615,31,19,121,171
"6298","chr14",97431974,97432192,219,125,24,368
"6299","chr14",97440115,97440150,36,140,124,300
"6300","chr14",98241852,98241869,18,49,50,117
"6301","chr14",98289495,98289513,19,76,116,211
"6302","chr14",98343958,98343988,31,41,92,164
"6303","chr14",99175207,99175246,40,5,48,93
"6304","chr14",99179474,99179499,26,7,6,39
"6305","chr14",99188538,99188600,63,12,51,126
"6306","chr14",99214667,99214694,28,106,125,259
"6307","chr14",99269876,99269910,35,37,54,126
"6308","chr14",99270749,99270788,40,23,12,75
"6309","chr14",99271289,99271337,49,135,85,269
"6310","chr14",99271900,99271924,25,10,115,150
"6311","chr14",99274710,99274791,82,133,58,273
"6312","chr14",99367812,99367845,34,29,73,136
"6313","chr14",99388805,99388835,31,15,72,118
"6314","chr14",99480803,99480832,30,67,113,210
"6315","chr14",99603981,99603998,18,23,72,113
"6316","chr14",99605370,99605395,26,2,11,39
"6317","chr14",99607022,99607047,26,73,49,148
"6318","chr14",99615575,99615744,170,62,43,275
"6319","chr14",99636981,99637267,287,29,12,328
"6320","chr14",99654189,99654222,34,84,42,160
"6321","chr14",99675233,99675258,26,2,145,173
"6322","chr14",99682122,99682150,29,74,28,131
"6323","chr14",99760084,99760113,30,13,29,72
"6324","chr14",99806317,99806340,24,82,73,179
"6325","chr14",99971985,99972012,28,93,57,178
"6326","chr14",100178039,100178074,36,114,60,210
"6327","chr14",100220904,100220926,23,77,27,127
"6328","chr14",100240056,100240092,37,28,26,91
"6329","chr14",100248112,100248135,24,78,143,245
"6330","chr14",100254760,100254778,19,114,55,188
"6331","chr14",100283866,100283893,28,115,129,272
"6332","chr14",100306168,100306186,19,9,4,32
"6333","chr14",100331464,100331488,25,26,64,115
"6334","chr14",100365580,100365600,21,128,6,155
"6335","chr14",100546764,100546781,18,99,74,191
"6336","chr14",100546781,100546823,43,141,57,241
"6337","chr14",100587188,100587222,35,2,33,70
"6338","chr14",100592361,100592379,19,21,78,118
"6339","chr14",100654896,100654913,18,64,3,85
"6340","chr14",100710122,100710140,19,54,6,79
"6341","chr14",100723115,100723147,33,7,146,186
"6342","chr14",100757662,100757690,29,5,74,108
"6343","chr14",100880125,100880142,18,39,64,121
"6344","chr14",100902604,100902634,31,107,129,267
"6345","chr14",101007033,101007055,23,54,74,151
"6346","chr14",101402114,101402131,18,145,55,218
"6347","chr14",101489283,101489301,19,61,1,81
"6348","chr14",101584881,101584903,23,9,140,172
"6349","chr14",101585215,101585267,53,44,107,204
"6350","chr14",101617459,101617485,27,65,84,176
"6351","chr14",101627501,101627528,28,36,71,135
"6352","chr14",101760942,101761104,163,106,17,286
"6353","chr14",101761566,101761618,53,110,25,188
"6354","chr14",101761678,101761715,38,46,50,134
"6355","chr14",101761782,101761882,101,23,23,147
"6356","chr14",101781849,101781869,21,142,4,167
"6357","chr14",101893753,101893779,27,13,3,43
"6358","chr14",101937107,101937129,23,75,75,173
"6359","chr14",101964507,101964524,18,69,71,158
"6360","chr14",102002102,102002128,27,76,88,191
"6361","chr14",102063092,102063117,26,13,4,43
"6362","chr14",102076763,102076788,26,89,6,121
"6363","chr14",102087932,102087965,34,76,56,166
"6364","chr14",102136568,102136590,23,95,75,193
"6365","chr14",102137309,102137340,32,73,108,213
"6366","chr14",102276477,102276517,41,21,18,80
"6367","chr14",102286299,102286325,27,133,6,166
"6368","chr14",102292475,102292503,29,78,4,111
"6369","chr14",102294446,102294465,20,77,74,171
"6370","chr14",102306546,102306571,26,148,10,184
"6371","chr14",102311086,102311112,27,65,141,233
"6372","chr14",102319808,102319825,18,140,81,239
"6373","chr14",102319921,102319938,18,80,11,109
"6374","chr14",102438215,102438262,48,144,75,267
"6375","chr14",102509723,102509752,30,31,7,68
"6376","chr14",102516091,102516113,23,68,74,165
"6377","chr14",102519296,102519318,23,145,73,241
"6378","chr14",102534418,102534435,18,123,7,148
"6379","chr14",102556102,102556125,24,138,21,183
"6380","chr14",102567325,102567362,38,73,123,234
"6381","chr14",102579832,102579852,21,72,95,188
"6382","chr14",102597629,102597654,26,39,10,75
"6383","chr14",102639832,102639865,34,10,59,103
"6384","chr14",102694426,102694455,30,36,141,207
"6385","chr14",102748439,102748460,22,8,135,165
"6386","chr14",102900181,102900203,23,130,72,225
"6387","chr14",102928683,102928720,38,121,68,227
"6388","chr14",102930091,102930131,41,134,34,209
"6389","chr14",102934532,102934561,30,144,8,182
"6390","chr14",103044367,103044387,21,8,143,172
"6391","chr14",103056565,103056592,28,75,131,234
"6392","chr14",103059002,103059023,22,133,57,212
"6393","chr14",103103355,103103400,46,25,6,77
"6394","chr14",103103798,103103829,32,19,110,161
"6395","chr14",103107595,103107620,26,65,62,153
"6396","chr14",103112866,103112894,29,10,82,121
"6397","chr14",103117028,103117051,24,76,25,125
"6398","chr14",103117320,103117341,22,26,142,190
"6399","chr14",103117613,103117639,27,76,3,106
"6400","chr14",103118044,103118140,97,16,142,255
"6401","chr14",103151950,103151988,39,7,101,147
"6402","chr14",103207384,103207415,32,83,113,228
"6403","chr14",103210785,103210807,23,8,136,167
"6404","chr14",103273125,103273166,42,22,28,92
"6405","chr14",103273134,103273213,80,69,19,168
"6406","chr14",103279151,103279168,18,102,12,132
"6407","chr14",103298016,103298033,18,137,6,161
"6408","chr14",103356696,103356737,42,75,134,251
"6409","chr14",103373282,103373299,18,27,14,59
"6410","chr14",103379979,103380028,50,136,15,201
"6411","chr14",103389944,103389966,23,13,6,42
"6412","chr14",103458455,103458475,21,68,10,99
"6413","chr14",103484159,103484193,35,74,70,179
"6414","chr14",103493875,103493893,19,84,74,177
"6415","chr14",103506487,103506505,19,147,108,274
"6416","chr14",103539898,103539921,24,29,25,78
"6417","chr14",103564572,103564597,26,8,53,87
"6418","chr14",103586201,103586222,22,49,10,81
"6419","chr14",103615915,103615937,23,136,67,226
"6420","chr14",103655603,103655624,22,74,139,235
"6421","chr14",103666765,103666794,30,126,75,231
"6422","chr14",103745795,103745828,34,13,91,138
"6423","chr14",103784584,103784615,32,66,74,172
"6424","chr14",103847519,103847536,18,18,11,47
"6425","chr14",103847534,103847566,33,11,36,80
"6426","chr14",103864075,103864098,24,121,75,220
"6427","chr14",103922329,103922348,20,4,43,67
"6428","chr14",103952191,103952221,31,39,3,73
"6429","chr14",104004362,104004398,37,78,61,176
"6430","chr14",104022726,104022764,39,14,7,60
"6431","chr14",104089011,104089036,26,6,141,173
"6432","chr14",104148660,104148690,31,1,31,63
"6433","chr14",104179583,104179606,24,136,77,237
"6434","chr14",104242040,104242072,33,77,35,145
"6435","chr14",104314900,104314927,28,120,63,211
"6436","chr14",104365868,104365892,25,72,60,157
"6437","chr14",104461610,104461667,58,107,60,225
"6438","chr14",104601872,104601894,23,48,88,159
"6439","chr14",104687461,104687505,45,43,42,130
"6440","chr14",104689591,104689620,30,34,34,98
"6441","chr14",104787451,104787468,18,16,28,62
"6442","chr14",104795744,104795790,47,59,26,132
"6443","chr14",104843922,104843939,18,41,27,86
"6444","chr14",104847686,104847709,24,122,71,217
"6445","chr14",104865170,104865240,71,38,82,191
"6446","chr14",104865392,104865409,18,13,2,33
"6447","chr14",104871377,104871395,19,80,112,211
"6448","chr14",104933377,104933395,19,25,11,55
"6449","chr14",104985530,104985554,25,21,6,52
"6450","chr14",104987790,104987808,19,23,138,180
"6451","chr14",105021289,105021336,48,123,48,219
"6452","chr14",105086285,105086309,25,8,11,44
"6453","chr14",105114242,105114273,32,95,72,199
"6454","chr14",105168521,105168558,38,30,18,86
"6455","chr14",105168530,105168562,33,34,9,76
"6456","chr14",105248570,105248589,20,123,20,163
"6457","chr14",105296081,105296102,22,7,4,33
"6458","chr14",105303241,105303259,19,74,133,226
"6459","chr14",105310534,105310555,22,20,70,112
"6460","chr14",105314651,105314739,89,15,23,127
"6461","chr14",105314704,105314745,42,21,1,64
"6462","chr14",105318626,105318676,51,8,134,193
"6463","chr14",105360543,105360569,27,74,7,108
"6464","chr14",105408227,105408249,23,67,134,224
"6465","chr14",105411517,105411546,30,97,14,141
"6466","chr14",105415904,105415921,18,57,5,80
"6467","chr14",105416856,105416892,37,50,7,94
"6468","chr14",105417395,105417416,22,44,55,121
"6469","chr14",105425664,105425682,19,126,62,207
"6470","chr14",105451764,105451807,44,7,69,120
"6471","chr14",105454342,105454359,18,26,82,126
"6472","chr14",105479072,105479093,22,40,22,84
"6473","chr14",105502033,105502052,20,28,33,81
"6474","chr14",105503230,105503252,23,114,17,154
"6475","chr14",105503320,105503351,32,10,50,92
"6476","chr14",105557392,105557409,18,78,78,174
"6477","chr14",105559066,105559085,20,4,33,57
"6478","chr14",105559748,105559818,71,45,100,216
"6479","chr14",105586720,105586745,26,26,56,108
"6480","chr14",105679480,105679499,20,3,33,56
"6481","chr14",105680150,105680235,86,45,97,228
"6482","chr14",105706951,105706976,26,26,56,108
"6483","chr14",105874825,105874863,39,85,69,193
"6484","chr14",106231134,106231191,58,23,127,208
"6485","chr14",106498729,106498754,26,50,67,143
"6486","chr14",106498756,106498777,22,73,40,135
"6487","chr14",106498783,106498810,28,106,13,147
"6488","chr14",106686249,106686276,28,15,3,46
"6489","chr15",20061098,20061202,105,136,76,317
"6490","chr15",20098878,20098901,24,72,17,113
"6491","chr15",20099940,20099967,28,74,22,124
"6492","chr15",20168997,20169017,21,148,29,198
"6493","chr15",20302788,20302814,27,75,12,114
"6494","chr15",20550195,20550223,29,35,76,140
"6495","chr15",20550484,20550502,19,35,5,59
"6496","chr15",20581035,20581065,31,7,52,90
"6497","chr15",20588348,20588365,18,8,67,93
"6498","chr15",20742082,20742102,21,76,5,102
"6499","chr15",20879910,20879952,43,43,74,160
"6500","chr15",21068209,21068313,105,136,76,317
"6501","chr15",21105983,21106006,24,72,17,113
"6502","chr15",21107045,21107073,29,74,22,125
"6503","chr15",21175524,21175541,18,148,29,195
"6504","chr15",21890885,21890932,48,43,74,165
"6505","chr15",22101183,22101205,23,103,116,242
"6506","chr15",22412020,22412039,20,69,6,95
"6507","chr15",22419314,22419340,27,55,5,87
"6508","chr15",22448572,22448591,20,108,1,129
"6509","chr15",22449285,22449315,31,146,32,209
"6510","chr15",22450502,22450530,29,78,33,140
"6511","chr15",22575504,22575526,23,75,60,158
"6512","chr15",22598385,22598416,32,75,140,247
"6513","chr15",22599786,22599805,20,75,120,215
"6514","chr15",22624527,22624553,27,84,74,185
"6515","chr15",22710431,22710452,22,31,75,128
"6516","chr15",22710718,22710736,19,7,4,30
"6517","chr15",22710887,22710908,22,70,60,152
"6518","chr15",22783422,22783466,45,75,74,194
"6519","chr15",22798239,22798256,18,75,25,118
"6520","chr15",22803676,22803697,22,8,137,167
"6521","chr15",22840291,22840315,25,21,73,119
"6522","chr15",22928386,22928435,50,111,71,232
"6523","chr15",22929632,22929653,22,12,74,108
"6524","chr15",22960994,22961038,45,8,68,121
"6525","chr15",23067095,23067117,23,35,60,118
"6526","chr15",23067704,23067721,18,62,86,166
"6527","chr15",23068328,23068351,24,68,77,169
"6528","chr15",23069053,23069070,18,35,75,128
"6529","chr15",23145172,23145200,29,35,76,140
"6530","chr15",23145461,23145483,23,34,5,62
"6531","chr15",23146404,23146425,22,34,144,200
"6532","chr15",23147122,23147147,26,5,106,137
"6533","chr15",23163761,23163788,28,95,119,242
"6534","chr15",23175028,23175067,40,61,29,130
"6535","chr15",23175487,23175513,27,77,36,140
"6536","chr15",23175676,23175694,19,6,61,86
"6537","chr15",23176090,23176112,23,21,71,115
"6538","chr15",23176267,23176296,30,18,76,124
"6539","chr15",23201337,23201357,21,19,121,161
"6540","chr15",23342598,23342626,29,35,76,140
"6541","chr15",23342887,23342909,23,34,5,62
"6542","chr15",23343819,23343840,22,34,144,200
"6543","chr15",23344537,23344559,23,5,106,134
"6544","chr15",23361135,23361181,47,96,119,262
"6545","chr15",23407515,23407543,29,23,24,76
"6546","chr15",23409587,23409640,54,103,6,163
"6547","chr15",23466771,23466791,21,75,143,239
"6548","chr15",23468943,23468961,19,111,7,137
"6549","chr15",23571466,23571483,18,77,23,118
"6550","chr15",23597669,23597688,20,76,38,134
"6551","chr15",23605854,23605878,25,8,68,101
"6552","chr15",23700743,23700762,20,96,4,120
"6553","chr15",23738450,23738479,30,46,74,150
"6554","chr15",23888350,23888371,22,120,78,220
"6555","chr15",23955828,23955884,57,6,39,102
"6556","chr15",23956036,23956057,22,28,106,156
"6557","chr15",24014255,24014272,18,109,143,270
"6558","chr15",24827149,24827175,27,90,135,252
"6559","chr15",24848214,24848273,60,1,4,65
"6560","chr15",24864335,24864362,28,77,2,107
"6561","chr15",24877662,24877703,42,78,34,154
"6562","chr15",24904659,24904690,32,148,70,250
"6563","chr15",24922038,24922063,26,145,32,203
"6564","chr15",24930591,24930609,19,88,108,215
"6565","chr15",24980681,24980711,31,80,10,121
"6566","chr15",25012427,25012466,40,7,133,180
"6567","chr15",25262087,25262111,25,147,91,263
"6568","chr15",25502946,25502988,43,77,61,181
"6569","chr15",25682054,25682076,23,77,74,174
"6570","chr15",25769487,25769513,27,77,6,110
"6571","chr15",25807813,25807834,22,128,142,292
"6572","chr15",25835798,25835829,32,6,76,114
"6573","chr15",26082401,26082418,18,12,5,35
"6574","chr15",26364171,26364203,33,24,6,63
"6575","chr15",26730418,26730439,22,123,6,151
"6576","chr15",26773041,26773063,23,31,24,78
"6577","chr15",26895827,26895852,26,19,60,105
"6578","chr15",26929973,26930008,36,54,77,167
"6579","chr15",26930007,26930036,30,82,43,155
"6580","chr15",26934249,26934284,36,4,77,117
"6581","chr15",26934265,26934300,36,20,61,117
"6582","chr15",26968297,26968321,25,69,101,195
"6583","chr15",27263924,27263958,35,108,45,188
"6584","chr15",27353427,27353459,33,75,103,211
"6585","chr15",27753739,27753779,41,17,72,130
"6586","chr15",27984553,27984579,27,77,37,141
"6587","chr15",28108538,28108558,21,76,27,124
"6588","chr15",28108707,28108731,25,57,7,89
"6589","chr15",28116212,28116239,28,84,4,116
"6590","chr15",28140934,28140953,20,145,32,197
"6591","chr15",28190176,28190200,25,37,75,137
"6592","chr15",28249816,28249834,19,35,73,127
"6593","chr15",28366480,28366509,30,35,76,141
"6594","chr15",28385051,28385086,36,97,121,254
"6595","chr15",28396326,28396369,44,61,29,134
"6596","chr15",28396787,28396818,32,77,36,145
"6597","chr15",28397559,28397595,37,20,8,65
"6598","chr15",28430005,28430025,21,19,121,161
"6599","chr15",28487308,28487331,24,123,17,164
"6600","chr15",28514072,28514099,28,10,18,56
"6601","chr15",28515279,28515310,32,31,59,122
"6602","chr15",28526550,28526582,33,121,95,249
"6603","chr15",28545133,28545161,29,78,33,140
"6604","chr15",28586238,28586268,31,100,5,136
"6605","chr15",28669786,28669810,25,75,60,160
"6606","chr15",28692822,28692849,28,75,140,243
"6607","chr15",28725887,28725914,28,76,3,107
"6608","chr15",28726199,28726217,19,74,146,239
"6609","chr15",28727096,28727122,27,42,66,135
"6610","chr15",28783753,28783771,19,73,26,118
"6611","chr15",28866536,28866558,23,10,7,40
"6612","chr15",28867021,28867047,27,135,7,169
"6613","chr15",28918618,28918652,35,57,40,132
"6614","chr15",28940553,28940591,39,43,64,146
"6615","chr15",28941751,28941774,24,76,86,186
"6616","chr15",29078611,29078648,38,130,74,242
"6617","chr15",29085525,29085546,22,115,74,211
"6618","chr15",29128692,29128713,22,39,2,63
"6619","chr15",29570933,29570977,45,4,31,80
"6620","chr15",29617072,29617094,23,73,31,127
"6621","chr15",29818671,29818689,19,40,76,135
"6622","chr15",29864238,29864264,27,80,23,130
"6623","chr15",29978725,29978791,67,82,132,281
"6624","chr15",30196717,30196749,33,16,6,55
"6625","chr15",30196751,30196769,19,36,38,93
"6626","chr15",30223296,30223328,33,98,9,140
"6627","chr15",30332052,30332078,27,7,28,62
"6628","chr15",30430968,30430990,23,84,74,181
"6629","chr15",30506903,30506933,31,121,72,224
"6630","chr15",30535248,30535270,23,76,82,181
"6631","chr15",30759271,30759291,21,93,6,120
"6632","chr15",30803228,30803247,20,124,73,217
"6633","chr15",30803513,30803534,22,72,33,127
"6634","chr15",30804602,30804635,34,142,73,249
"6635","chr15",30861182,30861204,23,8,129,160
"6636","chr15",30869403,30869424,22,13,15,50
"6637","chr15",30873672,30873701,30,10,76,116
"6638","chr15",30895856,30895884,29,78,34,141
"6639","chr15",31104587,31104611,25,8,83,116
"6640","chr15",31168219,31168383,165,142,9,316
"6641","chr15",31241065,31241085,21,19,7,47
"6642","chr15",31298866,31298896,31,73,105,209
"6643","chr15",31311278,31311297,20,6,95,121
"6644","chr15",31319352,31319374,23,142,11,176
"6645","chr15",31327076,31327099,24,2,22,48
"6646","chr15",31391599,31391621,23,116,69,208
"6647","chr15",31392815,31392840,26,34,69,129
"6648","chr15",31483269,31483293,25,18,76,119
"6649","chr15",31484008,31484037,30,28,35,93
"6650","chr15",32030401,32030428,28,11,54,93
"6651","chr15",32198701,32198727,27,30,5,62
"6652","chr15",32315361,32315392,32,11,96,139
"6653","chr15",32341938,32341956,19,34,34,87
"6654","chr15",32341961,32341997,37,9,11,57
"6655","chr15",32468446,32468465,20,78,4,102
"6656","chr15",32472352,32472373,22,84,74,180
"6657","chr15",32500785,32500815,31,74,119,224
"6658","chr15",32576696,32576717,22,76,82,180
"6659","chr15",32580608,32580625,18,6,76,100
"6660","chr15",33213257,33213275,19,10,71,100
"6661","chr15",33219016,33219038,23,72,6,101
"6662","chr15",33248701,33248756,56,66,132,254
"6663","chr15",33753645,33753662,18,52,48,118
"6664","chr15",33937131,33937149,19,44,6,69
"6665","chr15",34038900,34038937,38,97,30,165
"6666","chr15",34039203,34039226,24,106,59,189
"6667","chr15",34073208,34073228,21,29,75,125
"6668","chr15",34073496,34073537,42,75,4,121
"6669","chr15",34342565,34342587,23,31,5,59
"6670","chr15",34347854,34347894,41,58,5,104
"6671","chr15",34362139,34362157,19,52,5,76
"6672","chr15",34369609,34369626,18,26,76,120
"6673","chr15",34381909,34381947,39,84,13,136
"6674","chr15",34475372,34475398,27,89,75,191
"6675","chr15",34528130,34528168,39,84,13,136
"6676","chr15",34970040,34970064,25,10,59,94
"6677","chr15",34992136,34992174,39,36,68,143
"6678","chr15",35012178,35012199,22,105,5,132
"6679","chr15",36471642,36471659,18,78,27,123
"6680","chr15",36956022,36956047,26,78,27,131
"6681","chr15",37491148,37491167,20,85,14,119
"6682","chr15",38221587,38221615,29,8,48,85
"6683","chr15",38282319,38282355,37,76,77,190
"6684","chr15",38493180,38493201,22,82,144,248
"6685","chr15",39005528,39005548,21,29,75,125
"6686","chr15",39976926,39976948,23,60,2,85
"6687","chr15",40238813,40238831,19,84,4,107
"6688","chr15",40323834,40323860,27,43,25,95
"6689","chr15",40358234,40358279,46,50,32,128
"6690","chr15",40373707,40373724,18,15,71,104
"6691","chr15",40401174,40401196,23,7,54,84
"6692","chr15",40401347,40401369,23,39,76,138
"6693","chr15",40401525,40401555,31,3,106,140
"6694","chr15",40403356,40403374,19,112,23,154
"6695","chr15",40417207,40417225,19,147,94,260
"6696","chr15",40436214,40436236,23,18,22,63
"6697","chr15",40552482,40552502,21,22,5,48
"6698","chr15",40562578,40562601,24,111,8,143
"6699","chr15",40583777,40583798,22,6,3,31
"6700","chr15",40590210,40590317,108,108,85,301
"6701","chr15",40710242,40710287,46,12,74,132
"6702","chr15",40724870,40724910,41,69,119,229
"6703","chr15",40754823,40754840,18,94,44,156
"6704","chr15",40755630,40755650,21,67,8,96
"6705","chr15",40780813,40780852,40,135,120,295
"6706","chr15",40875726,40875747,22,138,7,167
"6707","chr15",41037105,41037128,24,49,72,145
"6708","chr15",41059122,41059142,21,36,140,197
"6709","chr15",41113260,41113279,20,71,72,163
"6710","chr15",41117943,41117969,27,143,60,230
"6711","chr15",41158432,41158449,18,138,65,221
"6712","chr15",41172626,41172665,40,74,112,226
"6713","chr15",41211067,41211090,24,5,67,96
"6714","chr15",41312628,41312647,20,9,142,171
"6715","chr15",41375175,41375195,21,76,77,174
"6716","chr15",41393292,41393316,25,23,143,191
"6717","chr15",41409023,41409061,39,7,96,142
"6718","chr15",41414919,41414945,27,8,142,177
"6719","chr15",41416066,41416087,22,36,42,100
"6720","chr15",41436457,41436475,19,78,25,122
"6721","chr15",41496357,41496387,31,67,5,103
"6722","chr15",41511683,41511713,31,46,6,83
"6723","chr15",41544448,41544468,21,76,24,121
"6724","chr15",41795596,41795622,27,6,50,83
"6725","chr15",41844823,41844841,19,14,106,139
"6726","chr15",41883959,41884003,45,121,74,240
"6727","chr15",42269943,42269965,23,25,119,167
"6728","chr15",42493333,42493355,23,14,15,52
"6729","chr15",42875906,42875927,22,41,74,137
"6730","chr15",42891173,42891194,22,125,6,153
"6731","chr15",42920634,42920651,18,126,10,154
"6732","chr15",42978893,42978912,20,76,146,242
"6733","chr15",43037350,43037390,41,4,4,49
"6734","chr15",43113413,43113453,41,14,12,67
"6735","chr15",43370976,43371006,31,41,25,97
"6736","chr15",43639411,43639437,27,28,76,131
"6737","chr15",43735931,43735949,19,28,144,191
"6738","chr15",43745751,43745774,24,110,4,138
"6739","chr15",43841189,43841220,32,14,74,120
"6740","chr15",44108961,44109020,60,104,6,170
"6741","chr15",44285194,44285231,38,127,3,168
"6742","chr15",44314237,44314264,28,135,6,169
"6743","chr15",44375005,44375033,29,3,125,157
"6744","chr15",44378355,44378373,19,6,4,29
"6745","chr15",44537197,44537219,23,94,58,175
"6746","chr15",44537403,44537422,20,65,12,97
"6747","chr15",44539727,44539750,24,48,118,190
"6748","chr15",44552547,44552579,33,76,56,165
"6749","chr15",44567350,44567367,18,26,7,51
"6750","chr15",44679530,44679572,43,36,8,87
"6751","chr15",44749043,44749066,24,148,120,292
"6752","chr15",44776326,44776344,19,8,26,53
"6753","chr15",44982667,44982689,23,27,104,154
"6754","chr15",45022975,45022995,21,73,94,188
"6755","chr15",45081502,45081528,27,3,70,100
"6756","chr15",45137186,45137210,25,32,33,90
"6757","chr15",45187993,45188026,34,1,12,47
"6758","chr15",45324504,45324535,32,76,22,130
"6759","chr15",45380124,45380152,29,148,6,183
"6760","chr15",45424372,45424394,23,11,74,108
"6761","chr15",45559590,45559613,24,7,18,49
"6762","chr15",45577616,45577636,21,95,6,122
"6763","chr15",45652639,45652664,26,122,5,153
"6764","chr15",45860399,45860416,18,118,65,201
"6765","chr15",46328274,46328296,23,29,75,127
"6766","chr15",48178094,48178119,26,63,14,103
"6767","chr15",48404490,48404515,26,115,6,147
"6768","chr15",48491334,48491364,31,72,43,146
"6769","chr15",48816601,48816621,21,145,26,192
"6770","chr15",49277138,49277186,49,8,135,192
"6771","chr15",49802502,49802532,31,8,130,169
"6772","chr15",50218061,50218086,26,149,67,242
"6773","chr15",50300437,50300460,24,76,66,166
"6774","chr15",50389685,50389707,23,25,75,123
"6775","chr15",50449891,50449911,21,8,1,30
"6776","chr15",50460302,50460324,23,76,6,105
"6777","chr15",50466595,50466613,19,53,74,146
"6778","chr15",50467881,50467951,71,75,121,267
"6779","chr15",50506958,50506990,33,31,6,70
"6780","chr15",50635665,50635691,27,91,4,122
"6781","chr15",50681265,50681293,29,49,60,138
"6782","chr15",50692679,50692699,21,100,7,128
"6783","chr15",50693421,50693449,29,106,68,203
"6784","chr15",50693424,50693452,29,109,65,203
"6785","chr15",50754985,50755027,43,137,53,233
"6786","chr15",50766505,50766525,21,20,72,113
"6787","chr15",50772028,50772047,20,140,75,235
"6788","chr15",50797319,50797336,18,6,67,91
"6789","chr15",50882688,50882712,25,7,95,127
"6790","chr15",50903848,50903874,27,75,72,174
"6791","chr15",50990345,50990376,32,9,18,59
"6792","chr15",51112665,51112710,46,125,100,271
"6793","chr15",51605518,51605554,37,69,123,229
"6794","chr15",51709888,51709909,22,25,75,122
"6795","chr15",51737248,51737280,33,29,110,172
"6796","chr15",51824913,51824934,22,149,74,245
"6797","chr15",51984448,51984476,29,29,76,134
"6798","chr15",51990955,51990977,23,52,33,108
"6799","chr15",51992268,51992294,27,19,135,181
"6800","chr15",52019445,52019474,30,31,13,74
"6801","chr15",52019548,52019582,35,40,12,87
"6802","chr15",52027948,52027971,24,9,135,168
"6803","chr15",52135853,52135894,42,26,104,172
"6804","chr15",52519617,52519644,28,7,29,64
"6805","chr15",52528912,52528965,54,2,138,194
"6806","chr15",52529104,52529132,29,21,53,103
"6807","chr15",52679756,52679841,86,75,28,189
"6808","chr15",52789469,52789516,48,23,10,81
"6809","chr15",52790363,52790382,20,58,37,115
"6810","chr15",52801022,52801042,21,94,83,198
"6811","chr15",52805380,52805399,20,11,143,174
"6812","chr15",52865719,52865741,23,76,99,198
"6813","chr15",53035760,53035787,28,56,69,153
"6814","chr15",53414926,53414955,30,73,76,179
"6815","chr15",53759706,53759740,35,126,39,200
"6816","chr15",53924206,53924237,32,95,7,134
"6817","chr15",54296368,54296399,32,38,143,213
"6818","chr15",54793938,54793962,25,28,78,131
"6819","chr15",55021844,55021886,43,72,4,119
"6820","chr15",55298205,55298223,19,18,74,111
"6821","chr15",55313973,55314018,46,149,6,201
"6822","chr15",55351874,55351893,20,3,4,27
"6823","chr15",55414200,55414223,24,72,8,104
"6824","chr15",55498594,55498613,20,3,19,42
"6825","chr15",55576456,55576482,27,6,6,39
"6826","chr15",55588184,55588202,19,81,68,168
"6827","chr15",55589261,55589297,37,39,22,98
"6828","chr15",55627493,55627513,21,29,73,123
"6829","chr15",55711082,55711101,20,35,17,72
"6830","chr15",55720061,55720089,29,4,7,40
"6831","chr15",55747915,55747948,34,144,74,252
"6832","chr15",55757981,55758015,35,66,69,170
"6833","chr15",55993613,55993670,58,75,114,247
"6834","chr15",56243369,56243398,30,30,132,192
"6835","chr15",56243375,56243417,43,2,126,171
"6836","chr15",56243786,56243840,55,24,84,163
"6837","chr15",56479888,56479911,24,36,78,138
"6838","chr15",56482152,56482189,38,8,133,179
"6839","chr15",56625132,56625154,23,147,18,188
"6840","chr15",56733492,56733527,36,37,7,80
"6841","chr15",56761908,56761950,43,109,83,235
"6842","chr15",57081705,57081742,38,29,143,210
"6843","chr15",57304260,57304278,19,72,57,148
"6844","chr15",57591854,57591893,40,43,97,180
"6845","chr15",58304304,58304345,42,5,121,168
"6846","chr15",58577338,58577377,40,9,144,193
"6847","chr15",58769431,58769455,25,64,67,156
"6848","chr15",58803946,58803969,24,18,34,76
"6849","chr15",58866862,58866883,22,53,74,149
"6850","chr15",58871073,58871114,42,12,5,59
"6851","chr15",58920624,58920665,42,5,73,120
"6852","chr15",58986184,58986206,23,47,26,96
"6853","chr15",58986207,58986233,27,6,3,36
"6854","chr15",58997886,58997919,34,5,4,43
"6855","chr15",59122242,59122266,25,32,20,77
"6856","chr15",59141798,59141818,21,6,74,101
"6857","chr15",59435285,59435322,38,82,76,196
"6858","chr15",59692594,59692616,23,76,47,146
"6859","chr15",59755357,59755400,44,73,44,161
"6860","chr15",59799847,59799872,26,11,7,44
"6861","chr15",59999510,59999543,34,76,105,215
"6862","chr15",60271670,60271700,31,76,141,248
"6863","chr15",60398048,60398068,21,4,94,119
"6864","chr15",60398363,60398387,25,7,2,34
"6865","chr15",60398784,60398835,52,142,141,335
"6866","chr15",60437644,60437670,27,78,134,239
"6867","chr15",60487703,60487720,18,17,6,41
"6868","chr15",60592477,60592499,23,23,15,61
"6869","chr15",60677306,60677345,40,68,16,124
"6870","chr15",60714041,60714059,19,64,101,184
"6871","chr15",61229304,61229346,43,135,50,228
"6872","chr15",62145250,62145278,29,72,25,126
"6873","chr15",62319052,62319078,27,73,29,129
"6874","chr15",62666962,62666982,21,7,90,118
"6875","chr15",62825700,62825882,183,59,21,263
"6876","chr15",62961177,62961196,20,68,72,160
"6877","chr15",62982181,62982204,24,75,127,226
"6878","chr15",62990090,62990114,25,78,110,213
"6879","chr15",63084035,63084052,18,8,11,37
"6880","chr15",63107142,63107160,19,9,78,106
"6881","chr15",63122004,63122022,19,15,24,58
"6882","chr15",63158568,63158593,26,9,28,63
"6883","chr15",63166858,63166879,22,55,70,147
"6884","chr15",63202090,63202119,30,68,34,132
"6885","chr15",63272312,63272349,38,47,141,226
"6886","chr15",63277438,63277488,51,37,54,142
"6887","chr15",63336544,63336568,25,76,10,111
"6888","chr15",63349523,63349541,19,38,7,64
"6889","chr15",63370773,63370805,33,134,6,173
"6890","chr15",63399989,63400017,29,39,3,71
"6891","chr15",63581551,63581572,22,33,74,129
"6892","chr15",63833754,63833791,38,67,3,108
"6893","chr15",63903996,63904017,22,61,70,153
"6894","chr15",64093515,64093537,23,11,132,166
"6895","chr15",64104885,64104903,19,98,74,191
"6896","chr15",64148448,64148465,18,144,33,195
"6897","chr15",64154957,64154980,24,7,86,117
"6898","chr15",64199854,64199872,19,57,73,149
"6899","chr15",64276947,64276973,27,95,74,196
"6900","chr15",64278373,64278419,47,49,91,187
"6901","chr15",64289180,64289197,18,147,1,166
"6902","chr15",64377919,64377940,22,68,75,165
"6903","chr15",64380706,64380724,19,63,5,87
"6904","chr15",64386620,64386659,40,75,71,186
"6905","chr15",64387396,64387413,18,39,60,117
"6906","chr15",64435214,64435237,24,6,75,105
"6907","chr15",64450389,64450439,51,63,74,188
"6908","chr15",64460592,64460617,26,52,37,115
"6909","chr15",64460688,64460718,31,5,29,65
"6910","chr15",64536910,64536940,31,147,98,276
"6911","chr15",64541028,64541047,20,49,74,143
"6912","chr15",64541427,64541445,19,34,6,59
"6913","chr15",64563774,64563808,35,78,8,121
"6914","chr15",64595002,64595028,27,98,30,155
"6915","chr15",64616813,64616837,25,19,17,61
"6916","chr15",64617184,64617201,18,35,69,122
"6917","chr15",64715211,64715228,18,8,140,166
"6918","chr15",64726785,64726808,24,16,74,114
"6919","chr15",64769662,64769680,19,5,4,28
"6920","chr15",64775593,64775662,70,5,102,177
"6921","chr15",64814492,64814514,23,76,7,106
"6922","chr15",64886866,64886888,23,89,6,118
"6923","chr15",64980738,64980772,35,16,74,125
"6924","chr15",64988982,64989002,21,20,6,47
"6925","chr15",64989277,64989309,33,31,6,70
"6926","chr15",65145255,65145276,22,88,144,254
"6927","chr15",65230263,65230286,24,140,6,170
"6928","chr15",65233405,65233440,36,131,15,182
"6929","chr15",65235640,65235659,20,145,31,196
"6930","chr15",65240324,65240363,40,122,56,218
"6931","chr15",65257454,65257480,27,77,37,141
"6932","chr15",65262124,65262151,28,9,36,73
"6933","chr15",65317783,65317803,21,136,4,161
"6934","chr15",65322865,65322891,27,35,130,192
"6935","chr15",65362847,65362873,27,4,28,59
"6936","chr15",65377701,65377728,28,5,47,80
"6937","chr15",65377856,65377899,44,38,27,109
"6938","chr15",65398893,65398922,30,36,71,137
"6939","chr15",65399448,65399471,24,129,85,238
"6940","chr15",65422877,65422897,21,2,49,72
"6941","chr15",65837244,65837265,22,34,134,190
"6942","chr15",66214031,66214052,22,7,143,172
"6943","chr15",66341768,66341797,30,41,6,77
"6944","chr15",66357087,66357109,23,40,72,135
"6945","chr15",66398769,66398792,24,77,82,183
"6946","chr15",66423605,66423624,20,7,75,102
"6947","chr15",66500025,66500043,19,110,4,133
"6948","chr15",66544725,66544759,35,74,63,172
"6949","chr15",66553755,66553772,18,46,6,70
"6950","chr15",66568818,66568876,59,38,53,150
"6951","chr15",66569363,66569413,51,113,74,238
"6952","chr15",66572865,66572896,32,11,6,49
"6953","chr15",66687416,66687465,50,76,135,261
"6954","chr15",66703331,66703358,28,1,1,30
"6955","chr15",66852987,66853041,55,32,40,127
"6956","chr15",67065664,67065685,22,44,32,98
"6957","chr15",67542730,67542758,29,7,12,48
"6958","chr15",68089876,68089893,18,71,125,214
"6959","chr15",68119238,68119264,27,46,32,105
"6960","chr15",68302056,68302115,60,83,1,144
"6961","chr15",68306023,68306040,18,109,35,162
"6962","chr15",68329752,68329769,18,21,61,100
"6963","chr15",68492364,68492381,18,38,73,129
"6964","chr15",68564471,68564497,27,69,143,239
"6965","chr15",68577725,68577746,22,73,2,97
"6966","chr15",68578895,68578923,29,105,60,194
"6967","chr15",68579188,68579229,42,51,75,168
"6968","chr15",68691625,68691656,32,22,6,60
"6969","chr15",68701479,68701503,25,8,75,108
"6970","chr15",68813869,68813887,19,8,70,97
"6971","chr15",68818040,68818068,29,17,37,83
"6972","chr15",68820633,68820652,20,17,32,69
"6973","chr15",69166909,69166933,25,147,17,189
"6974","chr15",69218150,69218170,21,40,10,71
"6975","chr15",69284425,69284449,25,8,112,145
"6976","chr15",69285462,69285489,28,145,27,200
"6977","chr15",69473534,69473551,18,4,18,40
"6978","chr15",69547425,69547444,20,26,76,122
"6979","chr15",69907181,69907210,30,63,41,134
"6980","chr15",70097015,70097045,31,24,32,87
"6981","chr15",70097448,70097473,26,118,69,213
"6982","chr15",70097767,70097815,49,16,79,144
"6983","chr15",70101681,70101702,22,126,70,218
"6984","chr15",70767239,70767293,55,134,120,309
"6985","chr15",70840547,70840570,24,38,67,129
"6986","chr15",70854226,70854265,40,60,36,136
"6987","chr15",70858609,70858631,23,18,69,110
"6988","chr15",70939848,70939868,21,7,53,81
"6989","chr15",71115648,71115666,19,24,129,172
"6990","chr15",71390850,71390874,25,5,110,140
"6991","chr15",71391027,71391044,18,74,143,235
"6992","chr15",71524764,71524784,21,28,143,192
"6993","chr15",72224916,72224939,24,8,62,94
"6994","chr15",72225089,72225109,21,29,143,193
"6995","chr15",72229923,72229954,32,11,130,173
"6996","chr15",72320054,72320077,24,148,39,211
"6997","chr15",72474428,72474462,35,41,108,184
"6998","chr15",72474867,72474896,30,4,26,60
"6999","chr15",72960878,72960900,23,76,5,104
"7000","chr15",73052293,73052323,31,44,15,90
"7001","chr15",73052528,73052552,25,6,52,83
"7002","chr15",73067617,73067634,18,8,75,101
"7003","chr15",73396266,73396292,27,44,55,126
"7004","chr15",73417547,73417578,32,120,18,170
"7005","chr15",73633245,73633271,27,17,4,48
"7006","chr15",73652930,73652947,18,7,76,101
"7007","chr15",73656135,73656155,21,73,18,112
"7008","chr15",73656285,73656302,18,12,98,128
"7009","chr15",73656466,73656484,19,8,125,152
"7010","chr15",73657083,73657113,31,75,1,107
"7011","chr15",73684186,73684213,28,1,114,143
"7012","chr15",73752987,73753005,19,35,15,69
"7013","chr15",73927563,73927580,18,69,61,148
"7014","chr15",74048579,74048602,24,144,28,196
"7015","chr15",74126897,74126958,62,22,42,126
"7016","chr15",74215887,74215918,32,84,17,133
"7017","chr15",74298710,74298731,22,9,72,103
"7018","chr15",74366278,74366299,22,6,40,68
"7019","chr15",74366456,74366495,40,31,138,209
"7020","chr15",74433209,74433241,33,1,43,77
"7021","chr15",74433809,74433835,27,16,7,50
"7022","chr15",74541152,74541177,26,14,100,140
"7023","chr15",74555787,74555809,23,8,93,124
"7024","chr15",74646045,74646066,22,52,95,169
"7025","chr15",74646060,74646082,23,68,80,171
"7026","chr15",74758712,74758743,32,146,75,253
"7027","chr15",74785981,74786003,23,36,88,147
"7028","chr15",74786014,74786043,30,76,55,161
"7029","chr15",74810866,74810883,18,137,32,187
"7030","chr15",74861901,74861944,44,114,6,164
"7031","chr15",74865075,74865098,24,12,18,54
"7032","chr15",74873427,74873446,20,36,24,80
"7033","chr15",74880502,74880519,18,76,106,200
"7034","chr15",74921408,74921432,25,26,6,57
"7035","chr15",74926033,74926057,25,8,75,108
"7036","chr15",74995540,74995561,22,118,27,167
"7037","chr15",75007557,75007582,26,125,23,174
"7038","chr15",75052739,75052758,20,29,4,53
"7039","chr15",75081556,75081586,31,18,7,56
"7040","chr15",75120395,75120416,22,8,13,43
"7041","chr15",75156242,75156291,50,10,73,133
"7042","chr15",75178961,75178983,23,126,27,176
"7043","chr15",75183933,75183955,23,8,51,82
"7044","chr15",75201837,75201873,37,59,125,221
"7045","chr15",75322725,75322760,36,10,49,95
"7046","chr15",75451584,75451611,28,68,137,233
"7047","chr15",75454678,75454701,24,103,13,140
"7048","chr15",75521290,75521307,18,82,27,127
"7049","chr15",75530200,75530223,24,80,36,140
"7050","chr15",75530216,75530243,28,100,20,148
"7051","chr15",75552042,75552077,36,108,124,268
"7052","chr15",75574943,75574961,19,46,73,138
"7053","chr15",75574983,75575001,19,18,33,70
"7054","chr15",75619739,75619768,30,78,1,109
"7055","chr15",75632803,75632822,20,76,140,236
"7056","chr15",75635043,75635070,28,38,74,140
"7057","chr15",75844189,75844211,23,120,14,157
"7058","chr15",76130219,76130254,36,146,11,193
"7059","chr15",76156362,76156391,30,44,4,78
"7060","chr15",76161458,76161481,24,75,95,194
"7061","chr15",76180608,76180631,24,44,85,153
"7062","chr15",76323196,76323218,23,39,114,176
"7063","chr15",76335113,76335142,30,50,74,154
"7064","chr15",76340525,76340550,26,124,73,223
"7065","chr15",76389501,76389531,31,147,74,252
"7066","chr15",76873087,76873104,18,120,34,172
"7067","chr15",76994608,76994630,23,141,87,251
"7068","chr15",76995150,76995172,23,147,111,281
"7069","chr15",77297758,77297776,19,13,75,107
"7070","chr15",77623826,77624236,411,103,146,660
"7071","chr15",77634905,77634928,24,6,17,47
"7072","chr15",77705175,77705206,32,8,22,62
"7073","chr15",78074004,78074039,36,74,39,149
"7074","chr15",78264626,78264643,18,61,45,124
"7075","chr15",78327192,78327217,26,47,6,79
"7076","chr15",78445775,78445800,26,74,116,216
"7077","chr15",78570425,78570449,25,35,144,204
"7078","chr15",78620716,78620747,32,76,28,136
"7079","chr15",78621012,78621043,32,65,129,226
"7080","chr15",78647691,78647710,20,145,27,192
"7081","chr15",78811451,78811472,22,9,16,47
"7082","chr15",78811530,78811566,37,3,120,160
"7083","chr15",78877114,78877140,27,78,18,123
"7084","chr15",79089484,79089501,18,37,71,126
"7085","chr15",79091374,79091396,23,28,42,93
"7086","chr15",79282907,79282931,25,5,42,72
"7087","chr15",79432586,79432607,22,64,10,96
"7088","chr15",80374935,80374962,28,8,53,89
"7089","chr15",80404297,80404330,34,26,13,73
"7090","chr15",80559316,80559348,33,58,13,104
"7091","chr15",80679181,80679203,23,3,5,31
"7092","chr15",80695066,80695091,26,14,51,91
"7093","chr15",80695096,80695118,23,13,21,57
"7094","chr15",80695275,80695301,27,47,11,85
"7095","chr15",80695378,80695400,23,146,23,192
"7096","chr15",80771045,80771091,47,68,44,159
"7097","chr15",80788472,80788518,47,131,42,220
"7098","chr15",80989715,80989737,23,45,81,149
"7099","chr15",81160025,81160043,19,29,74,122
"7100","chr15",81271255,81271323,69,77,43,189
"7101","chr15",81317195,81317212,18,3,121,142
"7102","chr15",81565292,81565433,142,149,105,396
"7103","chr15",81816592,81816636,45,76,135,256
"7104","chr15",82014366,82014397,32,77,66,175
"7105","chr15",82046083,82046101,19,85,54,158
"7106","chr15",82305235,82305271,37,11,43,91
"7107","chr15",82513029,82513047,19,14,136,169
"7108","chr15",82665377,82665434,58,13,113,184
"7109","chr15",82670070,82670092,23,41,5,69
"7110","chr15",82699642,82699659,18,53,55,126
"7111","chr15",82734459,82734479,21,13,73,107
"7112","chr15",82744775,82744792,18,53,43,114
"7113","chr15",82764493,82764512,20,25,54,99
"7114","chr15",82782066,82782106,41,140,72,253
"7115","chr15",82855326,82855354,29,30,119,178
"7116","chr15",82914179,82914227,49,76,78,203
"7117","chr15",82927974,82927995,22,83,2,107
"7118","chr15",82962365,82962386,22,4,11,37
"7119","chr15",83059548,83059570,23,95,4,122
"7120","chr15",83066698,83066737,40,34,44,118
"7121","chr15",83106501,83106545,45,72,62,179
"7122","chr15",83207683,83207707,25,65,70,160
"7123","chr15",83369291,83369309,19,75,74,168
"7124","chr15",83550795,83550813,19,17,40,76
"7125","chr15",83669454,83669485,32,8,139,179
"7126","chr15",84066496,84066514,19,135,47,201
"7127","chr15",84229216,84229233,18,14,136,168
"7128","chr15",84343787,84343804,18,14,136,168
"7129","chr15",84444349,84444366,18,138,12,168
"7130","chr15",84603369,84603386,18,8,73,99
"7131","chr15",84650355,84650376,22,6,143,171
"7132","chr15",84702066,84702096,31,92,75,198
"7133","chr15",84748280,84748317,38,28,102,168
"7134","chr15",84776755,84776776,22,104,7,133
"7135","chr15",84796904,84796930,27,25,111,163
"7136","chr15",84830868,84830895,28,34,23,85
"7137","chr15",84908179,84908201,23,76,5,104
"7138","chr15",84936245,84936272,28,73,21,122
"7139","chr15",84981384,84981403,20,39,40,99
"7140","chr15",84981692,84981711,20,1,16,37
"7141","chr15",85090691,85090708,18,23,45,86
"7142","chr15",85321905,85321929,25,42,73,140
"7143","chr15",85338740,85338758,19,8,73,100
"7144","chr15",85570076,85570095,20,74,7,101
"7145","chr15",85641446,85641507,62,12,6,80
"7146","chr15",85775865,85775889,25,11,54,90
"7147","chr15",85801301,85801320,20,8,84,112
"7148","chr15",85803187,85803208,22,72,5,99
"7149","chr15",85902171,85902203,33,15,67,115
"7150","chr15",86236933,86236959,27,22,62,111
"7151","chr15",86250526,86250573,48,6,6,60
"7152","chr15",86380205,86380258,54,32,45,131
"7153","chr15",86383248,86383275,28,117,73,218
"7154","chr15",86724236,86724254,19,43,6,68
"7155","chr15",87158401,87158423,23,77,143,243
"7156","chr15",87663453,87663486,34,100,5,139
"7157","chr15",87843799,87843871,73,104,96,273
"7158","chr15",87881407,87881436,30,7,111,148
"7159","chr15",88206659,88206677,19,71,5,95
"7160","chr15",88256785,88256823,39,10,10,59
"7161","chr15",88256939,88256959,21,54,64,139
"7162","chr15",88669271,88669295,25,8,45,78
"7163","chr15",88705430,88705472,43,85,9,137
"7164","chr15",88777298,88777318,21,78,16,115
"7165","chr15",88885443,88885476,34,9,143,186
"7166","chr15",88951994,88952023,30,76,48,154
"7167","chr15",88996099,88996118,20,38,143,201
"7168","chr15",89062968,89062985,18,8,13,39
"7169","chr15",89359185,89359203,19,35,73,127
"7170","chr15",89400142,89400172,31,62,18,111
"7171","chr15",89486548,89486600,53,50,10,113
"7172","chr15",89501962,89502022,61,76,106,243
"7173","chr15",89574170,89574198,29,37,50,116
"7174","chr15",89598361,89598378,18,6,57,81
"7175","chr15",89675115,89675139,25,81,35,141
"7176","chr15",89740488,89740519,32,8,7,47
"7177","chr15",89750673,89750690,18,58,84,160
"7178","chr15",89776890,89776973,84,86,62,232
"7179","chr15",89787041,89787063,23,76,38,137
"7180","chr15",89832487,89832506,20,76,31,127
"7181","chr15",89989509,89989551,43,73,91,207
"7182","chr15",89999911,89999938,28,4,145,177
"7183","chr15",90001553,90001576,24,47,58,129
"7184","chr15",90001633,90001660,28,131,47,206
"7185","chr15",90001890,90001924,35,25,85,145
"7186","chr15",90001967,90001997,31,19,8,58
"7187","chr15",90030330,90030353,24,74,5,103
"7188","chr15",90042493,90042519,27,121,58,206
"7189","chr15",90047569,90047600,32,8,40,80
"7190","chr15",90069229,90069250,22,137,73,232
"7191","chr15",90151710,90151728,19,129,35,183
"7192","chr15",90156473,90156502,30,136,6,172
"7193","chr15",90169705,90169723,19,39,2,60
"7194","chr15",90188629,90188647,19,38,41,98
"7195","chr15",90201650,90201684,35,52,26,113
"7196","chr15",90243641,90243670,30,11,64,105
"7197","chr15",90249215,90249237,23,11,3,37
"7198","chr15",90279004,90279026,23,28,6,57
"7199","chr15",90332652,90332669,18,36,72,126
"7200","chr15",90387149,90387170,22,13,74,109
"7201","chr15",90533085,90533121,37,12,98,147
"7202","chr15",90699371,90699389,19,16,6,41
"7203","chr15",90937793,90937825,33,87,4,124
"7204","chr15",90978754,90978778,25,68,5,98
"7205","chr15",91272829,91272852,24,10,4,38
"7206","chr15",91278679,91278699,21,3,6,30
"7207","chr15",91761624,91761659,36,76,82,194
"7208","chr15",91853714,91853734,21,30,1,52
"7209","chr15",91853871,91853901,31,104,43,178
"7210","chr15",91878086,91878106,21,47,54,122
"7211","chr15",92065067,92065097,31,73,139,243
"7212","chr15",92393898,92393929,32,34,52,118
"7213","chr15",92627052,92627078,27,54,124,205
"7214","chr15",92769511,92769546,36,1,117,154
"7215","chr15",92812627,92812649,23,4,142,169
"7216","chr15",92826566,92826589,24,75,33,132
"7217","chr15",92828971,92828997,27,9,8,44
"7218","chr15",93084459,93084490,32,8,37,77
"7219","chr15",93097475,93097492,18,7,7,32
"7220","chr15",93144366,93144385,20,10,74,104
"7221","chr15",93214898,93214924,27,38,142,207
"7222","chr15",93354065,93354093,29,97,74,200
"7223","chr15",93434087,93434109,23,77,9,109
"7224","chr15",93472030,93472054,25,45,89,159
"7225","chr15",93804363,93804384,22,98,75,195
"7226","chr15",94512086,94512108,23,8,58,89
"7227","chr15",94712442,94712468,27,86,2,115
"7228","chr15",95251145,95251162,18,8,91,117
"7229","chr15",95530159,95530181,23,23,55,101
"7230","chr15",96186948,96186965,18,76,22,116
"7231","chr15",96330401,96330427,27,32,71,130
"7232","chr15",96331282,96331299,18,9,6,33
"7233","chr15",96332040,96332062,23,6,76,105
"7234","chr15",96341152,96341174,23,22,80,125
"7235","chr15",96354141,96354185,45,53,15,113
"7236","chr15",96537249,96537271,23,86,104,213
"7237","chr15",96802592,96802613,22,115,41,178
"7238","chr15",96849187,96849210,24,113,68,205
"7239","chr15",96899393,96899411,19,69,33,121
"7240","chr15",96966259,96966287,29,110,74,213
"7241","chr15",97391920,97391948,29,9,6,44
"7242","chr15",97952835,97952857,23,74,56,153
"7243","chr15",97981061,97981085,25,35,74,134
"7244","chr15",98000092,98000116,25,43,69,137
"7245","chr15",98542021,98542074,54,78,71,203
"7246","chr15",98585003,98585022,20,9,74,103
"7247","chr15",98585354,98585376,23,134,94,251
"7248","chr15",98618499,98618551,53,10,95,158
"7249","chr15",98649031,98649053,23,9,23,55
"7250","chr15",98649508,98649549,42,104,3,149
"7251","chr15",98747183,98747207,25,69,74,168
"7252","chr15",99065283,99065304,22,114,82,218
"7253","chr15",99406708,99406758,51,109,4,164
"7254","chr15",99688762,99688781,20,77,1,98
"7255","chr15",99734209,99734235,27,76,33,136
"7256","chr15",99806041,99806068,28,7,17,52
"7257","chr15",99844084,99844106,23,21,17,61
"7258","chr15",100091011,100091028,18,92,71,181
"7259","chr15",101008143,101008176,34,119,74,227
"7260","chr15",101109495,101109538,44,80,39,163
"7261","chr15",101277420,101277439,20,68,50,138
"7262","chr15",101299184,101299211,28,15,6,49
"7263","chr15",101316911,101316929,19,76,61,156
"7264","chr15",101381363,101381387,25,104,99,228
"7265","chr15",101406211,101406238,28,120,58,206
"7266","chr15",101452450,101452468,19,51,115,185
"7267","chr15",101489495,101489527,33,35,16,84
"7268","chr15",101489758,101489785,28,24,16,68
"7269","chr15",101533762,101533792,31,77,6,114
"7270","chr15",101722643,101722669,27,145,35,207
"7271","chr15",101724553,101724584,32,1,79,112
"7272","chr15",101724604,101724628,25,2,28,55
"7273","chr15",101746664,101746691,28,19,6,53
"7274","chr16",24474,24497,24,8,19,51
"7275","chr16",46723,46765,43,49,75,167
"7276","chr16",72367,72403,37,4,25,66
"7277","chr16",88388,88408,21,59,67,147
"7278","chr16",99960,100005,46,67,71,184
"7279","chr16",127655,127672,18,8,25,51
"7280","chr16",137046,137071,26,78,33,137
"7281","chr16",139190,139233,44,11,22,77
"7282","chr16",139517,139540,24,35,6,65
"7283","chr16",144647,144667,21,144,7,172
"7284","chr16",154101,154193,93,115,132,340
"7285","chr16",155377,155397,21,100,4,125
"7286","chr16",164691,164983,293,149,132,574
"7287","chr16",182418,182441,24,81,72,177
"7288","chr16",190055,190072,18,99,84,201
"7289","chr16",216381,216400,20,8,66,94
"7290","chr16",229175,229192,18,122,90,230
"7291","chr16",238766,238797,32,10,43,85
"7292","chr16",239303,239322,20,138,3,161
"7293","chr16",247122,247148,27,10,96,133
"7294","chr16",257237,257262,26,75,68,169
"7295","chr16",273732,273754,23,36,98,157
"7296","chr16",281017,281035,19,38,3,60
"7297","chr16",340025,340050,26,3,55,84
"7298","chr16",352654,352698,45,57,16,118
"7299","chr16",352915,352943,29,15,27,71
"7300","chr16",381745,381762,18,28,5,51
"7301","chr16",385619,385642,24,8,137,169
"7302","chr16",397653,397744,92,59,46,197
"7303","chr16",401146,401168,23,9,117,149
"7304","chr16",402160,402182,23,37,21,81
"7305","chr16",448739,448758,20,138,3,161
"7306","chr16",459432,459452,21,74,70,165
"7307","chr16",508365,508389,25,6,14,45
"7308","chr16",570398,570417,20,10,35,65
"7309","chr16",579011,579046,36,79,129,244
"7310","chr16",581761,581780,20,7,146,173
"7311","chr16",595594,595620,27,76,80,183
"7312","chr16",601806,601845,40,147,41,228
"7313","chr16",628579,628597,19,71,13,103
"7314","chr16",642266,642286,21,57,30,108
"7315","chr16",663102,663133,32,125,71,228
"7316","chr16",690600,690619,20,10,43,73
"7317","chr16",695344,695392,49,141,22,212
"7318","chr16",696226,696249,24,47,56,127
"7319","chr16",696247,696269,23,67,35,125
"7320","chr16",705952,705980,29,53,38,120
"7321","chr16",713319,713348,30,145,8,183
"7322","chr16",722646,722664,19,126,10,155
"7323","chr16",726993,727012,20,24,16,60
"7324","chr16",743521,743544,24,33,6,63
"7325","chr16",769164,769269,106,139,7,252
"7326","chr16",773387,773410,24,59,111,194
"7327","chr16",788403,788443,41,10,10,61
"7328","chr16",793085,793103,19,98,106,223
"7329","chr16",826415,826455,41,76,31,148
"7330","chr16",826638,826676,39,8,42,89
"7331","chr16",837819,837855,37,73,138,248
"7332","chr16",977814,978238,425,7,4,436
"7333","chr16",981304,981348,45,11,94,150
"7334","chr16",981348,981391,44,6,50,100
"7335","chr16",981783,981804,22,74,30,126
"7336","chr16",982188,982205,18,3,41,62
"7337","chr16",989855,989872,18,93,14,125
"7338","chr16",1004210,1004228,19,56,54,129
"7339","chr16",1004360,1004383,24,41,113,178
"7340","chr16",1024892,1024914,23,3,7,33
"7341","chr16",1029036,1029059,24,25,20,69
"7342","chr16",1046003,1046020,18,64,41,123
"7343","chr16",1050086,1050112,27,141,59,227
"7344","chr16",1052274,1052292,19,37,6,62
"7345","chr16",1072716,1072741,26,127,82,235
"7346","chr16",1075835,1076304,470,101,59,630
"7347","chr16",1089088,1089108,21,15,66,102
"7348","chr16",1116059,1116081,23,58,74,155
"7349","chr16",1134457,1134475,19,43,4,66
"7350","chr16",1152653,1152671,19,15,56,90
"7351","chr16",1152698,1152732,35,37,11,83
"7352","chr16",1153017,1153096,80,44,62,186
"7353","chr16",1153343,1153402,60,26,10,96
"7354","chr16",1174904,1174969,66,147,95,308
"7355","chr16",1202006,1202039,34,123,94,251
"7356","chr16",1204261,1204278,18,116,25,159
"7357","chr16",1212151,1212171,21,101,62,184
"7358","chr16",1234772,1234789,18,40,74,132
"7359","chr16",1251657,1251677,21,79,38,138
"7360","chr16",1268498,1268524,27,137,73,237
"7361","chr16",1268819,1268842,24,82,6,112
"7362","chr16",1337670,1337690,21,36,83,140
"7363","chr16",1348030,1348049,20,138,100,258
"7364","chr16",1357484,1357510,27,55,45,127
"7365","chr16",1383104,1383122,19,145,27,191
"7366","chr16",1414874,1414930,57,121,4,182
"7367","chr16",1422778,1422803,26,57,95,178
"7368","chr16",1432692,1432735,44,1,21,66
"7369","chr16",1457197,1457214,18,10,41,69
"7370","chr16",1466924,1466954,31,46,76,153
"7371","chr16",1483397,1483419,23,22,2,47
"7372","chr16",1487999,1488016,18,94,33,145
"7373","chr16",1507764,1507939,176,87,87,350
"7374","chr16",1519961,1519979,19,34,16,69
"7375","chr16",1522357,1522386,30,78,74,182
"7376","chr16",1611491,1611520,30,135,19,184
"7377","chr16",1614312,1614340,29,36,4,69
"7378","chr16",1618283,1618310,28,5,73,106
"7379","chr16",1622754,1622779,26,76,139,241
"7380","chr16",1678441,1678462,22,52,35,109
"7381","chr16",1686373,1686402,30,140,6,176
"7382","chr16",1705648,1705670,23,48,43,114
"7383","chr16",1721756,1721785,30,74,129,233
"7384","chr16",1756624,1756670,47,143,24,214
"7385","chr16",1821935,1821966,32,64,136,232
"7386","chr16",1843296,1843328,33,59,4,96
"7387","chr16",1871520,1871544,25,78,144,247
"7388","chr16",1889809,1889826,18,8,28,54
"7389","chr16",1891925,1891971,47,43,109,199
"7390","chr16",1899491,1899508,18,8,7,33
"7391","chr16",1918484,1918520,37,33,11,81
"7392","chr16",1927780,1927801,22,14,72,108
"7393","chr16",1934391,1934426,36,6,11,53
"7394","chr16",1934398,1934430,33,10,4,47
"7395","chr16",1944544,1944563,20,92,109,221
"7396","chr16",1949239,1949281,43,136,90,269
"7397","chr16",1957250,1957291,42,9,3,54
"7398","chr16",1964483,1964527,45,68,72,185
"7399","chr16",1989996,1990016,21,69,35,125
"7400","chr16",1990013,1990031,19,84,18,121
"7401","chr16",2000908,2000939,32,54,72,158
"7402","chr16",2017316,2017342,27,9,95,131
"7403","chr16",2017492,2017510,19,8,142,169
"7404","chr16",2026858,2026889,32,24,50,106
"7405","chr16",2038199,2038263,65,103,68,236
"7406","chr16",2093917,2093936,20,14,119,153
"7407","chr16",2102774,2102792,19,33,84,136
"7408","chr16",2121016,2121048,33,112,7,152
"7409","chr16",2129542,2129568,27,9,31,67
"7410","chr16",2135933,2135971,39,19,75,133
"7411","chr16",2142851,2142874,24,8,8,40
"7412","chr16",2144971,2144990,20,4,15,39
"7413","chr16",2148650,2148682,33,132,83,248
"7414","chr16",2155939,2155963,25,142,1,168
"7415","chr16",2155962,2155996,35,15,30,80
"7416","chr16",2156003,2156030,28,23,33,84
"7417","chr16",2179022,2179068,47,4,54,105
"7418","chr16",2196572,2196598,27,27,19,73
"7419","chr16",2196644,2196681,38,36,17,91
"7420","chr16",2214765,2214811,47,113,144,304
"7421","chr16",2218709,2218726,18,37,75,130
"7422","chr16",2234794,2234819,26,2,119,147
"7423","chr16",2238236,2238260,25,112,76,213
"7424","chr16",2241858,2241875,18,74,143,235
"7425","chr16",2249019,2249061,43,6,81,130
"7426","chr16",2249877,2249905,29,96,7,132
"7427","chr16",2420776,2420810,35,46,14,95
"7428","chr16",2447276,2447293,18,145,13,176
"7429","chr16",2455058,2455082,25,80,76,181
"7430","chr16",2475605,2475623,19,99,147,265
"7431","chr16",2489435,2489464,30,39,3,72
"7432","chr16",2513789,2513811,23,97,72,192
"7433","chr16",2520252,2520276,25,139,66,230
"7434","chr16",2537723,2537759,37,74,24,135
"7435","chr16",2543889,2543906,18,27,143,188
"7436","chr16",2556358,2556381,24,7,143,174
"7437","chr16",2643811,2643831,21,145,5,171
"7438","chr16",2742288,2742310,23,123,74,220
"7439","chr16",2747475,2747511,37,8,37,82
"7440","chr16",2867112,2867131,20,4,30,54
"7441","chr16",2878581,2878606,26,44,137,207
"7442","chr16",2884559,2884577,19,131,35,185
"7443","chr16",2884875,2884897,23,4,5,32
"7444","chr16",2969365,2969383,19,33,37,89
"7445","chr16",3011286,3011305,20,75,76,171
"7446","chr16",3011331,3011348,18,118,31,167
"7447","chr16",3016648,3016665,18,8,143,169
"7448","chr16",3020314,3020332,19,8,145,172
"7449","chr16",3045343,3045381,39,56,7,102
"7450","chr16",3046537,3046556,20,20,12,52
"7451","chr16",3061137,3061162,26,87,74,187
"7452","chr16",3090891,3090908,18,65,30,113
"7453","chr16",3096929,3096947,19,145,6,170
"7454","chr16",3105668,3105691,24,106,6,136
"7455","chr16",3106652,3106681,30,128,30,188
"7456","chr16",3108409,3108433,25,8,49,82
"7457","chr16",3135099,3135139,41,15,89,145
"7458","chr16",3151830,3151893,64,71,66,201
"7459","chr16",3154899,3154918,20,33,54,107
"7460","chr16",3161062,3161086,25,6,6,37
"7461","chr16",3179117,3179141,25,132,5,162
"7462","chr16",3195280,3195298,19,25,7,51
"7463","chr16",3242362,3242379,18,139,8,165
"7464","chr16",3272715,3272738,24,8,20,52
"7465","chr16",3309452,3309485,34,145,23,202
"7466","chr16",3329749,3329772,24,76,11,111
"7467","chr16",3402439,3402474,36,6,14,56
"7468","chr16",3455387,3455408,22,4,123,149
"7469","chr16",3465267,3465295,29,84,74,187
"7470","chr16",3488533,3488555,23,5,98,126
"7471","chr16",3613909,3613931,23,77,106,206
"7472","chr16",3653807,3653841,35,112,6,153
"7473","chr16",3708638,3708660,23,111,5,139
"7474","chr16",3724245,3724266,22,76,140,238
"7475","chr16",3728289,3728315,27,77,77,181
"7476","chr16",3728400,3728453,54,14,71,139
"7477","chr16",3777021,3777054,34,141,71,246
"7478","chr16",3851861,3851879,19,136,67,222
"7479","chr16",3880140,3880163,24,44,5,73
"7480","chr16",3880302,3880319,18,77,5,100
"7481","chr16",3880404,3880421,18,11,12,41
"7482","chr16",3880450,3880522,73,34,80,187
"7483","chr16",3909526,3909565,40,76,15,131
"7484","chr16",4051216,4051239,24,10,120,154
"7485","chr16",4116583,4116610,28,27,92,147
"7486","chr16",4119576,4119604,29,73,81,183
"7487","chr16",4149994,4150023,30,145,26,201
"7488","chr16",4173376,4173402,27,39,140,206
"7489","chr16",4188451,4188469,19,128,72,219
"7490","chr16",4201638,4201672,35,75,84,194
"7491","chr16",4254902,4254927,26,76,8,110
"7492","chr16",4268571,4268608,38,6,52,96
"7493","chr16",4269493,4269515,23,133,6,162
"7494","chr16",4272286,4272308,23,9,26,58
"7495","chr16",4272869,4272887,19,95,74,188
"7496","chr16",4272948,4273003,56,13,35,104
"7497","chr16",4274402,4274425,24,8,17,49
"7498","chr16",4279540,4279558,19,144,78,241
"7499","chr16",4292778,4292802,25,38,75,138
"7500","chr16",4316410,4316445,36,58,8,102
"7501","chr16",4326756,4326776,21,6,30,57
"7502","chr16",4348954,4348972,19,7,12,38
"7503","chr16",4394449,4394467,19,12,6,37
"7504","chr16",4397608,4397631,24,76,93,193
"7505","chr16",4445543,4445566,24,5,136,165
"7506","chr16",4464612,4464632,21,8,122,151
"7507","chr16",4477498,4477523,26,33,7,66
"7508","chr16",4487952,4487972,21,76,5,102
"7509","chr16",4581128,4581184,57,76,69,202
"7510","chr16",4595691,4595713,23,65,97,185
"7511","chr16",4632391,4632409,19,74,31,124
"7512","chr16",4637119,4637141,23,54,124,201
"7513","chr16",4650318,4650335,18,10,10,38
"7514","chr16",4693887,4693922,36,11,9,56
"7515","chr16",4702107,4702126,20,113,122,255
"7516","chr16",4757601,4757618,18,74,144,236
"7517","chr16",4773544,4773562,19,15,1,35
"7518","chr16",4775806,4775832,27,8,143,178
"7519","chr16",4789307,4789343,37,8,2,47
"7520","chr16",4907994,4908013,20,78,33,131
"7521","chr16",4909425,4909446,22,78,86,186
"7522","chr16",4922661,4922680,20,68,7,95
"7523","chr16",4930535,4930553,19,91,50,160
"7524","chr16",4950276,4950303,28,6,85,119
"7525","chr16",4953181,4953202,22,61,6,89
"7526","chr16",4965661,4965689,29,127,6,162
"7527","chr16",4966268,4966291,24,76,143,243
"7528","chr16",4998738,4998766,29,99,6,134
"7529","chr16",5001251,5001276,26,76,52,154
"7530","chr16",5005864,5005882,19,48,6,73
"7531","chr16",5019834,5019861,28,126,4,158
"7532","chr16",5059251,5059294,44,123,74,241
"7533","chr16",5061265,5061284,20,148,71,239
"7534","chr16",5578845,5578867,23,10,77,110
"7535","chr16",6019074,6019107,34,125,122,281
"7536","chr16",6069025,6069090,66,121,54,241
"7537","chr16",6166769,6166792,24,77,27,128
"7538","chr16",6344392,6344419,28,12,104,144
"7539","chr16",6925456,6925482,27,113,86,226
"7540","chr16",6940764,6940811,48,119,76,243
"7541","chr16",6940852,6940890,39,39,141,219
"7542","chr16",6960974,6960994,21,78,31,130
"7543","chr16",6985853,6985885,33,58,100,191
"7544","chr16",7000565,7000617,53,71,2,126
"7545","chr16",7145186,7145214,29,68,9,106
"7546","chr16",7304194,7304247,54,137,65,256
"7547","chr16",7427595,7427628,34,33,16,83
"7548","chr16",7427599,7427639,41,44,12,97
"7549","chr16",7448928,7448946,19,7,65,91
"7550","chr16",7610119,7610139,21,10,9,40
"7551","chr16",8211369,8211415,47,5,104,156
"7552","chr16",8238099,8238125,27,63,6,96
"7553","chr16",8393591,8393618,28,8,60,96
"7554","chr16",8602724,8602751,28,8,4,40
"7555","chr16",8609232,8609271,40,70,3,113
"7556","chr16",8626762,8626784,23,76,88,187
"7557","chr16",8660781,8660907,127,95,131,353
"7558","chr16",8742866,8742886,21,145,6,172
"7559","chr16",8749387,8749416,30,8,145,183
"7560","chr16",8766654,8766686,33,147,7,187
"7561","chr16",8776881,8776902,22,44,61,127
"7562","chr16",8781581,8781603,23,1,30,54
"7563","chr16",8857760,8857778,19,7,112,138
"7564","chr16",8869205,8869232,28,11,24,63
"7565","chr16",8904784,8904815,32,70,31,133
"7566","chr16",8963256,8963276,21,68,46,135
"7567","chr16",8963346,8963393,48,1,120,169
"7568","chr16",8963567,8963586,20,16,18,54
"7569","chr16",8963604,8963641,38,8,76,122
"7570","chr16",8963928,8963946,19,22,6,47
"7571","chr16",9004508,9004549,42,7,30,79
"7572","chr16",9025194,9025213,20,29,144,193
"7573","chr16",9026621,9026638,18,8,124,150
"7574","chr16",9030081,9030125,45,60,72,177
"7575","chr16",9045826,9045848,23,7,39,69
"7576","chr16",9073427,9073456,30,45,89,164
"7577","chr16",9087650,9087667,18,71,145,234
"7578","chr16",9151453,9151485,33,76,43,152
"7579","chr16",9190137,9190161,25,8,140,173
"7580","chr16",9523485,9523505,21,111,71,203
"7581","chr16",9540838,9540855,18,8,111,137
"7582","chr16",10096540,10096573,34,136,19,189
"7583","chr16",10239511,10239530,20,85,15,120
"7584","chr16",10366183,10366217,35,77,6,118
"7585","chr16",10387883,10387913,31,69,114,214
"7586","chr16",10459468,10459490,23,70,6,99
"7587","chr16",10509497,10509520,24,79,35,138
"7588","chr16",10528054,10528080,27,72,35,134
"7589","chr16",10542400,10542422,23,9,72,104
"7590","chr16",10605633,10605666,34,38,72,144
"7591","chr16",10752784,10752806,23,119,53,195
"7592","chr16",10774607,10774625,19,73,23,115
"7593","chr16",10785097,10785114,18,139,74,231
"7594","chr16",11146760,11146783,24,1,145,170
"7595","chr16",11172890,11172908,19,45,73,137
"7596","chr16",11247395,11247435,41,34,2,77
"7597","chr16",11261890,11261921,32,56,124,212
"7598","chr16",11273404,11273445,42,77,135,254
"7599","chr16",11322499,11322531,33,9,73,115
"7600","chr16",11324675,11324699,25,104,145,274
"7601","chr16",11411250,11411267,18,114,19,151
"7602","chr16",11490397,11490417,21,147,5,173
"7603","chr16",11498498,11498521,24,53,58,135
"7604","chr16",11503925,11503942,18,39,17,74
"7605","chr16",11593172,11593190,19,129,5,153
"7606","chr16",11644770,11644797,28,123,118,269
"7607","chr16",11652348,11652370,23,135,74,232
"7608","chr16",11668332,11668356,25,19,4,48
"7609","chr16",11754894,11754914,21,134,17,172
"7610","chr16",11797160,11797209,50,20,91,161
"7611","chr16",11853856,11853885,30,56,13,99
"7612","chr16",11860258,11860275,18,76,39,133
"7613","chr16",11867086,11867107,22,17,16,55
"7614","chr16",11889330,11889356,27,9,127,163
"7615","chr16",11908760,11908792,33,20,6,59
"7616","chr16",11915649,11915672,24,41,22,87
"7617","chr16",11915674,11915705,32,23,74,129
"7618","chr16",11941345,11941381,37,46,133,216
"7619","chr16",11941434,11941458,25,123,44,192
"7620","chr16",11952153,11952198,46,78,12,136
"7621","chr16",11963058,11963084,27,84,52,163
"7622","chr16",11975076,11975094,19,5,5,29
"7623","chr16",11975142,11975165,24,8,7,39
"7624","chr16",12175476,12175498,23,29,38,90
"7625","chr16",12376033,12376053,21,36,74,131
"7626","chr16",12587066,12587089,24,51,6,81
"7627","chr16",12970679,12970697,19,25,141,185
"7628","chr16",13983342,13983362,21,8,143,172
"7629","chr16",14071327,14071358,32,105,23,160
"7630","chr16",14184223,14184240,18,76,78,172
"7631","chr16",14302006,14302062,57,15,44,116
"7632","chr16",14317256,14317282,27,45,78,150
"7633","chr16",14321171,14321189,19,76,113,208
"7634","chr16",14352476,14352518,43,32,74,149
"7635","chr16",14352540,14352564,25,11,10,46
"7636","chr16",14413142,14413201,60,76,101,237
"7637","chr16",14598148,14598165,18,77,139,234
"7638","chr16",14694159,14694198,40,36,84,160
"7639","chr16",14712316,14712358,43,134,65,242
"7640","chr16",14733277,14733316,40,36,84,160
"7641","chr16",14751440,14751482,43,134,65,242
"7642","chr16",14778073,14778098,26,5,102,133
"7643","chr16",14788657,14788683,27,68,142,237
"7644","chr16",14824761,14824786,26,11,137,174
"7645","chr16",14834688,14834705,18,34,31,83
"7646","chr16",14930344,14930362,19,86,31,136
"7647","chr16",14932133,14932152,20,52,7,79
"7648","chr16",14938070,14938112,43,72,65,180
"7649","chr16",15122818,15122861,44,57,70,171
"7650","chr16",15125152,15125179,28,47,69,144
"7651","chr16",15130595,15130613,19,33,84,136
"7652","chr16",15140096,15140123,28,108,75,211
"7653","chr16",15148371,15148401,31,9,31,71
"7654","chr16",15231722,15231745,24,77,27,128
"7655","chr16",15377625,15377674,50,71,132,253
"7656","chr16",15395572,15395594,23,30,51,104
"7657","chr16",15426131,15426170,40,10,49,99
"7658","chr16",15503448,15503465,18,23,76,117
"7659","chr16",15503463,15503480,18,38,61,117
"7660","chr16",15532528,15532563,36,8,41,85
"7661","chr16",15541906,15541925,20,35,141,196
"7662","chr16",15567761,15567786,26,21,76,123
"7663","chr16",15582402,15582420,19,109,3,131
"7664","chr16",15614482,15614503,22,5,7,34
"7665","chr16",15705985,15706005,21,71,2,94
"7666","chr16",15777091,15777128,38,65,79,182
"7667","chr16",15858334,15858357,24,40,88,152
"7668","chr16",15889762,15889779,18,10,6,34
"7669","chr16",15901617,15901641,25,5,25,55
"7670","chr16",15949523,15949548,26,26,88,140
"7671","chr16",15949612,15949633,22,23,23,68
"7672","chr16",15990817,15990836,20,29,143,192
"7673","chr16",15999616,15999653,38,43,73,154
"7674","chr16",16005995,16006017,23,148,33,204
"7675","chr16",16093980,16094001,22,44,86,152
"7676","chr16",16108575,16108611,37,74,145,256
"7677","chr16",16124378,16124425,48,126,146,320
"7678","chr16",16223526,16223551,26,11,137,174
"7679","chr16",16233503,16233522,20,35,31,86
"7680","chr16",16266388,16266405,18,100,66,184
"7681","chr16",16313792,16313809,18,75,123,216
"7682","chr16",16328829,16328847,19,86,31,136
"7683","chr16",16330619,16330639,21,52,7,80
"7684","chr16",16336554,16336596,43,135,65,243
"7685","chr16",16372128,16372146,19,86,31,136
"7686","chr16",16377567,16377587,21,71,45,137
"7687","chr16",16379871,16379914,44,135,66,245
"7688","chr16",16406725,16406750,26,5,102,133
"7689","chr16",16491945,16491967,23,29,6,58
"7690","chr16",16580375,16580418,44,7,69,120
"7691","chr16",16630593,16630696,104,7,39,150
"7692","chr16",16886612,16886644,33,48,71,152
"7693","chr16",16909807,16909846,40,19,55,114
"7694","chr16",16997201,16997229,29,77,24,130
"7695","chr16",17192093,17192116,24,126,40,190
"7696","chr16",17273844,17273861,18,8,74,100
"7697","chr16",17357173,17357199,27,118,10,155
"7698","chr16",17397828,17397848,21,16,42,79
"7699","chr16",17470527,17470564,38,39,64,141
"7700","chr16",18187183,18187200,18,75,27,120
"7701","chr16",18331993,18332036,44,68,133,245
"7702","chr16",18334320,18334340,21,47,69,137
"7703","chr16",18339761,18339779,19,33,84,136
"7704","chr16",18372108,18372162,55,68,133,256
"7705","chr16",18378077,18378096,20,9,50,79
"7706","chr16",18379868,18379886,19,33,84,136
"7707","chr16",18398339,18398356,18,125,73,216
"7708","chr16",18561174,18561207,34,36,33,103
"7709","chr16",18722996,18723052,57,41,20,118
"7710","chr16",18802589,18802607,19,4,141,164
"7711","chr16",18925988,18926007,20,24,75,119
"7712","chr16",18926157,18926192,36,4,17,57
"7713","chr16",18939379,18939397,19,69,24,112
"7714","chr16",18974074,18974105,32,75,114,221
"7715","chr16",18979380,18979413,34,48,5,87
"7716","chr16",18983999,18984019,21,54,20,95
"7717","chr16",18997730,18997747,18,8,90,116
"7718","chr16",19028990,19029022,33,7,109,149
"7719","chr16",19042741,19042763,23,7,9,39
"7720","chr16",19064662,19064683,22,14,142,178
"7721","chr16",19067035,19067053,19,19,51,89
"7722","chr16",19076255,19076276,22,37,29,88
"7723","chr16",19094405,19094423,19,128,107,254
"7724","chr16",19138519,19138543,25,20,13,58
"7725","chr16",19240942,19240965,24,8,117,149
"7726","chr16",19441798,19441816,19,71,117,207
"7727","chr16",19492916,19492933,18,30,47,95
"7728","chr16",19492954,19492977,24,6,9,39
"7729","chr16",19562092,19562115,24,104,21,149
"7730","chr16",19612240,19612268,29,42,98,169
"7731","chr16",19645284,19645307,24,8,104,136
"7732","chr16",19814221,19814246,26,68,33,127
"7733","chr16",19884915,19884937,23,37,123,183
"7734","chr16",20074898,20074969,72,2,125,199
"7735","chr16",20698190,20698212,23,119,10,152
"7736","chr16",20767517,20767545,29,143,6,178
"7737","chr16",20951739,20951762,24,9,60,93
"7738","chr16",20992342,20992362,21,7,86,114
"7739","chr16",21129568,21129587,20,145,61,226
"7740","chr16",21142055,21142081,27,144,3,174
"7741","chr16",21145112,21145130,19,48,74,141
"7742","chr16",21189232,21189256,25,69,67,161
"7743","chr16",21390373,21390400,28,75,52,155
"7744","chr16",21418987,21419036,50,53,132,235
"7745","chr16",21419082,21419106,25,123,37,185
"7746","chr16",21432003,21432025,23,18,143,184
"7747","chr16",21481454,21481481,28,145,6,179
"7748","chr16",21491898,21491920,23,145,56,224
"7749","chr16",21501824,21501855,32,27,66,125
"7750","chr16",21502002,21502019,18,4,17,39
"7751","chr16",21515177,21515225,49,52,72,173
"7752","chr16",21516639,21516668,30,45,72,147
"7753","chr16",21522573,21522600,28,8,145,181
"7754","chr16",21533742,21533759,18,7,143,168
"7755","chr16",21542100,21542117,18,74,21,113
"7756","chr16",21542977,21542995,19,149,58,226
"7757","chr16",21545370,21545388,19,57,25,101
"7758","chr16",21599903,21599930,28,6,99,133
"7759","chr16",21619588,21619609,22,29,143,194
"7760","chr16",21684721,21684767,47,74,86,207
"7761","chr16",21741956,21741980,25,75,24,124
"7762","chr16",21851257,21851316,60,53,132,245
"7763","chr16",21851362,21851386,25,123,27,175
"7764","chr16",21864281,21864301,21,18,143,182
"7765","chr16",21907847,21907869,23,16,53,92
"7766","chr16",21923388,21923410,23,145,56,224
"7767","chr16",22009805,22009837,33,73,27,133
"7768","chr16",22162447,22162464,18,38,100,156
"7769","chr16",22177628,22177681,54,31,74,159
"7770","chr16",22315663,22315691,29,78,28,135
"7771","chr16",22447314,22447336,23,58,143,224
"7772","chr16",22462857,22462879,23,55,14,92
"7773","chr16",22506879,22506901,23,145,16,184
"7774","chr16",22519798,22519822,25,39,121,185
"7775","chr16",22519869,22519917,49,134,50,233
"7776","chr16",22539494,22539511,18,13,123,154
"7777","chr16",22558078,22558102,25,75,24,124
"7778","chr16",22597226,22597243,18,17,54,89
"7779","chr16",22619588,22619609,22,29,75,126
"7780","chr16",22734277,22734302,26,39,75,140
"7781","chr16",22892111,22892131,21,136,35,192
"7782","chr16",23360785,23360809,25,5,53,83
"7783","chr16",23453666,23453700,35,8,144,187
"7784","chr16",23510871,23510888,18,64,109,191
"7785","chr16",23510907,23510948,42,22,73,137
"7786","chr16",23511017,23511050,34,124,108,266
"7787","chr16",23623502,23623529,28,74,145,247
"7788","chr16",23631280,23631305,26,63,6,95
"7789","chr16",23639518,23639537,20,11,21,52
"7790","chr16",23695723,23695747,25,4,13,42
"7791","chr16",24136850,24136893,44,6,4,54
"7792","chr16",24440767,24440787,21,58,57,136
"7793","chr16",24446191,24446230,40,44,75,159
"7794","chr16",24527824,24527846,23,45,145,213
"7795","chr16",24540059,24540079,21,20,38,79
"7796","chr16",24581101,24581122,22,83,25,130
"7797","chr16",24602279,24602306,28,119,142,289
"7798","chr16",24607606,24607631,26,105,4,135
"7799","chr16",24729669,24729723,55,3,22,80
"7800","chr16",24814386,24814426,41,76,16,133
"7801","chr16",24849594,24849623,30,21,47,98
"7802","chr16",24856598,24856621,24,78,27,129
"7803","chr16",24893292,24893316,25,147,70,242
"7804","chr16",24895491,24895519,29,14,4,47
"7805","chr16",25015438,25015484,47,50,10,107
"7806","chr16",25198849,25198919,71,43,52,166
"7807","chr16",25204710,25204732,23,48,140,211
"7808","chr16",25206620,25206654,35,69,38,142
"7809","chr16",25367495,25367513,19,78,6,103
"7810","chr16",25621445,25621640,196,69,101,366
"7811","chr16",25692306,25692349,44,14,28,86
"7812","chr16",25692380,25692402,23,44,31,98
"7813","chr16",25692439,25692466,28,108,2,138
"7814","chr16",26319380,26319402,23,31,26,80
"7815","chr16",26512960,26512985,26,73,22,121
"7816","chr16",26513797,26513839,43,5,113,161
"7817","chr16",26654119,26654141,23,29,75,127
"7818","chr16",26743669,26743692,24,8,4,36
"7819","chr16",26975861,26975881,21,29,69,119
"7820","chr16",27053868,27053902,35,16,74,125
"7821","chr16",27067473,27067491,19,24,87,130
"7822","chr16",27108814,27108858,45,99,74,218
"7823","chr16",27149158,27149183,26,13,25,64
"7824","chr16",27236293,27236316,24,78,48,150
"7825","chr16",27336677,27336696,20,47,75,142
"7826","chr16",27343407,27343438,32,70,63,165
"7827","chr16",27385178,27385223,46,5,111,162
"7828","chr16",27549630,27549649,20,74,84,178
"7829","chr16",27564747,27564778,32,5,137,174
"7830","chr16",27616369,27616386,18,90,68,176
"7831","chr16",27690141,27690163,23,24,33,80
"7832","chr16",27734695,27734712,18,120,10,148
"7833","chr16",27855720,27855740,21,8,19,48
"7834","chr16",28006296,28006327,32,77,113,222
"7835","chr16",28063197,28063234,38,86,68,192
"7836","chr16",28160185,28160211,27,50,74,151
"7837","chr16",28246052,28246084,33,122,33,188
"7838","chr16",28265417,28265435,19,145,8,172
"7839","chr16",28270407,28270440,34,6,102,142
"7840","chr16",28277801,28277818,18,66,48,132
"7841","chr16",28296093,28296113,21,77,25,123
"7842","chr16",28320763,28320823,61,2,3,66
"7843","chr16",28321177,28321238,62,91,27,180
"7844","chr16",28330675,28330727,53,75,52,180
"7845","chr16",28356704,28356787,84,56,133,273
"7846","chr16",28374558,28374575,18,86,7,111
"7847","chr16",28384150,28384170,21,6,49,76
"7848","chr16",28411039,28411061,23,76,20,119
"7849","chr16",28437269,28437289,21,73,137,231
"7850","chr16",28469601,28469619,19,32,39,90
"7851","chr16",28470542,28470658,117,59,132,308
"7852","chr16",28490760,28490780,21,140,6,167
"7853","chr16",28499851,28499894,44,4,106,154
"7854","chr16",28553720,28553741,22,57,1,80
"7855","chr16",28556340,28556362,23,73,27,123
"7856","chr16",28599025,28599047,23,119,70,212
"7857","chr16",28607975,28608005,31,8,48,87
"7858","chr16",28612019,28612041,23,119,70,212
"7859","chr16",28618340,28618363,24,76,134,234
"7860","chr16",28623786,28623812,27,53,28,108
"7861","chr16",28644351,28644375,25,28,121,174
"7862","chr16",28644421,28644487,67,140,51,258
"7863","chr16",28677720,28677740,21,139,71,231
"7864","chr16",28704255,28704277,23,22,74,119
"7865","chr16",28731139,28731160,22,51,4,77
"7866","chr16",28740705,28740728,24,9,84,117
"7867","chr16",28758450,28758474,25,8,121,154
"7868","chr16",28758518,28758600,83,134,53,270
"7869","chr16",28791895,28791915,21,139,71,231
"7870","chr16",28811545,28811568,24,6,41,71
"7871","chr16",28811858,28811876,19,87,5,111
"7872","chr16",28812000,28812022,23,81,90,194
"7873","chr16",28822936,28822959,24,88,96,208
"7874","chr16",28855629,28855650,22,38,37,97
"7875","chr16",28862613,28862633,21,8,132,161
"7876","chr16",28863894,28863918,25,20,103,148
"7877","chr16",28868440,28868475,36,74,10,120
"7878","chr16",28882101,28882126,26,23,146,195
"7879","chr16",28906772,28906810,39,133,36,208
"7880","chr16",28906961,28906984,24,39,17,80
"7881","chr16",28925338,28925367,30,17,32,79
"7882","chr16",28998001,28998024,24,23,6,53
"7883","chr16",29010247,29010271,25,127,28,180
"7884","chr16",29038408,29038432,25,15,121,161
"7885","chr16",29038447,29038552,106,135,82,323
"7886","chr16",29071972,29071995,24,29,143,196
"7887","chr16",29107381,29107414,34,31,84,149
"7888","chr16",29119802,29119827,26,32,128,186
"7889","chr16",29143447,29143472,26,61,61,148
"7890","chr16",29168443,29168478,36,40,75,151
"7891","chr16",29239096,29239121,26,76,145,247
"7892","chr16",29369504,29369531,28,75,52,155
"7893","chr16",29397746,29397795,50,68,132,250
"7894","chr16",29397770,29397825,56,98,108,262
"7895","chr16",29450809,29451142,334,59,7,400
"7896","chr16",29468390,29468415,26,76,20,122
"7897","chr16",29499501,29499544,44,53,132,229
"7898","chr16",29499590,29499614,25,123,43,191
"7899","chr16",29512492,29512511,20,18,143,181
"7900","chr16",29574211,29574232,22,126,73,221
"7901","chr16",29595078,29595123,46,115,21,182
"7902","chr16",29596330,29596425,96,129,39,264
"7903","chr16",29601368,29601397,30,20,120,170
"7904","chr16",29608449,29608495,47,50,72,169
"7905","chr16",29609916,29609945,30,45,72,147
"7906","chr16",29621721,29621739,19,75,133,227
"7907","chr16",29628073,29628090,18,74,21,113
"7908","chr16",29628950,29628968,19,149,58,226
"7909","chr16",29631344,29631366,23,58,25,106
"7910","chr16",29648607,29648633,27,76,68,171
"7911","chr16",29660233,29660266,34,104,2,140
"7912","chr16",29678092,29678110,19,10,143,172
"7913","chr16",29695244,29695264,21,129,90,240
"7914","chr16",29703409,29703452,44,149,30,223
"7915","chr16",29747581,29747605,25,70,16,111
"7916","chr16",29752306,29752335,30,8,41,79
"7917","chr16",29761504,29761522,19,9,74,102
"7918","chr16",29762520,29762539,20,81,19,120
"7919","chr16",29806402,29806427,26,26,17,69
"7920","chr16",29806405,29806456,52,55,14,121
"7921","chr16",29879214,29879239,26,72,134,232
"7922","chr16",29887468,29887485,18,29,75,122
"7923","chr16",29890922,29890955,34,54,69,157
"7924","chr16",29954597,29954647,51,81,4,136
"7925","chr16",29960837,29960863,27,60,24,111
"7926","chr16",29983204,29983244,41,64,39,144
"7927","chr16",30019902,30019926,25,8,75,108
"7928","chr16",30031150,30031170,21,82,9,112
"7929","chr16",30035736,30035763,28,59,90,177
"7930","chr16",30037084,30037118,35,5,75,115
"7931","chr16",30052699,30052747,49,6,4,59
"7932","chr16",30054315,30054345,31,34,79,144
"7933","chr16",30076007,30076031,25,103,7,135
"7934","chr16",30107987,30108017,31,8,77,116
"7935","chr16",30108030,30108058,29,49,34,112
"7936","chr16",30115074,30115091,18,145,35,198
"7937","chr16",30178249,30178279,31,136,6,173
"7938","chr16",30183655,30183689,35,83,18,136
"7939","chr16",30190096,30190484,389,59,59,507
"7940","chr16",30207736,30207759,24,76,20,120
"7941","chr16",30239469,30239512,44,53,132,229
"7942","chr16",30239558,30239582,25,123,43,191
"7943","chr16",30252474,30252492,19,18,143,180
"7944","chr16",30297824,30297846,23,8,5,36
"7945","chr16",30313321,30313343,23,145,56,224
"7946","chr16",30313925,30313946,22,126,73,221
"7947","chr16",30369936,30369970,35,14,71,120
"7948","chr16",30378854,30378902,49,5,123,177
"7949","chr16",30386940,30386960,21,121,101,243
"7950","chr16",30388894,30388937,44,106,6,156
"7951","chr16",30406498,30406527,30,77,86,193
"7952","chr16",30414947,30414975,29,76,143,248
"7953","chr16",30478341,30478366,26,97,67,190
"7954","chr16",30507904,30507923,20,33,28,81
"7955","chr16",30519928,30519945,18,117,53,188
"7956","chr16",30533752,30533769,18,62,27,107
"7957","chr16",30533931,30533949,19,53,77,149
"7958","chr16",30586576,30586599,24,76,74,174
"7959","chr16",30590735,30590770,36,75,102,213
"7960","chr16",30613252,30613278,27,77,85,189
"7961","chr16",30626084,30626105,22,147,73,242
"7962","chr16",30636272,30636294,23,11,59,93
"7963","chr16",30638808,30638838,31,146,6,183
"7964","chr16",30664822,30664848,27,7,129,163
"7965","chr16",30669193,30669242,50,104,81,235
"7966","chr16",30679895,30679932,38,42,68,148
"7967","chr16",30687035,30687064,30,122,2,154
"7968","chr16",30698719,30698742,24,26,20,70
"7969","chr16",30705372,30705404,33,64,9,106
"7970","chr16",30735568,30735589,22,67,23,112
"7971","chr16",30799202,30799221,20,69,115,204
"7972","chr16",30799514,30799534,21,14,7,42
"7973","chr16",30814728,30814763,36,51,64,151
"7974","chr16",30814764,30814794,31,82,28,141
"7975","chr16",30817176,30817196,21,7,143,171
"7976","chr16",30822643,30822662,20,76,8,104
"7977","chr16",30844042,30844069,28,147,74,249
"7978","chr16",30878179,30878197,19,96,2,117
"7979","chr16",30890988,30891010,23,134,71,228
"7980","chr16",30931894,30931912,19,33,75,127
"7981","chr16",30979860,30979911,52,1,29,82
"7982","chr16",31010525,31010547,23,99,74,196
"7983","chr16",31057153,31057178,26,8,93,127
"7984","chr16",31063097,31063131,35,17,3,55
"7985","chr16",31069771,31069792,22,8,144,174
"7986","chr16",31093700,31093726,27,78,27,132
"7987","chr16",31095332,31095354,23,81,6,110
"7988","chr16",31134677,31134707,31,69,119,219
"7989","chr16",31202229,31202246,18,95,45,158
"7990","chr16",31220457,31220486,30,76,27,133
"7991","chr16",31230726,31230744,19,99,6,124
"7992","chr16",31437620,31437638,19,4,131,154
"7993","chr16",31442302,31442336,35,6,127,168
"7994","chr16",32020854,32020880,27,76,147,250
"7995","chr16",32187440,32187457,18,76,26,120
"7996","chr16",32191663,32191693,31,77,27,135
"7997","chr16",32202516,32202552,37,1,102,140
"7998","chr16",32726880,32726916,37,104,141,282
"7999","chr16",32737749,32737776,28,29,75,132
"8000","chr16",32741970,32741987,18,28,74,120
"8001","chr16",32964415,32964444,30,76,147,253
"8002","chr16",33128421,33128438,18,76,26,120
"8003","chr16",33132636,33132663,28,77,27,132
"8004","chr16",33143492,33143528,37,1,102,140
"8005","chr16",33547165,33547191,27,14,73,114
"8006","chr16",33555463,33555489,27,47,48,122
"8007","chr16",33889510,33889539,30,149,74,253
"8008","chr16",34133716,34133762,47,51,29,127
"8009","chr16",34140529,34140608,80,16,5,101
"8010","chr16",34148020,34148043,24,36,128,188
"8011","chr16",34148043,34148074,32,15,105,152
"8012","chr16",34423459,34423479,21,3,41,65
"8013","chr16",34439450,34439472,23,63,6,92
"8014","chr16",34972364,34972386,23,8,61,92
"8015","chr16",34988358,34988378,21,43,1,65
"8016","chr16",35143467,35143491,25,8,135,168
"8017","chr16",35145772,35145799,28,53,59,140
"8018","chr16",46568396,46568441,46,38,56,140
"8019","chr16",46836060,46836083,24,29,6,59
"8020","chr16",46875805,46875843,39,110,69,218
"8021","chr16",46935312,46935334,23,34,76,133
"8022","chr16",46970731,46970756,26,13,11,50
"8023","chr16",47020670,47020691,22,38,132,192
"8024","chr16",47144025,47144049,25,4,25,54
"8025","chr16",47974958,47974990,33,7,120,160
"8026","chr16",48060393,48060410,18,27,143,188
"8027","chr16",48385381,48385399,19,5,1,25
"8028","chr16",48386509,48386532,24,141,4,169
"8029","chr16",48500863,48500881,19,13,91,123
"8030","chr16",48542155,48542173,19,143,137,299
"8031","chr16",48805639,48805674,36,42,7,85
"8032","chr16",49281769,49281793,25,14,46,85
"8033","chr16",49465035,49465054,20,12,97,129
"8034","chr16",49492462,49492501,40,33,6,79
"8035","chr16",49803934,49803955,22,78,126,226
"8036","chr16",49845525,49845559,35,77,116,228
"8037","chr16",49855515,49855622,108,56,33,197
"8038","chr16",49855667,49855692,26,4,36,66
"8039","chr16",49855677,49855708,32,20,26,78
"8040","chr16",49856114,49856143,30,28,2,60
"8041","chr16",49856231,49856256,26,20,3,49
"8042","chr16",49856918,49856935,18,13,53,84
"8043","chr16",49857307,49857327,21,86,12,119
"8044","chr16",49866951,49866977,27,66,88,181
"8045","chr16",49872600,49872618,19,9,48,76
"8046","chr16",49896509,49896545,37,145,4,186
"8047","chr16",49957888,49957948,61,108,42,211
"8048","chr16",50044592,50044626,35,77,78,190
"8049","chr16",50139388,50139410,23,140,122,285
"8050","chr16",50152773,50152795,23,82,21,126
"8051","chr16",50153278,50153300,23,2,2,27
"8052","chr16",50153316,50153336,21,38,50,109
"8053","chr16",50153489,50153536,48,99,100,247
"8054","chr16",50153558,50153575,18,138,31,187
"8055","chr16",50153836,50153864,29,24,112,165
"8056","chr16",50183040,50183058,19,5,87,111
"8057","chr16",50191919,50191942,24,129,6,159
"8058","chr16",50193332,50193353,22,6,108,136
"8059","chr16",50245954,50245988,35,87,14,136
"8060","chr16",50246028,50246072,45,82,28,155
"8061","chr16",50548668,50548699,32,106,17,155
"8062","chr16",50657022,50657045,24,75,73,172
"8063","chr16",50689008,50689036,29,49,130,208
"8064","chr16",50693580,50693613,34,34,32,100
"8065","chr16",51066202,51066226,25,51,6,82
"8066","chr16",51135018,51135046,29,7,119,155
"8067","chr16",51151315,51151334,20,10,9,39
"8068","chr16",51151709,51151739,31,32,7,70
"8069","chr16",51153020,51153037,18,32,38,88
"8070","chr16",51165682,51165709,28,11,128,167
"8071","chr16",51626114,51626135,22,37,143,202
"8072","chr16",51626372,51626390,19,85,27,131
"8073","chr16",51732949,51732969,21,145,26,192
"8074","chr16",52547069,52547087,19,47,24,90
"8075","chr16",53131312,53131334,23,41,49,113
"8076","chr16",53412186,53412229,44,74,139,257
"8077","chr16",53413766,53413786,21,7,141,169
"8078","chr16",53413942,53413962,21,33,70,124
"8079","chr16",53503259,53503283,25,45,21,91
"8080","chr16",53565267,53565289,23,31,15,69
"8081","chr16",53694433,53694466,34,13,78,125
"8082","chr16",53732042,53732066,25,8,43,76
"8083","chr16",53783605,53783627,23,21,77,121
"8084","chr16",54284700,54284719,20,66,13,99
"8085","chr16",54286211,54286243,33,32,30,95
"8086","chr16",54497083,54497115,33,75,140,248
"8087","chr16",54626734,54626758,25,144,6,175
"8088","chr16",54869617,54869637,21,8,67,96
"8089","chr16",54877076,54877099,24,60,73,157
"8090","chr16",54910123,54910144,22,36,74,132
"8091","chr16",54930946,54930964,19,1,13,33
"8092","chr16",54931410,54931432,23,93,114,230
"8093","chr16",55156285,55156303,19,9,44,72
"8094","chr16",55325449,55325621,173,54,19,246
"8095","chr16",55479278,55479299,22,112,36,170
"8096","chr16",56191751,56191796,46,84,24,154
"8097","chr16",56191765,56191808,44,96,10,150
"8098","chr16",56402335,56402358,24,116,7,147
"8099","chr16",56425421,56425457,37,82,103,222
"8100","chr16",56425449,56425472,24,97,75,196
"8101","chr16",56540839,56540857,19,69,6,94
"8102","chr16",56624587,56624611,25,106,45,176
"8103","chr16",56632534,56632551,18,32,19,69
"8104","chr16",56676412,56676460,49,9,20,78
"8105","chr16",56853695,56853719,25,111,65,201
"8106","chr16",56873690,56873720,31,67,7,105
"8107","chr16",56902767,56902790,24,74,8,106
"8108","chr16",56966567,56966614,48,5,54,107
"8109","chr16",57006414,57006436,23,82,78,183
"8110","chr16",57092565,57092585,21,11,6,38
"8111","chr16",57185903,57185977,75,15,72,162
"8112","chr16",57230006,57230028,23,76,11,110
"8113","chr16",57294516,57294536,21,79,27,127
"8114","chr16",57304810,57304844,35,73,49,157
"8115","chr16",57368578,57368606,29,51,35,115
"8116","chr16",57370197,57370223,27,113,144,284
"8117","chr16",57378459,57378481,23,76,1,100
"8118","chr16",57416830,57416879,50,105,32,187
"8119","chr16",57493389,57493421,33,36,141,210
"8120","chr16",57525076,57525113,38,76,17,131
"8121","chr16",57586105,57586129,25,7,139,171
"8122","chr16",57612868,57612908,41,76,112,229
"8123","chr16",57671333,57671357,25,7,107,139
"8124","chr16",57744719,57744802,84,61,69,214
"8125","chr16",57768173,57768195,23,76,43,142
"8126","chr16",57870635,57870652,18,3,74,95
"8127","chr16",57899331,57899348,18,3,76,97
"8128","chr16",57932571,57932594,24,4,142,170
"8129","chr16",57986585,57986611,27,76,14,117
"8130","chr16",58064078,58064095,18,48,17,83
"8131","chr16",58094775,58094796,22,17,76,115
"8132","chr16",58102417,58102444,28,8,144,180
"8133","chr16",58197841,58197859,19,54,14,87
"8134","chr16",58198097,58198123,27,23,9,59
"8135","chr16",58198231,58198264,34,2,47,83
"8136","chr16",58328299,58328351,53,100,34,187
"8137","chr16",58516125,58516152,28,29,7,64
"8138","chr16",58526512,58526537,26,143,75,244
"8139","chr16",58604797,58604845,49,138,6,193
"8140","chr16",58631194,58631216,23,12,6,41
"8141","chr16",58632999,58633031,33,41,72,146
"8142","chr16",58668714,58668747,34,34,72,140
"8143","chr16",58728850,58728867,18,36,141,195
"8144","chr16",58733480,58733498,19,7,124,150
"8145","chr16",59012817,59012849,33,122,140,295
"8146","chr16",59147247,59147265,19,113,71,203
"8147","chr16",59676303,59676328,26,127,65,218
"8148","chr16",59822176,59822197,22,63,75,160
"8149","chr16",59942824,59942844,21,78,35,134
"8150","chr16",60171590,60171618,29,146,8,183
"8151","chr16",60250283,60250307,25,75,122,222
"8152","chr16",60370350,60370375,26,77,77,180
"8153","chr16",60434691,60434735,45,75,145,265
"8154","chr16",60667554,60667571,18,34,43,95
"8155","chr16",60712833,60712867,35,130,76,241
"8156","chr16",61168288,61168316,29,11,6,46
"8157","chr16",62028062,62028081,20,7,44,71
"8158","chr16",62220845,62220872,28,9,85,122
"8159","chr16",62348886,62348905,20,8,31,59
"8160","chr16",62845536,62845562,27,35,69,131
"8161","chr16",63290366,63290386,21,145,25,191
"8162","chr16",63291692,63291717,26,19,73,118
"8163","chr16",63675978,63676039,62,30,4,96
"8164","chr16",64207570,64207587,18,78,24,120
"8165","chr16",65341029,65341053,25,27,6,58
"8166","chr16",65472740,65472781,42,91,76,209
"8167","chr16",65916801,65916863,63,51,17,131
"8168","chr16",66427131,66427160,30,95,30,155
"8169","chr16",66427238,66427255,18,16,28,62
"8170","chr16",66427343,66427392,50,2,23,75
"8171","chr16",66469784,66469829,46,148,138,332
"8172","chr16",66504759,66504787,29,110,6,145
"8173","chr16",66604813,66604843,31,94,70,195
"8174","chr16",66696594,66696631,38,100,91,229
"8175","chr16",66696880,66696906,27,67,60,154
"8176","chr16",66713891,66713925,35,74,146,255
"8177","chr16",66765850,66765882,33,69,53,155
"8178","chr16",66820901,66820919,19,77,6,102
"8179","chr16",66877921,66877948,28,43,6,77
"8180","chr16",66894907,66894939,33,73,74,180
"8181","chr16",66915899,66915943,45,15,3,63
"8182","chr16",66924668,66924701,34,80,3,117
"8183","chr16",66945431,66945467,37,54,75,166
"8184","chr16",66982113,66982145,33,29,104,166
"8185","chr16",67013883,67013901,19,119,57,195
"8186","chr16",67022019,67022038,20,9,135,164
"8187","chr16",67029118,67029213,96,59,75,230
"8188","chr16",67108340,67108362,23,113,49,185
"8189","chr16",67109988,67110017,30,13,61,104
"8190","chr16",67118767,67118792,26,25,7,58
"8191","chr16",67119687,67119707,21,35,108,164
"8192","chr16",67133502,67133522,21,145,24,190
"8193","chr16",67155134,67155151,18,15,23,56
"8194","chr16",67161442,67161467,26,70,75,171
"8195","chr16",67164552,67164587,36,30,69,135
"8196","chr16",67164556,67164607,52,50,65,167
"8197","chr16",67189250,67189294,45,76,38,159
"8198","chr16",67192185,67192202,18,77,104,199
"8199","chr16",67195891,67195947,57,144,121,322
"8200","chr16",67233072,67233101,30,73,130,233
"8201","chr16",67266895,67266921,27,18,91,136
"8202","chr16",67325916,67325935,20,67,25,112
"8203","chr16",67351038,67351068,31,116,6,153
"8204","chr16",67416368,67416420,53,12,37,102
"8205","chr16",67431041,67431085,45,26,59,130
"8206","chr16",67510988,67511012,25,44,143,212
"8207","chr16",67555254,67555303,50,42,4,96
"8208","chr16",67562922,67562944,23,25,17,65
"8209","chr16",67612589,67612616,28,113,75,216
"8210","chr16",67627923,67627944,22,76,59,157
"8211","chr16",67672226,67672279,54,29,2,85
"8212","chr16",67755684,67755707,24,101,6,131
"8213","chr16",67768524,67768565,42,125,71,238
"8214","chr16",67776462,67776486,25,8,6,39
"8215","chr16",67819646,67819664,19,75,73,167
"8216","chr16",67819816,67819837,22,9,74,105
"8217","chr16",67846949,67846966,18,18,17,53
"8218","chr16",67849644,67849671,28,71,142,241
"8219","chr16",67896536,67896559,24,75,18,117
"8220","chr16",67904822,67904844,23,8,89,120
"8221","chr16",67980293,67980323,31,26,64,121
"8222","chr16",67980837,67980895,59,70,47,176
"8223","chr16",67993133,67993155,23,81,65,169
"8224","chr16",67997339,67997373,35,7,4,46
"8225","chr16",68012111,68012128,18,76,35,129
"8226","chr16",68020548,68020567,20,9,146,175
"8227","chr16",68124417,68124448,32,4,140,176
"8228","chr16",68195810,68195832,23,87,4,114
"8229","chr16",68239280,68239307,28,114,111,253
"8230","chr16",68240569,68240600,32,73,10,115
"8231","chr16",68251858,68251877,20,102,8,130
"8232","chr16",68255091,68255108,18,23,122,163
"8233","chr16",68277926,68277947,22,49,101,172
"8234","chr16",68392836,68392855,20,77,31,128
"8235","chr16",68515315,68515362,48,79,69,196
"8236","chr16",68515326,68515368,43,85,58,186
"8237","chr16",68515373,68515394,22,111,11,144
"8238","chr16",68539679,68539713,35,1,39,75
"8239","chr16",68596094,68596128,35,77,17,129
"8240","chr16",68630578,68630596,19,76,12,107
"8241","chr16",68635387,68635418,32,13,75,120
"8242","chr16",68644736,68644758,23,78,15,116
"8243","chr16",68653229,68653255,27,8,84,119
"8244","chr16",68653669,68653707,39,8,13,60
"8245","chr16",68683652,68683685,34,47,74,155
"8246","chr16",68688617,68688644,28,76,45,149
"8247","chr16",68724069,68724086,18,145,6,169
"8248","chr16",68760087,68760116,30,75,74,179
"8249","chr16",68837246,68837280,35,27,143,205
"8250","chr16",68837414,68837432,19,6,140,165
"8251","chr16",68848000,68848019,20,28,25,73
"8252","chr16",68866976,68867000,25,129,35,189
"8253","chr16",69060596,69060623,28,73,73,174
"8254","chr16",69075763,69075782,20,74,108,202
"8255","chr16",69096535,69096564,30,5,75,110
"8256","chr16",69127602,69127625,24,6,143,173
"8257","chr16",69147002,69147020,19,70,7,96
"8258","chr16",69147179,69147222,44,148,72,264
"8259","chr16",69162712,69162739,28,145,74,247
"8260","chr16",69178795,69178829,35,20,6,61
"8261","chr16",69185884,69185902,19,7,114,140
"8262","chr16",69232195,69232223,29,8,117,154
"8263","chr16",69232503,69232529,27,76,13,116
"8264","chr16",69241169,69241194,26,8,136,170
"8265","chr16",69253648,69253671,24,84,7,115
"8266","chr16",69297307,69297334,28,144,74,246
"8267","chr16",69318788,69318806,19,88,41,148
"8268","chr16",69358012,69358031,20,9,141,170
"8269","chr16",69424067,69424090,24,16,6,46
"8270","chr16",69489013,69489036,24,74,56,154
"8271","chr16",69563439,69563473,35,7,38,80
"8272","chr16",69657759,69657777,19,121,74,214
"8273","chr16",69713872,69713894,23,9,75,107
"8274","chr16",69714879,69714900,22,86,6,114
"8275","chr16",69725875,69725908,34,129,73,236
"8276","chr16",69778943,69778964,22,5,147,174
"8277","chr16",69784069,69784116,48,7,5,60
"8278","chr16",69826572,69826593,22,143,6,171
"8279","chr16",69862058,69862083,26,8,70,104
"8280","chr16",69953813,69953832,20,23,100,143
"8281","chr16",69999786,69999809,24,8,12,44
"8282","chr16",70009640,70009662,23,5,131,159
"8283","chr16",70055719,70055743,25,126,74,225
"8284","chr16",70075470,70075560,91,105,3,199
"8285","chr16",70097642,70097683,42,10,6,58
"8286","chr16",70150092,70150120,29,75,9,113
"8287","chr16",70288099,70288120,22,76,111,209
"8288","chr16",70290092,70290118,27,10,18,55
"8289","chr16",70311050,70311068,19,124,24,167
"8290","chr16",70322589,70322611,23,147,57,227
"8291","chr16",70342583,70342603,21,10,45,76
"8292","chr16",70369174,70369198,25,77,138,240
"8293","chr16",70377480,70377497,18,102,6,126
"8294","chr16",70382052,70382071,20,109,59,188
"8295","chr16",70385699,70385721,23,76,93,192
"8296","chr16",70389766,70389805,40,9,93,142
"8297","chr16",70402284,70402308,25,98,21,144
"8298","chr16",70413561,70413586,26,108,26,160
"8299","chr16",70429639,70429658,20,7,24,51
"8300","chr16",70438648,70438680,33,2,50,85
"8301","chr16",70439018,70439048,31,19,30,80
"8302","chr16",70439132,70439150,19,27,9,55
"8303","chr16",70440943,70440973,31,146,3,180
"8304","chr16",70502281,70502310,30,145,75,250
"8305","chr16",70536349,70536381,33,7,61,101
"8306","chr16",70591571,70591589,19,18,4,41
"8307","chr16",70608115,70608146,32,76,48,156
"8308","chr16",70730595,70730614,20,75,17,112
"8309","chr16",70795312,70795336,25,137,26,188
"8310","chr16",70818912,70818932,21,77,105,203
"8311","chr16",70853012,70853031,20,145,33,198
"8312","chr16",71130471,71130498,28,69,147,244
"8313","chr16",71380255,71380282,28,32,92,152
"8314","chr16",71380288,71380327,40,9,59,108
"8315","chr16",71388998,71389017,20,56,74,150
"8316","chr16",71613910,71613932,23,35,135,193
"8317","chr16",71648772,71648805,34,42,6,82
"8318","chr16",71684126,71684144,19,77,111,207
"8319","chr16",71719965,71719988,24,78,75,177
"8320","chr16",71723726,71723749,24,5,29,58
"8321","chr16",71736547,71736601,55,6,144,205
"8322","chr16",71782467,71782502,36,74,7,117
"8323","chr16",71831072,71831099,28,76,95,199
"8324","chr16",71831260,71831291,32,144,64,240
"8325","chr16",71837161,71837181,21,98,70,189
"8326","chr16",71889676,71889727,52,120,3,175
"8327","chr16",71891996,71892021,26,70,74,170
"8328","chr16",71892572,71892589,18,75,5,98
"8329","chr16",72026960,72027010,51,72,73,196
"8330","chr16",72135360,72135378,19,17,58,94
"8331","chr16",72225543,72225561,19,26,19,64
"8332","chr16",72437603,72437628,26,146,6,178
"8333","chr16",72554675,72554694,20,63,71,154
"8334","chr16",72595790,72595809,20,77,3,100
"8335","chr16",72967761,72967778,18,77,27,122
"8336","chr16",73057536,73057583,48,60,94,202
"8337","chr16",73058240,73058266,27,30,19,76
"8338","chr16",73058654,73058728,75,38,39,152
"8339","chr16",73058869,73058891,23,102,34,159
"8340","chr16",73072877,73072895,19,57,118,194
"8341","chr16",73096162,73096195,34,82,59,175
"8342","chr16",73116121,73116138,18,36,5,59
"8343","chr16",73147692,73147720,29,108,6,143
"8344","chr16",73172646,73172672,27,90,141,258
"8345","chr16",73260681,73260707,27,15,108,150
"8346","chr16",73288170,73288189,20,59,12,91
"8347","chr16",73444956,73444981,26,73,35,134
"8348","chr16",73483299,73483369,71,136,37,244
"8349","chr16",73537315,73537341,27,15,116,158
"8350","chr16",73591355,73591388,34,124,4,162
"8351","chr16",73651681,73651708,28,80,28,136
"8352","chr16",73865985,73866019,35,75,6,116
"8353","chr16",74266260,74266280,21,132,74,227
"8354","chr16",74334237,74334255,19,11,3,33
"8355","chr16",74377710,74377737,28,7,124,159
"8356","chr16",74377790,74377870,81,134,44,259
"8357","chr16",74420941,74420973,33,60,82,175
"8358","chr16",74461467,74461488,22,76,5,103
"8359","chr16",74473438,74473455,18,74,18,110
"8360","chr16",74502723,74502743,21,29,131,181
"8361","chr16",74585710,74585727,18,94,4,116
"8362","chr16",74597852,74597869,18,80,8,106
"8363","chr16",74606842,74606878,37,10,104,151
"8364","chr16",74620977,74620997,21,147,75,243
"8365","chr16",74665737,74665759,23,71,28,122
"8366","chr16",74720181,74720211,31,34,34,99
"8367","chr16",74740621,74740670,50,36,73,159
"8368","chr16",74783595,74783619,25,21,145,191
"8369","chr16",74917809,74917832,24,8,74,106
"8370","chr16",74925303,74925320,18,3,104,125
"8371","chr16",74945816,74945835,20,8,93,121
"8372","chr16",74951160,74951181,22,54,6,82
"8373","chr16",75016700,75016719,20,30,33,83
"8374","chr16",75096062,75096101,40,8,2,50
"8375","chr16",75163295,75163320,26,67,57,150
"8376","chr16",75178920,75178947,28,66,5,99
"8377","chr16",75224994,75225025,32,19,133,184
"8378","chr16",75269204,75269228,25,30,75,130
"8379","chr16",75328145,75328164,20,9,30,59
"8380","chr16",75335555,75335575,21,9,50,80
"8381","chr16",75352008,75352038,31,91,74,196
"8382","chr16",75367793,75367811,19,136,6,161
"8383","chr16",75393738,75393773,36,137,67,240
"8384","chr16",75422397,75422417,21,81,10,112
"8385","chr16",75431455,75431492,38,81,73,192
"8386","chr16",75454460,75454482,23,142,30,195
"8387","chr16",75469418,75469442,25,13,6,44
"8388","chr16",75469723,75469746,24,77,7,108
"8389","chr16",75490174,75490196,23,147,73,243
"8390","chr16",75496283,75496300,18,11,74,103
"8391","chr16",75516837,75516855,19,82,104,205
"8392","chr16",75518010,75518035,26,3,7,36
"8393","chr16",75518267,75518289,23,37,66,126
"8394","chr16",75566391,75566411,21,20,77,118
"8395","chr16",75574863,75574883,21,78,77,176
"8396","chr16",75623523,75623544,22,74,74,170
"8397","chr16",75672489,75672507,19,13,108,140
"8398","chr16",75700502,75700522,21,43,5,69
"8399","chr16",75749427,75749448,22,77,29,128
"8400","chr16",76200560,76200577,18,34,124,176
"8401","chr16",77665884,77665901,18,36,69,123
"8402","chr16",77826023,77826049,27,69,6,102
"8403","chr16",77833750,77833771,22,30,99,151
"8404","chr16",77856014,77856045,32,79,10,121
"8405","chr16",77884424,77884452,29,37,73,139
"8406","chr16",77962724,77962778,55,10,30,95
"8407","chr16",78030153,78030171,19,15,74,108
"8408","chr16",78100244,78100270,27,144,7,178
"8409","chr16",78195822,78195851,30,55,119,204
"8410","chr16",78248865,78248885,21,56,145,222
"8411","chr16",78730618,78730638,21,121,144,286
"8412","chr16",79598582,79598638,57,61,2,120
"8413","chr16",79599176,79599227,52,43,14,109
"8414","chr16",79599320,79599361,42,36,70,148
"8415","chr16",79599909,79599934,26,81,36,143
"8416","chr16",79702620,79702657,38,6,89,133
"8417","chr16",79770586,79770603,18,19,105,142
"8418","chr16",80506203,80506242,40,122,40,202
"8419","chr16",80804012,80804031,20,58,131,209
"8420","chr16",80804055,80804074,20,27,88,135
"8421","chr16",80804080,80804110,31,12,63,106
"8422","chr16",80804394,80804416,23,3,5,31
"8423","chr16",80926913,80926930,18,75,11,104
"8424","chr16",81016781,81016807,27,76,55,158
"8425","chr16",81036304,81036327,24,52,69,145
"8426","chr16",81119818,81119839,22,7,12,41
"8427","chr16",81131224,81131241,18,119,6,143
"8428","chr16",81157255,81157275,21,78,35,134
"8429","chr16",81191198,81191218,21,69,115,205
"8430","chr16",81364690,81364707,18,38,5,61
"8431","chr16",81418563,81418593,31,7,90,128
"8432","chr16",81419302,81419328,27,19,116,162
"8433","chr16",81432879,81432899,21,42,81,144
"8434","chr16",81434519,81434551,33,74,9,116
"8435","chr16",81444508,81444535,28,36,6,70
"8436","chr16",81504642,81504683,42,146,7,195
"8437","chr16",81589069,81589110,42,4,128,174
"8438","chr16",81594781,81594803,23,28,75,126
"8439","chr16",81629135,81629166,32,31,75,138
"8440","chr16",81640739,81640771,33,15,85,133
"8441","chr16",81726579,81726612,34,44,5,83
"8442","chr16",81729850,81729877,28,75,114,217
"8443","chr16",81769820,81769852,33,99,6,138
"8444","chr16",81779209,81779247,39,12,135,186
"8445","chr16",81843912,81843993,82,7,82,171
"8446","chr16",81844144,81844166,23,29,75,127
"8447","chr16",82113034,82113090,57,106,74,237
"8448","chr16",82486555,82486586,32,86,142,260
"8449","chr16",82494290,82494320,31,48,72,151
"8450","chr16",82627338,82627381,44,50,7,101
"8451","chr16",82713044,82713076,33,64,146,243
"8452","chr16",82844640,82844657,18,76,35,129
"8453","chr16",83136487,83136507,21,9,5,35
"8454","chr16",83312067,83312086,20,17,80,117
"8455","chr16",83329221,83329242,22,138,61,221
"8456","chr16",83508056,83508132,77,26,50,153
"8457","chr16",83518458,83518490,33,8,132,173
"8458","chr16",83880982,83881005,24,41,74,139
"8459","chr16",83957853,83957894,42,76,21,139
"8460","chr16",83964306,83964343,38,6,72,116
"8461","chr16",84013425,84013449,25,77,96,198
"8462","chr16",84143835,84143853,19,12,33,64
"8463","chr16",84504913,84504930,18,46,34,98
"8464","chr16",84573769,84573794,26,50,44,120
"8465","chr16",84616505,84616534,30,109,72,211
"8466","chr16",84630243,84630265,23,8,56,87
"8467","chr16",84636636,84636659,24,21,135,180
"8468","chr16",84648441,84648468,28,8,67,103
"8469","chr16",84653841,84653859,19,67,24,110
"8470","chr16",84676936,84676956,21,94,23,138
"8471","chr16",84678678,84678700,23,123,4,150
"8472","chr16",84702994,84703013,20,14,73,107
"8473","chr16",84720894,84720911,18,36,133,187
"8474","chr16",84842275,84842340,66,24,40,130
"8475","chr16",84863958,84864020,63,19,16,98
"8476","chr16",84878055,84878074,20,145,27,192
"8477","chr16",84908681,84908703,23,5,73,101
"8478","chr16",84917585,84917604,20,134,18,172
"8479","chr16",84927457,84927478,22,72,1,95
"8480","chr16",84936485,84936510,26,57,67,150
"8481","chr16",84948568,84948589,22,80,17,119
"8482","chr16",84969011,84969033,23,28,75,126
"8483","chr16",84985953,84985976,24,77,8,109
"8484","chr16",85011332,85011349,18,7,37,62
"8485","chr16",85104714,85104738,25,16,76,117
"8486","chr16",85115640,85115671,32,78,58,168
"8487","chr16",85169251,85169287,37,41,109,187
"8488","chr16",85169381,85169407,27,14,14,55
"8489","chr16",85235978,85236053,76,17,14,107
"8490","chr16",85320442,85320472,31,33,143,207
"8491","chr16",85416837,85416874,38,10,94,142
"8492","chr16",85443983,85444003,21,46,86,153
"8493","chr16",85477556,85477578,23,8,97,128
"8494","chr16",85479189,85479213,25,37,75,137
"8495","chr16",85545753,85545799,47,75,117,239
"8496","chr16",85554800,85554818,19,7,51,77
"8497","chr16",85557023,85557044,22,1,36,59
"8498","chr16",85565395,85565423,29,38,3,70
"8499","chr16",85567035,85567069,35,60,20,115
"8500","chr16",85611307,85611332,26,20,40,86
"8501","chr16",85612242,85612265,24,140,14,178
"8502","chr16",85620111,85620133,23,73,16,112
"8503","chr16",85627045,85627076,32,39,33,104
"8504","chr16",85651029,85651091,63,40,130,233
"8505","chr16",85652546,85652566,21,46,97,164
"8506","chr16",85700698,85700719,22,145,6,173
"8507","chr16",85710273,85710291,19,68,12,99
"8508","chr16",85732666,85732689,24,47,74,145
"8509","chr16",85740692,85740714,23,145,74,242
"8510","chr16",85755105,85755128,24,6,10,40
"8511","chr16",85769142,85769163,22,70,84,176
"8512","chr16",85920240,85920264,25,76,48,149
"8513","chr16",86079150,86079174,25,81,7,113
"8514","chr16",86178548,86178569,22,89,9,120
"8515","chr16",86335895,86335919,25,108,16,149
"8516","chr16",86497618,86497643,26,55,54,135
"8517","chr16",86510535,86510557,23,2,127,152
"8518","chr16",86510605,86510643,39,88,57,184
"8519","chr16",86512680,86512719,40,102,2,144
"8520","chr16",86562372,86562395,24,27,146,197
"8521","chr16",86568493,86568524,32,32,12,76
"8522","chr16",86576212,86576231,20,20,12,52
"8523","chr16",86594455,86594501,47,49,45,141
"8524","chr16",86760641,86760664,24,36,26,86
"8525","chr16",86859086,86859120,35,5,32,72
"8526","chr16",87166740,87166757,18,68,42,128
"8527","chr16",87345322,87345356,35,129,24,188
"8528","chr16",87363388,87363408,21,143,2,166
"8529","chr16",87375308,87375342,35,78,4,117
"8530","chr16",87380297,87380315,19,22,7,48
"8531","chr16",87400132,87400173,42,54,84,180
"8532","chr16",87412004,87412025,22,65,10,97
"8533","chr16",87431473,87431501,29,125,74,228
"8534","chr16",87492304,87492424,121,5,111,237
"8535","chr16",87492599,87492619,21,22,20,63
"8536","chr16",87492912,87492952,41,40,89,170
"8537","chr16",87562670,87562689,20,7,65,92
"8538","chr16",87579214,87579253,40,77,6,123
"8539","chr16",87587056,87587087,32,65,8,105
"8540","chr16",87588715,87588750,36,70,74,180
"8541","chr16",87602413,87602479,67,19,5,91
"8542","chr16",87602535,87602565,31,105,28,164
"8543","chr16",87604283,87604329,47,49,131,227
"8544","chr16",87613096,87613114,19,8,49,76
"8545","chr16",87618168,87618189,22,13,39,74
"8546","chr16",87637392,87637412,21,30,103,154
"8547","chr16",87637412,87637443,32,61,83,176
"8548","chr16",87662359,87662376,18,143,74,235
"8549","chr16",87667804,87667842,39,8,42,89
"8550","chr16",87677186,87677226,41,135,47,223
"8551","chr16",87705791,87705813,23,25,88,136
"8552","chr16",87721415,87721439,25,42,11,78
"8553","chr16",87753971,87753990,20,145,76,241
"8554","chr16",87777570,87777590,21,30,44,95
"8555","chr16",87778384,87778513,130,64,85,279
"8556","chr16",87792890,87792909,20,56,128,204
"8557","chr16",87796341,87796359,19,33,124,176
"8558","chr16",87796380,87796402,23,76,85,184
"8559","chr16",87826139,87826160,22,147,70,239
"8560","chr16",87836826,87836905,80,7,42,129
"8561","chr16",87899920,87899952,33,57,25,115
"8562","chr16",87908793,87908830,38,73,7,118
"8563","chr16",87940804,87940832,29,100,126,255
"8564","chr16",87951568,87951585,18,2,118,138
"8565","chr16",88063272,88063289,18,59,104,181
"8566","chr16",88079828,88079857,30,7,142,179
"8567","chr16",88134098,88134125,28,40,75,143
"8568","chr16",88135749,88135778,30,8,18,56
"8569","chr16",88167054,88167077,24,6,67,97
"8570","chr16",88443430,88443463,34,138,36,208
"8571","chr16",88447990,88448037,48,12,16,76
"8572","chr16",88502066,88502111,46,61,44,151
"8573","chr16",88533626,88533648,23,128,8,159
"8574","chr16",88534271,88534291,21,52,14,87
"8575","chr16",88623975,88623993,19,50,137,206
"8576","chr16",88680276,88680304,29,9,78,116
"8577","chr16",88730598,88730620,23,7,6,36
"8578","chr16",88752863,88752914,52,107,49,208
"8579","chr16",88765669,88765688,20,5,44,69
"8580","chr16",88786569,88786608,40,137,6,183
"8581","chr16",88880226,88880260,35,17,136,188
"8582","chr16",88914975,88914992,18,139,144,301
"8583","chr16",88978131,88978150,20,63,83,166
"8584","chr16",89033239,89033260,22,6,10,38
"8585","chr16",89038396,89038421,26,49,52,127
"8586","chr16",89073165,89073192,28,126,36,190
"8587","chr16",89137079,89137096,18,13,136,167
"8588","chr16",89139580,89139610,31,76,4,111
"8589","chr16",89171343,89171376,34,14,26,74
"8590","chr16",89235995,89236018,24,68,35,127
"8591","chr16",89240635,89240658,24,50,8,82
"8592","chr16",89249064,89249083,20,37,115,172
"8593","chr16",89258554,89258573,20,8,39,67
"8594","chr16",89356781,89356812,32,52,74,158
"8595","chr16",89387673,89387710,38,137,74,249
"8596","chr16",89479943,89479961,19,145,6,170
"8597","chr16",89490351,89490369,19,4,126,149
"8598","chr16",89497644,89497670,27,135,36,198
"8599","chr16",89501011,89501031,21,129,6,156
"8600","chr16",89514491,89514516,26,6,23,55
"8601","chr16",89547607,89547629,23,7,35,65
"8602","chr16",89587145,89587164,20,2,38,60
"8603","chr16",89628232,89628259,28,60,1,89
"8604","chr16",89653003,89653039,37,12,36,85
"8605","chr16",89675344,89675370,27,59,28,114
"8606","chr16",89698475,89698503,29,7,50,86
"8607","chr16",89705751,89705772,22,7,53,82
"8608","chr16",89750773,89750806,34,30,74,138
"8609","chr16",89801033,89801063,31,14,74,119
"8610","chr16",89815336,89815366,31,75,11,117
"8611","chr16",89828931,89829007,77,45,21,143
"8612","chr16",89876928,89876952,25,27,7,59
"8613","chr16",89894663,89894681,19,27,137,183
"8614","chr16",89909510,89909532,23,81,75,179
"8615","chr16",89928962,89928979,18,7,145,170
"8616","chr16",89941280,89941308,29,8,127,164
"8617","chr16",89987374,89987426,53,12,102,167
"8618","chr16",90019489,90019506,18,81,8,107
"8619","chr16",90034893,90034920,28,7,23,58
"8620","chr16",90083635,90083669,35,62,25,122
"8621","chr16",90106134,90106154,21,38,75,134
"8622","chr17",363790,363815,26,26,67,119
"8623","chr17",385034,385056,23,18,34,75
"8624","chr17",386265,386284,20,123,45,188
"8625","chr17",391224,391254,31,7,102,140
"8626","chr17",566724,566750,27,16,25,68
"8627","chr17",678634,678651,18,71,107,196
"8628","chr17",702349,702383,35,12,11,58
"8629","chr17",712178,712197,20,75,83,178
"8630","chr17",786270,786292,23,9,28,60
"8631","chr17",798248,798268,21,16,123,160
"8632","chr17",801444,801463,20,11,5,36
"8633","chr17",811921,811945,25,76,124,225
"8634","chr17",820612,820633,22,4,124,150
"8635","chr17",836964,836991,28,71,70,169
"8636","chr17",860118,860140,23,7,89,119
"8637","chr17",926528,926563,36,76,102,214
"8638","chr17",931835,931856,22,142,6,170
"8639","chr17",951176,951203,28,80,28,136
"8640","chr17",978836,978858,23,4,19,46
"8641","chr17",989350,989377,28,9,75,112
"8642","chr17",989531,989549,19,28,138,185
"8643","chr17",989690,989711,22,76,83,181
"8644","chr17",1017465,1017486,22,9,27,58
"8645","chr17",1022107,1022125,19,110,57,186
"8646","chr17",1024025,1024049,25,68,7,100
"8647","chr17",1031849,1031941,93,76,45,214
"8648","chr17",1109234,1109253,20,5,98,123
"8649","chr17",1123554,1123580,27,38,27,92
"8650","chr17",1157250,1157268,19,8,83,110
"8651","chr17",1179471,1179520,50,16,20,86
"8652","chr17",1179868,1179903,36,86,84,206
"8653","chr17",1187897,1187919,23,133,3,159
"8654","chr17",1230075,1230129,55,42,58,155
"8655","chr17",1265745,1265762,18,8,4,30
"8656","chr17",1269797,1269824,28,6,23,57
"8657","chr17",1274614,1274636,23,53,9,85
"8658","chr17",1274622,1274659,38,8,1,47
"8659","chr17",1304103,1304127,25,88,68,181
"8660","chr17",1314347,1314368,22,76,31,129
"8661","chr17",1323283,1323305,23,51,133,207
"8662","chr17",1330765,1330800,36,25,14,75
"8663","chr17",1336005,1336035,31,87,83,201
"8664","chr17",1337197,1337225,29,30,6,65
"8665","chr17",1356172,1356216,45,142,3,190
"8666","chr17",1357403,1357421,19,136,6,161
"8667","chr17",1406202,1406232,31,10,2,43
"8668","chr17",1417666,1417683,18,48,33,99
"8669","chr17",1451193,1451211,19,40,5,64
"8670","chr17",1459658,1459676,19,37,75,131
"8671","chr17",1474428,1474450,23,11,6,40
"8672","chr17",1491749,1491766,18,48,1,67
"8673","chr17",1547999,1548017,19,47,69,135
"8674","chr17",1562635,1562652,18,29,45,92
"8675","chr17",1571902,1571927,26,56,5,87
"8676","chr17",1578510,1578546,37,9,93,139
"8677","chr17",1580530,1580582,53,11,94,158
"8678","chr17",1580729,1580747,19,75,143,237
"8679","chr17",1584820,1584849,30,12,6,48
"8680","chr17",1618990,1619017,28,7,68,103
"8681","chr17",1622917,1622949,33,138,3,174
"8682","chr17",1633235,1633259,25,5,74,104
"8683","chr17",1649137,1649195,59,100,105,264
"8684","chr17",1691483,1691506,24,63,145,232
"8685","chr17",1696003,1696020,18,6,5,29
"8686","chr17",1698481,1698514,34,46,13,93
"8687","chr17",1722673,1722707,35,5,117,157
"8688","chr17",1728416,1728438,23,45,12,80
"8689","chr17",1728956,1728974,19,75,3,97
"8690","chr17",1730004,1730026,23,80,32,135
"8691","chr17",1779190,1779212,23,95,3,121
"8692","chr17",1791117,1791138,22,49,16,87
"8693","chr17",1889648,1889671,24,101,138,263
"8694","chr17",1939353,1939394,42,39,6,87
"8695","chr17",1955575,1955597,23,4,55,82
"8696","chr17",1961774,1961798,25,77,19,121
"8697","chr17",1961948,1961997,50,145,74,269
"8698","chr17",1963726,1963748,23,11,126,160
"8699","chr17",1973366,1973384,19,69,5,93
"8700","chr17",1995427,1995446,20,17,5,42
"8701","chr17",1998777,1998797,21,81,15,117
"8702","chr17",2005726,2005765,40,27,80,147
"8703","chr17",2055482,2055499,18,34,37,89
"8704","chr17",2057107,2057134,28,104,35,167
"8705","chr17",2090183,2090202,20,62,7,89
"8706","chr17",2242357,2242380,24,77,27,128
"8707","chr17",2255404,2255429,26,27,6,59
"8708","chr17",2277133,2277175,43,67,93,203
"8709","chr17",2298718,2298735,18,25,6,49
"8710","chr17",2314583,2314603,21,28,74,123
"8711","chr17",2337549,2337570,22,148,64,234
"8712","chr17",2339708,2339726,19,146,74,239
"8713","chr17",2378531,2378577,47,23,51,121
"8714","chr17",2402216,2402234,19,88,1,108
"8715","chr17",2404148,2404166,19,60,97,176
"8716","chr17",2408347,2408382,36,14,53,103
"8717","chr17",2415473,2415501,29,76,18,123
"8718","chr17",2495695,2495717,23,38,105,166
"8719","chr17",2497306,2497330,25,8,145,178
"8720","chr17",2520537,2520583,47,8,22,77
"8721","chr17",2535303,2535329,27,147,6,180
"8722","chr17",2542905,2542931,27,4,72,103
"8723","chr17",2547926,2547943,18,32,8,58
"8724","chr17",2570104,2570129,26,27,75,128
"8725","chr17",2575569,2575587,19,9,4,32
"8726","chr17",2585053,2585080,28,76,146,250
"8727","chr17",2593591,2593618,28,73,17,118
"8728","chr17",2593888,2593938,51,12,82,145
"8729","chr17",2626554,2626571,18,7,134,159
"8730","chr17",2725235,2725253,19,98,9,126
"8731","chr17",2736427,2736458,32,7,74,113
"8732","chr17",2744342,2744370,29,27,138,194
"8733","chr17",2761283,2761305,23,75,121,219
"8734","chr17",2765969,2765988,20,54,74,148
"8735","chr17",2776824,2776858,35,50,8,93
"8736","chr17",2785900,2785919,20,76,9,105
"8737","chr17",2786947,2786969,23,77,9,109
"8738","chr17",2806377,2806408,32,6,35,73
"8739","chr17",2818294,2818344,51,11,59,121
"8740","chr17",2828985,2829003,19,11,23,53
"8741","chr17",2844007,2844037,31,44,139,214
"8742","chr17",2911687,2911713,27,146,58,231
"8743","chr17",2926126,2926144,19,58,124,201
"8744","chr17",2957128,2957153,26,56,6,88
"8745","chr17",3017917,3017955,39,83,53,175
"8746","chr17",3161477,3161498,22,37,67,126
"8747","chr17",3471161,3471192,32,62,68,162
"8748","chr17",3471187,3471226,40,96,42,178
"8749","chr17",3536588,3536610,23,50,6,79
"8750","chr17",3550521,3550542,22,76,97,195
"8751","chr17",3576669,3576690,22,136,57,215
"8752","chr17",3594128,3594152,25,28,6,59
"8753","chr17",3600588,3600615,28,12,125,165
"8754","chr17",3631513,3631539,27,8,101,136
"8755","chr17",3696269,3696289,21,89,11,121
"8756","chr17",3732503,3732520,18,37,75,130
"8757","chr17",3733415,3733437,23,75,15,113
"8758","chr17",3740376,3740393,18,75,61,154
"8759","chr17",3746437,3746470,34,73,38,145
"8760","chr17",3780147,3780174,28,2,137,167
"8761","chr17",3782341,3782370,30,21,58,109
"8762","chr17",3847042,3847151,110,21,51,182
"8763","chr17",3892998,3893023,26,5,99,130
"8764","chr17",3902116,3902142,27,75,38,140
"8765","chr17",3902598,3902626,29,77,143,249
"8766","chr17",3943273,3943306,34,38,22,94
"8767","chr17",3951176,3951230,55,95,70,220
"8768","chr17",3955870,3955899,30,27,122,179
"8769","chr17",3964146,3964164,19,13,3,35
"8770","chr17",3968599,3968617,19,8,103,130
"8771","chr17",4110710,4110728,19,4,6,29
"8772","chr17",4148517,4148537,21,67,74,162
"8773","chr17",4194087,4194104,18,36,66,120
"8774","chr17",4194104,4194125,22,57,49,128
"8775","chr17",4263464,4263493,30,26,97,153
"8776","chr17",4327474,4327499,26,69,72,167
"8777","chr17",4348553,4348571,19,137,6,162
"8778","chr17",4379706,4379738,33,73,20,126
"8779","chr17",4380161,4380184,24,75,7,106
"8780","chr17",4383031,4383053,23,75,145,243
"8781","chr17",4393066,4393095,30,76,8,114
"8782","chr17",4451231,4451248,18,55,77,150
"8783","chr17",4487168,4487191,24,39,78,141
"8784","chr17",4616284,4616306,23,69,28,120
"8785","chr17",4739281,4739308,28,12,122,162
"8786","chr17",4785069,4785086,18,77,27,122
"8787","chr17",4785234,4785269,36,86,8,130
"8788","chr17",4788444,4788480,37,110,109,256
"8789","chr17",4799855,4799872,18,75,5,98
"8790","chr17",4820897,4820915,19,71,124,214
"8791","chr17",4830082,4830101,20,8,143,171
"8792","chr17",4830385,4830405,21,8,9,38
"8793","chr17",4830689,4830709,21,8,9,38
"8794","chr17",4832068,4832092,25,125,6,156
"8795","chr17",4887671,4887701,31,8,96,135
"8796","chr17",4910427,4910444,18,144,3,165
"8797","chr17",4914836,4914855,20,6,14,40
"8798","chr17",4925240,4925270,31,69,129,229
"8799","chr17",4952344,4952361,18,76,25,119
"8800","chr17",4954896,4954914,19,24,91,134
"8801","chr17",4964358,4964379,22,76,15,113
"8802","chr17",4964903,4964924,22,73,75,170
"8803","chr17",5027119,5027143,25,5,57,87
"8804","chr17",5035309,5035337,29,110,73,212
"8805","chr17",5066497,5066533,37,76,75,188
"8806","chr17",5071988,5072022,35,39,74,148
"8807","chr17",5073852,5073879,28,137,3,168
"8808","chr17",5098487,5098517,31,6,74,111
"8809","chr17",5115556,5115576,21,49,69,139
"8810","chr17",5123386,5123409,24,77,62,163
"8811","chr17",5257762,5257799,38,13,7,58
"8812","chr17",5282377,5282394,18,42,119,179
"8813","chr17",5417838,5417857,20,145,7,172
"8814","chr17",5441888,5441914,27,45,97,169
"8815","chr17",5452540,5452563,24,72,6,102
"8816","chr17",5519446,5519463,18,75,1,94
"8817","chr17",5587054,5587073,20,61,13,94
"8818","chr17",5717262,5717429,168,6,40,214
"8819","chr17",5732107,5732131,25,38,56,119
"8820","chr17",5815524,5815546,23,49,141,213
"8821","chr17",5871682,5871704,23,27,70,120
"8822","chr17",6070154,6070177,24,10,121,155
"8823","chr17",6070390,6070442,53,29,11,93
"8824","chr17",6406359,6406409,51,104,7,162
"8825","chr17",6420740,6420757,18,76,7,101
"8826","chr17",6430045,6430087,43,33,89,165
"8827","chr17",6444347,6444369,23,119,37,179
"8828","chr17",6537246,6537274,29,22,42,93
"8829","chr17",6566612,6566637,26,115,6,147
"8830","chr17",6760348,6760368,21,17,74,112
"8831","chr17",7089423,7089458,36,122,75,233
"8832","chr17",7105680,7105698,19,18,73,110
"8833","chr17",7239501,7239558,58,8,45,111
"8834","chr17",7262537,7262562,26,15,5,46
"8835","chr17",7265691,7265711,21,30,5,56
"8836","chr17",7266518,7266535,18,145,39,202
"8837","chr17",7270668,7270689,22,42,86,150
"8838","chr17",7278290,7278315,26,77,84,187
"8839","chr17",7295232,7295280,49,29,5,83
"8840","chr17",7295476,7295495,20,76,76,172
"8841","chr17",7297295,7297336,42,8,5,55
"8842","chr17",7341147,7341165,19,73,40,132
"8843","chr17",7342908,7342932,25,10,6,41
"8844","chr17",7352091,7352108,18,36,28,82
"8845","chr17",7362862,7362890,29,8,11,48
"8846","chr17",7363251,7363269,19,72,67,158
"8847","chr17",7395628,7395652,25,94,5,124
"8848","chr17",7417242,7417267,26,20,112,158
"8849","chr17",7436135,7436152,18,95,53,166
"8850","chr17",7438282,7438300,19,17,53,89
"8851","chr17",7440907,7440932,26,130,134,290
"8852","chr17",7463021,7463083,63,21,30,114
"8853","chr17",7473111,7473130,20,8,86,114
"8854","chr17",7479532,7479562,31,43,1,75
"8855","chr17",7479597,7479621,25,53,40,118
"8856","chr17",7479653,7479670,18,4,7,29
"8857","chr17",7479690,7479709,20,12,1,33
"8858","chr17",7500175,7500192,18,4,6,28
"8859","chr17",7562032,7562052,21,1,19,41
"8860","chr17",7643564,7643581,18,55,52,125
"8861","chr17",7682198,7682229,32,10,40,82
"8862","chr17",7754747,7754764,18,12,146,176
"8863","chr17",7796046,7796067,22,9,25,56
"8864","chr17",7806659,7806682,24,69,6,99
"8865","chr17",7838306,7838345,40,108,111,259
"8866","chr17",7838448,7838470,23,119,90,232
"8867","chr17",7841883,7841908,26,25,21,72
"8868","chr17",7847389,7847414,26,17,24,67
"8869","chr17",7866254,7866280,27,28,75,130
"8870","chr17",7885026,7885081,56,30,97,183
"8871","chr17",7885308,7885345,38,108,31,177
"8872","chr17",7907809,7907826,18,66,11,95
"8873","chr17",7941599,7941617,19,87,34,140
"8874","chr17",8030014,8030040,27,127,6,160
"8875","chr17",8058766,8058784,19,44,5,68
"8876","chr17",8078895,8078915,21,8,41,70
"8877","chr17",8131371,8131388,18,78,89,185
"8878","chr17",8178397,8178416,20,68,32,120
"8879","chr17",8178877,8178899,23,77,24,124
"8880","chr17",8179049,8179068,20,72,6,98
"8881","chr17",8179068,8179092,25,96,55,176
"8882","chr17",8185215,8185243,29,117,71,217
"8883","chr17",8195162,8195198,37,8,14,59
"8884","chr17",8214582,8214608,27,43,23,93
"8885","chr17",8217597,8217614,18,29,76,123
"8886","chr17",8247306,8247329,24,10,144,178
"8887","chr17",8248079,8248102,24,132,94,250
"8888","chr17",8280691,8280715,25,147,96,268
"8889","chr17",8288436,8288463,28,32,18,78
"8890","chr17",8292182,8292207,26,75,74,175
"8891","chr17",8334673,8334699,27,31,76,134
"8892","chr17",8374938,8374964,27,11,74,112
"8893","chr17",8503287,8503311,25,47,2,74
"8894","chr17",8503301,8503319,19,55,56,130
"8895","chr17",8740490,8740511,22,5,73,100
"8896","chr17",8745357,8745395,39,3,48,90
"8897","chr17",8757767,8757786,20,107,63,190
"8898","chr17",8787590,8787614,25,31,74,130
"8899","chr17",8822053,8822071,19,32,17,68
"8900","chr17",8877104,8877127,24,7,2,33
"8901","chr17",8888789,8888823,35,40,41,116
"8902","chr17",9110932,9110952,21,24,42,87
"8903","chr17",9116300,9116320,21,28,116,165
"8904","chr17",9202030,9202056,27,42,24,93
"8905","chr17",9202056,9202090,35,76,3,114
"8906","chr17",9239979,9240001,23,114,18,155
"8907","chr17",9345849,9345868,20,7,135,162
"8908","chr17",9349730,9349751,22,10,36,68
"8909","chr17",9471152,9471171,20,78,125,223
"8910","chr17",9504974,9504992,19,79,6,104
"8911","chr17",9546592,9546615,24,76,79,179
"8912","chr17",9554260,9554304,45,133,6,184
"8913","chr17",9571600,9571619,20,139,73,232
"8914","chr17",9604751,9604805,55,92,91,238
"8915","chr17",9644098,9644124,27,109,134,270
"8916","chr17",9684764,9684786,23,35,5,63
"8917","chr17",9687982,9688004,23,77,82,182
"8918","chr17",9706632,9706661,30,76,63,169
"8919","chr17",9822305,9822341,37,76,82,195
"8920","chr17",9822991,9823014,24,8,2,34
"8921","chr17",9921150,9921174,25,76,113,214
"8922","chr17",10006317,10006347,31,8,93,132
"8923","chr17",10162067,10162088,22,11,74,107
"8924","chr17",10198741,10198775,35,6,21,62
"8925","chr17",10239629,10239649,21,111,74,206
"8926","chr17",10243377,10243403,27,78,66,171
"8927","chr17",10274592,10274611,20,76,115,211
"8928","chr17",10382986,10383008,23,60,54,137
"8929","chr17",10563821,10563842,22,28,75,125
"8930","chr17",10616481,10616524,44,29,3,76
"8931","chr17",10619102,10619126,25,8,137,170
"8932","chr17",10622266,10622285,20,114,31,165
"8933","chr17",10674428,10674456,29,74,4,107
"8934","chr17",10786943,10786989,47,4,74,125
"8935","chr17",11054692,11054713,22,35,67,124
"8936","chr17",11111502,11111556,55,25,75,155
"8937","chr17",11226324,11226347,24,77,28,129
"8938","chr17",11240628,11240663,36,17,83,136
"8939","chr17",11241060,11241084,25,35,5,65
"8940","chr17",11249138,11249159,22,83,7,112
"8941","chr17",11291636,11291661,26,60,4,90
"8942","chr17",11293882,11293903,22,8,56,86
"8943","chr17",11350158,11350185,28,64,144,236
"8944","chr17",11460386,11460409,24,76,45,145
"8945","chr17",11534149,11534177,29,25,70,124
"8946","chr17",11606426,11606465,40,75,130,245
"8947","chr17",11689095,11689121,27,102,74,203
"8948","chr17",11821287,11821307,21,76,5,102
"8949","chr17",11826456,11826478,23,10,45,78
"8950","chr17",11919495,11919521,27,101,74,202
"8951","chr17",11981319,11981336,18,8,30,56
"8952","chr17",12020927,12020944,18,6,145,169
"8953","chr17",12042168,12042190,23,48,19,90
"8954","chr17",12205852,12205887,36,120,94,250
"8955","chr17",12409924,12409941,18,137,17,172
"8956","chr17",12543140,12543198,59,141,3,203
"8957","chr17",12734505,12734528,24,45,20,89
"8958","chr17",12778150,12778238,89,28,50,167
"8959","chr17",12978668,12978708,41,78,20,139
"8960","chr17",12980177,12980194,18,76,144,238
"8961","chr17",12988926,12988947,22,145,24,191
"8962","chr17",13032088,13032120,33,96,99,228
"8963","chr17",13169125,13169155,31,142,27,200
"8964","chr17",13271601,13271623,23,8,132,163
"8965","chr17",13306974,13307018,45,8,20,73
"8966","chr17",13506902,13506919,18,77,26,121
"8967","chr17",13556515,13556541,27,117,67,211
"8968","chr17",13578394,13578413,20,27,25,72
"8969","chr17",13591033,13591063,31,8,8,47
"8970","chr17",13601837,13601856,20,5,106,131
"8971","chr17",13666695,13666713,19,20,22,61
"8972","chr17",13838072,13838097,26,3,4,33
"8973","chr17",14300434,14300475,42,71,110,223
"8974","chr17",14301576,14301602,27,59,9,95
"8975","chr17",14556565,14556608,44,59,75,178
"8976","chr17",14770759,14770776,18,8,38,64
"8977","chr17",15041143,15041161,19,8,66,93
"8978","chr17",15043836,15043858,23,139,6,168
"8979","chr17",15108322,15108356,35,31,72,138
"8980","chr17",15174759,15174834,76,116,18,210
"8981","chr17",15180935,15180961,27,39,76,142
"8982","chr17",15247068,15247087,20,147,76,243
"8983","chr17",15340380,15340397,18,61,41,120
"8984","chr17",15395789,15395808,20,74,122,216
"8985","chr17",15478267,15478284,18,136,119,273
"8986","chr17",15511054,15511076,23,45,74,142
"8987","chr17",15561603,15561633,31,77,2,110
"8988","chr17",15561631,15561666,36,110,42,188
"8989","chr17",15597464,15597483,20,77,35,132
"8990","chr17",15627732,15627754,23,58,6,87
"8991","chr17",15727461,15727479,19,70,72,161
"8992","chr17",15772096,15772138,43,5,93,141
"8993","chr17",15798942,15798984,43,8,132,183
"8994","chr17",15799266,15799316,51,8,11,70
"8995","chr17",15799466,15799483,18,19,76,113
"8996","chr17",15804035,15804053,19,3,7,29
"8997","chr17",15960554,15960579,26,137,6,169
"8998","chr17",15995576,15995597,22,4,131,157
"8999","chr17",16228358,16228399,42,73,7,122
"9000","chr17",16229325,16229360,36,38,71,145
"9001","chr17",16237806,16237825,20,57,118,195
"9002","chr17",16331770,16331789,20,82,135,237
"9003","chr17",16338941,16338975,35,5,63,103
"9004","chr17",16353155,16353178,24,31,5,60
"9005","chr17",16376677,16376703,27,48,2,77
"9006","chr17",16387405,16387427,23,132,4,159
"9007","chr17",16406295,16406420,126,4,20,150
"9008","chr17",16406793,16406838,46,81,76,203
"9009","chr17",16476196,16476215,20,74,73,167
"9010","chr17",16485632,16485693,62,112,97,271
"9011","chr17",16492128,16492145,18,25,2,45
"9012","chr17",16500630,16500651,22,65,34,121
"9013","chr17",16536466,16536493,28,5,36,69
"9014","chr17",16583798,16583815,18,57,7,82
"9015","chr17",16964338,16964359,22,7,37,66
"9016","chr17",16984572,16984601,30,76,4,110
"9017","chr17",16987444,16987490,47,91,95,233
"9018","chr17",17030602,17030660,59,100,99,258
"9019","chr17",17042418,17042454,37,57,90,184
"9020","chr17",17042812,17042845,34,4,6,44
"9021","chr17",17227711,17227739,29,90,74,193
"9022","chr17",17267328,17267347,20,136,84,240
"9023","chr17",17315745,17315774,30,13,15,58
"9024","chr17",17368525,17368569,45,30,6,81
"9025","chr17",17436361,17436378,18,77,114,209
"9026","chr17",17496327,17496360,34,9,139,182
"9027","chr17",17525993,17526018,26,70,75,171
"9028","chr17",17608349,17608381,33,24,3,60
"9029","chr17",17639931,17639949,19,28,5,52
"9030","chr17",17722269,17722287,19,89,88,196
"9031","chr17",17793780,17793820,41,38,94,173
"9032","chr17",17796679,17796696,18,15,68,101
"9033","chr17",17833421,17833451,31,98,9,138
"9034","chr17",17955326,17955356,31,76,79,186
"9035","chr17",17973620,17973648,29,117,51,197
"9036","chr17",18029880,18029904,25,13,124,162
"9037","chr17",18095388,18095410,23,6,69,98
"9038","chr17",18101699,18101718,20,27,18,65
"9039","chr17",18184331,18184377,47,123,14,184
"9040","chr17",18217098,18217149,52,7,43,102
"9041","chr17",18231650,18231673,24,4,7,35
"9042","chr17",18234238,18234267,30,56,22,108
"9043","chr17",18259499,18259518,20,29,75,124
"9044","chr17",18343609,18343631,23,141,73,237
"9045","chr17",18355051,18355087,37,12,74,123
"9046","chr17",18355370,18355390,21,145,6,172
"9047","chr17",18360560,18360591,32,100,75,207
"9048","chr17",18369281,18369303,23,7,5,35
"9049","chr17",18373801,18373833,33,27,4,64
"9050","chr17",18494135,18494159,25,1,100,126
"9051","chr17",18649186,18649203,18,58,82,158
"9052","chr17",18649201,18649219,19,74,67,160
"9053","chr17",18673035,18673056,22,104,18,144
"9054","chr17",18697138,18697160,23,77,55,155
"9055","chr17",18736352,18736383,32,8,28,68
"9056","chr17",18764201,18764220,20,77,21,118
"9057","chr17",18783089,18783107,19,60,95,174
"9058","chr17",18802225,18802255,31,16,3,50
"9059","chr17",18829807,18829824,18,77,78,173
"9060","chr17",18857406,18857430,25,75,3,103
"9061","chr17",18917547,18917586,40,17,118,175
"9062","chr17",18917585,18917619,35,50,80,165
"9063","chr17",18984333,18984354,22,73,15,110
"9064","chr17",19004272,19004292,21,21,71,113
"9065","chr17",19062563,19062590,28,35,1,64
"9066","chr17",19063469,19063487,19,4,33,56
"9067","chr17",19067678,19067702,25,68,120,213
"9068","chr17",19088432,19088463,32,70,142,244
"9069","chr17",19097798,19097823,26,76,139,241
"9070","chr17",19103522,19103544,23,29,3,55
"9071","chr17",19103895,19103915,21,55,6,82
"9072","chr17",19106613,19106642,30,14,138,182
"9073","chr17",19154263,19154289,27,141,74,242
"9074","chr17",19163624,19163655,32,144,66,242
"9075","chr17",19184493,19184518,26,122,66,214
"9076","chr17",19188665,19188691,27,35,1,63
"9077","chr17",19189570,19189596,27,3,33,63
"9078","chr17",19193743,19193768,26,68,120,214
"9079","chr17",19214599,19214630,32,68,142,242
"9080","chr17",19223965,19223992,28,76,139,243
"9081","chr17",19229689,19229711,23,29,3,55
"9082","chr17",19230062,19230082,21,55,6,82
"9083","chr17",19232775,19232804,30,14,138,182
"9084","chr17",19350542,19350571,30,145,47,222
"9085","chr17",19352515,19352538,24,75,27,126
"9086","chr17",19376625,19376651,27,148,63,238
"9087","chr17",19411605,19411622,18,5,79,102
"9088","chr17",19482233,19482253,21,97,34,152
"9089","chr17",19487627,19487658,32,10,74,116
"9090","chr17",19722813,19722830,18,145,27,190
"9091","chr17",19744403,19744434,32,110,6,148
"9092","chr17",19851641,19851668,28,73,5,106
"9093","chr17",19869685,19869711,27,7,1,35
"9094","chr17",19882963,19882987,25,86,6,117
"9095","chr17",19883330,19883360,31,148,74,253
"9096","chr17",19907411,19907428,18,69,53,140
"9097","chr17",19995122,19995142,21,74,3,98
"9098","chr17",20015585,20015602,18,8,140,166
"9099","chr17",20099512,20099539,28,139,44,211
"9100","chr17",20099695,20099720,26,126,6,158
"9101","chr17",20322187,20322205,19,69,6,94
"9102","chr17",20330577,20330594,18,77,78,173
"9103","chr17",20489367,20489388,22,85,132,239
"9104","chr17",20602118,20602141,24,18,76,118
"9105","chr17",20606696,20606717,22,5,7,34
"9106","chr17",20608792,20608809,18,9,11,38
"9107","chr17",20667747,20667767,21,118,72,211
"9108","chr17",20686338,20686355,18,117,26,161
"9109","chr17",20708898,20708937,40,68,43,151
"9110","chr17",20744028,20744093,66,18,55,139
"9111","chr17",20791280,20791321,42,87,6,135
"9112","chr17",20803287,20803309,23,4,74,101
"9113","chr17",20808278,20808308,31,75,13,119
"9114","chr17",20828554,20828577,24,124,58,206
"9115","chr17",20915595,20915613,19,7,18,44
"9116","chr17",21023645,21023666,22,110,6,138
"9117","chr17",21128700,21128718,19,143,73,235
"9118","chr17",21246515,21246540,26,120,73,219
"9119","chr17",21284781,21284807,27,96,58,181
"9120","chr17",21291246,21291375,130,27,4,161
"9121","chr17",21302047,21302075,29,29,110,168
"9122","chr17",21322959,21322983,25,37,16,78
"9123","chr17",21345646,21345667,22,8,28,58
"9124","chr17",21376141,21376175,35,49,87,171
"9125","chr17",21376306,21376331,26,17,93,136
"9126","chr17",21387155,21387186,32,39,75,146
"9127","chr17",21395294,21395314,21,14,43,78
"9128","chr17",21454973,21455041,69,5,103,177
"9129","chr17",21551683,21551739,57,133,126,316
"9130","chr17",21610781,21610804,24,104,74,202
"9131","chr17",21678385,21678423,39,67,87,193
"9132","chr17",21720616,21720658,43,34,30,107
"9133","chr17",21742301,21742325,25,30,8,63
"9134","chr17",21764989,21765009,21,19,35,75
"9135","chr17",21817222,21817241,20,28,20,68
"9136","chr17",22092616,22092636,21,8,102,131
"9137","chr17",22377478,22377520,43,99,24,166
"9138","chr17",22379848,22379890,43,99,24,166
"9139","chr17",22382218,22382264,47,99,24,170
"9140","chr17",22384593,22384611,19,99,24,142
"9141","chr17",22386940,22386986,47,99,24,170
"9142","chr17",22389315,22389339,25,99,24,148
"9143","chr17",22393089,22393125,37,99,24,160
"9144","chr17",22395454,22395504,51,99,24,174
"9145","chr17",22396817,22396841,25,44,24,93
"9146","chr17",22397287,22397311,25,99,24,148
"9147","chr17",22401931,22401981,51,99,43,193
"9148","chr17",22405772,22405812,41,99,24,164
"9149","chr17",22406402,22406442,41,99,24,164
"9150","chr17",22409837,22409858,22,82,24,128
"9151","chr17",26774513,26774544,32,139,135,306
"9152","chr17",27293210,27293237,28,14,6,48
"9153","chr17",27317505,27317532,28,71,33,132
"9154","chr17",27383550,27383571,22,41,145,208
"9155","chr17",27456279,27456309,31,31,13,75
"9156","chr17",27563244,27563290,47,85,123,255
"9157","chr17",27883836,27883870,35,66,51,152
"9158","chr17",28247405,28247429,25,9,118,152
"9159","chr17",28247712,28247751,40,55,9,104
"9160","chr17",28250901,28250918,18,69,50,137
"9161","chr17",28388756,28388788,33,76,24,133
"9162","chr17",28430421,28430443,23,8,145,176
"9163","chr17",28508009,28508031,23,45,145,213
"9164","chr17",28726272,28726342,71,96,32,199
"9165","chr17",28730278,28730305,28,75,75,178
"9166","chr17",28743073,28743102,30,33,74,137
"9167","chr17",28744283,28744301,19,1,131,151
"9168","chr17",28762627,28762648,22,3,74,99
"9169","chr17",28764272,28764294,23,146,74,243
"9170","chr17",28775882,28775927,46,146,5,197
"9171","chr17",28851517,28851540,24,31,23,78
"9172","chr17",28866635,28866654,20,77,5,102
"9173","chr17",28869142,28869160,19,76,138,233
"9174","chr17",28962781,28962799,19,108,74,201
"9175","chr17",29134520,29134539,20,7,8,35
"9176","chr17",29219023,29219065,43,116,5,164
"9177","chr17",29227514,29227552,39,74,45,158
"9178","chr17",29294524,29294542,19,139,44,202
"9179","chr17",29302541,29302560,20,8,20,48
"9180","chr17",29307247,29307272,26,9,8,43
"9181","chr17",29379015,29379034,20,118,26,164
"9182","chr17",29379032,29379059,28,143,9,180
"9183","chr17",29387656,29387673,18,4,74,96
"9184","chr17",29389311,29389328,18,5,21,44
"9185","chr17",29390928,29390952,25,135,32,192
"9186","chr17",29395825,29395848,24,36,75,135
"9187","chr17",29414556,29414574,19,76,52,147
"9188","chr17",29512375,29512398,24,37,130,191
"9189","chr17",29531271,29531298,28,78,1,107
"9190","chr17",29539425,29539443,19,65,43,127
"9191","chr17",29540532,29540587,56,7,143,206
"9192","chr17",29736787,29736815,29,145,74,248
"9193","chr17",29932450,29932472,23,7,11,41
"9194","chr17",29972205,29972222,18,29,75,122
"9195","chr17",30150685,30150710,26,13,8,47
"9196","chr17",30291955,30291981,27,7,30,64
"9197","chr17",30305102,30305119,18,16,81,115
"9198","chr17",30338363,30338530,168,68,67,303
"9199","chr17",30348494,30348511,18,139,6,163
"9200","chr17",30400825,30400843,19,22,143,184
"9201","chr17",30593891,30593910,20,77,27,124
"9202","chr17",30658712,30658796,85,14,6,105
"9203","chr17",30663115,30663133,19,82,63,164
"9204","chr17",30670167,30670197,31,8,145,184
"9205","chr17",30679969,30679992,24,5,32,61
"9206","chr17",30681738,30681758,21,148,27,196
"9207","chr17",30704201,30704218,18,45,42,105
"9208","chr17",30709586,30709623,38,21,25,84
"9209","chr17",30731201,30731226,26,132,73,231
"9210","chr17",30805714,30805731,18,3,74,95
"9211","chr17",30815058,30815103,46,44,19,109
"9212","chr17",30825169,30825212,44,102,28,174
"9213","chr17",30830461,30830485,25,141,73,239
"9214","chr17",30836541,30836583,43,6,38,87
"9215","chr17",30928191,30928213,23,60,77,160
"9216","chr17",31007173,31007203,31,37,75,143
"9217","chr17",31021419,31021442,24,37,143,204
"9218","chr17",31055442,31055461,20,76,75,171
"9219","chr17",31067379,31067397,19,30,143,192
"9220","chr17",31084803,31084830,28,90,4,122
"9221","chr17",31130075,31130097,23,57,22,102
"9222","chr17",31173411,31173436,26,135,73,234
"9223","chr17",31280517,31280540,24,11,74,109
"9224","chr17",31391533,31391555,23,32,91,146
"9225","chr17",31391616,31391674,59,56,8,123
"9226","chr17",31418392,31418420,29,15,70,114
"9227","chr17",31450322,31450362,41,8,145,194
"9228","chr17",31451459,31451481,23,21,74,118
"9229","chr17",31487958,31487981,24,56,28,108
"9230","chr17",31519008,31519032,25,76,67,168
"9231","chr17",31549705,31549727,23,10,15,48
"9232","chr17",31602729,31602765,37,122,41,200
"9233","chr17",31698392,31698413,22,81,5,108
"9234","chr17",31761712,31761734,23,104,73,200
"9235","chr17",31777769,31777797,29,70,2,101
"9236","chr17",31807529,31807559,31,7,57,95
"9237","chr17",31935050,31935075,26,77,72,175
"9238","chr17",31937087,31937127,41,69,17,127
"9239","chr17",31954058,31954078,21,6,99,126
"9240","chr17",31998079,31998097,19,45,26,90
"9241","chr17",32006120,32006156,37,6,20,63
"9242","chr17",32079146,32079181,36,84,74,194
"9243","chr17",32086276,32086299,24,8,145,177
"9244","chr17",32087203,32087227,25,98,33,156
"9245","chr17",32142452,32142501,50,64,12,126
"9246","chr17",32146613,32146631,19,29,143,191
"9247","chr17",32291333,32291359,27,107,74,208
"9248","chr17",32333568,32333586,19,109,93,221
"9249","chr17",32391034,32391083,50,56,134,240
"9250","chr17",32467243,32467262,20,75,145,240
"9251","chr17",32487008,32487041,34,32,40,106
"9252","chr17",32762872,32762905,34,146,76,256
"9253","chr17",33126857,33126878,22,69,2,93
"9254","chr17",33443407,33443431,25,8,43,76
"9255","chr17",33634687,33634713,27,16,71,114
"9256","chr17",33659872,33659937,66,80,6,152
"9257","chr17",34021828,34021855,28,126,108,262
"9258","chr17",34075824,34075848,25,127,79,231
"9259","chr17",34075995,34076020,26,76,27,129
"9260","chr17",34155574,34155602,29,90,41,160
"9261","chr17",34331210,34331237,28,137,10,175
"9262","chr17",34634815,34634841,27,29,141,197
"9263","chr17",34913765,34913783,19,43,4,66
"9264","chr17",34980634,34980665,32,30,39,101
"9265","chr17",34988191,34988216,26,58,8,92
"9266","chr17",35033531,35033556,26,104,3,133
"9267","chr17",35089304,35089324,21,43,5,69
"9268","chr17",35116476,35116509,34,73,5,112
"9269","chr17",35218110,35218132,23,8,138,169
"9270","chr17",35242829,35242853,25,51,11,87
"9271","chr17",35448025,35448064,40,36,105,181
"9272","chr17",35449045,35449075,31,95,3,129
"9273","chr17",35495901,35495947,47,24,11,82
"9274","chr17",35512151,35512172,22,31,82,135
"9275","chr17",35512360,35512383,24,8,37,69
"9276","chr17",35515634,35515659,26,6,144,176
"9277","chr17",35535963,35535998,36,35,138,209
"9278","chr17",35567518,35567560,43,144,4,191
"9279","chr17",35804047,35804074,28,5,17,50
"9280","chr17",35871917,35871939,23,8,135,166
"9281","chr17",35927116,35927140,25,101,17,143
"9282","chr17",36007114,36007136,23,86,74,183
"9283","chr17",36186192,36186223,32,50,65,147
"9284","chr17",36225127,36225145,19,14,73,106
"9285","chr17",36349000,36349018,19,14,73,106
"9286","chr17",36402266,36402284,19,8,133,160
"9287","chr17",36405970,36405988,19,8,41,68
"9288","chr17",36512390,36512414,25,64,73,162
"9289","chr17",36545402,36545423,22,52,12,86
"9290","chr17",36548616,36548652,37,137,73,247
"9291","chr17",36558415,36558438,24,41,74,139
"9292","chr17",36786543,36786573,31,133,6,170
"9293","chr17",36814506,36814523,18,44,34,96
"9294","chr17",36983349,36983366,18,9,52,79
"9295","chr17",36984902,36984919,18,126,43,187
"9296","chr17",37314635,37314657,23,7,125,155
"9297","chr17",37314951,37314975,25,75,137,237
"9298","chr17",37331085,37331135,51,76,136,263
"9299","chr17",37355859,37355881,23,6,73,102
"9300","chr17",37359406,37359439,34,1,25,60
"9301","chr17",37370668,37370695,28,6,63,97
"9302","chr17",37394713,37394739,27,77,35,139
"9303","chr17",37406970,37406988,19,31,55,105
"9304","chr17",37408250,37408268,19,74,82,175
"9305","chr17",37411593,37411610,18,36,72,126
"9306","chr17",37485335,37485361,27,5,77,109
"9307","chr17",37485511,37485529,19,32,78,129
"9308","chr17",37489936,37489958,23,10,57,90
"9309","chr17",37814389,37814410,22,38,104,164
"9310","chr17",37906902,37906921,20,43,6,69
"9311","chr17",37910608,37910636,29,135,6,170
"9312","chr17",37949611,37949629,19,14,73,106
"9313","chr17",38029137,38029155,19,14,73,106
"9314","chr17",38255764,38255783,20,70,114,204
"9315","chr17",38256655,38256740,86,15,29,130
"9316","chr17",38264471,38264488,18,40,130,188
"9317","chr17",38288545,38288574,30,9,9,48
"9318","chr17",38296519,38296536,18,18,99,135
"9319","chr17",38300041,38300067,27,107,6,140
"9320","chr17",38347245,38347264,20,125,6,151
"9321","chr17",38352780,38352804,25,12,33,70
"9322","chr17",38387451,38387738,288,27,2,317
"9323","chr17",38419216,38419253,38,46,94,178
"9324","chr17",38445304,38445326,23,77,34,134
"9325","chr17",38462248,38462271,24,100,15,139
"9326","chr17",38490913,38490935,23,75,15,113
"9327","chr17",38605989,38606014,26,28,3,57
"9328","chr17",38605993,38606018,26,32,24,82
"9329","chr17",38648866,38648909,44,25,88,157
"9330","chr17",38705448,38705491,44,29,35,108
"9331","chr17",38724259,38724282,24,40,4,68
"9332","chr17",38736833,38736856,24,19,75,118
"9333","chr17",38743257,38743274,18,39,76,133
"9334","chr17",38748222,38748263,42,21,52,115
"9335","chr17",38748347,38748390,44,2,13,59
"9336","chr17",38751755,38751772,18,56,123,197
"9337","chr17",38761349,38761366,18,29,9,56
"9338","chr17",38799431,38799449,19,2,34,55
"9339","chr17",38804800,38804820,21,143,82,246
"9340","chr17",38813848,38813874,27,71,141,239
"9341","chr17",38814746,38814767,22,33,74,129
"9342","chr17",38818278,38818309,32,12,122,166
"9343","chr17",38832465,38832579,115,70,112,297
"9344","chr17",38837678,38837712,35,131,75,241
"9345","chr17",38842509,38842547,39,7,106,152
"9346","chr17",38842840,38842924,85,5,1,91
"9347","chr17",38843736,38843754,19,7,28,54
"9348","chr17",38876344,38876376,33,5,145,183
"9349","chr17",38884688,38884708,21,8,146,175
"9350","chr17",38924702,38924724,23,87,76,186
"9351","chr17",38927611,38927639,29,26,42,97
"9352","chr17",38944701,38944721,21,77,75,173
"9353","chr17",38965710,38965733,24,77,36,137
"9354","chr17",38968201,38968226,26,120,21,167
"9355","chr17",38969108,38969129,22,126,110,258
"9356","chr17",38979693,38979719,27,76,115,218
"9357","chr17",39006995,39007037,43,36,122,201
"9358","chr17",39007014,39007072,59,71,103,233
"9359","chr17",39023884,39023924,41,72,9,122
"9360","chr17",39025623,39025662,40,133,125,298
"9361","chr17",39093719,39093737,19,37,39,95
"9362","chr17",39179281,39179303,23,17,18,58
"9363","chr17",39220779,39220813,35,75,6,116
"9364","chr17",39269500,39269517,18,9,138,165
"9365","chr17",39299785,39299810,26,8,2,36
"9366","chr17",39312919,39312936,18,27,102,147
"9367","chr17",39343696,39343713,18,8,42,68
"9368","chr17",39349325,39349352,28,31,1,60
"9369","chr17",39384525,39384553,29,26,74,129
"9370","chr17",39386025,39386045,21,27,79,127
"9371","chr17",39446450,39446468,19,112,6,137
"9372","chr17",39449810,39449831,22,7,145,174
"9373","chr17",39451540,39451575,36,75,42,153
"9374","chr17",39544626,39544649,24,9,93,126
"9375","chr17",39573626,39573651,26,9,71,106
"9376","chr17",39604639,39604675,37,104,58,199
"9377","chr17",39618156,39618191,36,52,80,168
"9378","chr17",39655991,39656029,39,132,38,209
"9379","chr17",39693761,39693805,45,49,71,165
"9380","chr17",39699994,39700020,27,20,21,68
"9381","chr17",39731227,39731253,27,34,9,70
"9382","chr17",39930278,39930308,31,30,74,135
"9383","chr17",39970659,39970711,53,64,84,201
"9384","chr17",40001512,40001556,45,71,31,147
"9385","chr17",40019168,40019211,44,7,48,99
"9386","chr17",40039782,40039801,20,8,79,107
"9387","chr17",40082759,40082784,26,9,48,83
"9388","chr17",40119553,40119570,18,62,72,152
"9389","chr17",40140318,40140430,113,23,90,226
"9390","chr17",40186575,40186609,35,10,67,112
"9391","chr17",40187913,40187934,22,78,8,108
"9392","chr17",40219363,40219405,43,50,9,102
"9393","chr17",40224407,40224426,20,36,134,190
"9394","chr17",40239037,40239089,53,8,19,80
"9395","chr17",40250220,40250247,28,7,61,96
"9396","chr17",40259019,40259041,23,15,101,139
"9397","chr17",40325253,40325299,47,76,72,195
"9398","chr17",40365818,40365846,29,75,106,210
"9399","chr17",40379519,40379547,29,67,125,221
"9400","chr17",40425297,40425317,21,77,27,125
"9401","chr17",40443293,40443313,21,19,62,102
"9402","chr17",40443675,40443720,46,88,19,153
"9403","chr17",40482586,40482630,45,111,29,185
"9404","chr17",40580799,40580823,25,128,4,157
"9405","chr17",40818912,40818930,19,2,59,80
"9406","chr17",40904047,40904069,23,8,77,108
"9407","chr17",41588814,41588844,31,106,134,271
"9408","chr17",41657843,41657863,21,4,25,50
"9409","chr17",41665480,41665507,28,61,57,146
"9410","chr17",41665505,41665522,18,76,32,126
"9411","chr17",41673968,41674009,42,8,80,130
"9412","chr17",41703248,41703281,34,136,73,243
"9413","chr17",41703441,41703458,18,147,5,170
"9414","chr17",41717485,41717517,33,82,74,189
"9415","chr17",41733353,41733376,24,89,146,259
"9416","chr17",41748276,41748293,18,50,72,140
"9417","chr17",41756910,41756928,19,11,64,94
"9418","chr17",41797089,41797115,27,95,12,134
"9419","chr17",41818956,41818974,19,106,6,131
"9420","chr17",41830508,41830558,51,15,6,72
"9421","chr17",41865327,41865368,42,36,2,80
"9422","chr17",41866044,41866065,22,76,75,173
"9423","chr17",41866215,41866236,22,44,75,141
"9424","chr17",41924130,41924159,30,5,124,159
"9425","chr17",41955417,41955444,28,76,69,173
"9426","chr17",41956486,41956506,21,43,145,209
"9427","chr17",41958661,41958678,18,83,7,108
"9428","chr17",41970399,41970416,18,76,8,102
"9429","chr17",41994337,41994379,43,75,73,191
"9430","chr17",42047030,42047049,20,8,75,103
"9431","chr17",42093552,42093597,46,7,106,159
"9432","chr17",42134981,42134998,18,7,87,112
"9433","chr17",42168742,42168769,28,56,130,214
"9434","chr17",42168751,42168789,39,8,121,168
"9435","chr17",42226809,42226827,19,132,73,224
"9436","chr17",42292315,42292346,32,8,52,92
"9437","chr17",42293177,42293220,44,6,136,186
"9438","chr17",42332538,42332560,23,12,6,41
"9439","chr17",42334440,42334462,23,8,83,114
"9440","chr17",42340356,42340373,18,54,74,146
"9441","chr17",42367144,42367184,41,139,71,251
"9442","chr17",42373552,42373570,19,110,6,135
"9443","chr17",42405683,42405705,23,9,103,135
"9444","chr17",42416375,42416395,21,122,112,255
"9445","chr17",42432426,42432444,19,6,43,68
"9446","chr17",42438011,42438031,21,81,99,201
"9447","chr17",42458256,42458283,28,4,15,47
"9448","chr17",42462999,42463022,24,10,40,74
"9449","chr17",42532184,42532225,42,107,107,256
"9450","chr17",42532811,42532837,27,8,8,43
"9451","chr17",42554323,42554358,36,114,47,197
"9452","chr17",42644987,42645012,26,49,72,147
"9453","chr17",42649126,42649152,27,36,8,71
"9454","chr17",42657363,42657381,19,42,74,135
"9455","chr17",42668819,42668845,27,89,83,199
"9456","chr17",42676445,42676471,27,57,57,141
"9457","chr17",42682635,42682672,38,11,43,92
"9458","chr17",42733641,42733659,19,147,74,240
"9459","chr17",42738756,42738777,22,11,135,168
"9460","chr17",42766902,42766926,25,11,43,79
"9461","chr17",42769470,42769497,28,142,74,244
"9462","chr17",42840284,42840312,29,136,5,170
"9463","chr17",42848066,42848091,26,45,89,160
"9464","chr17",42863268,42863294,27,63,139,229
"9465","chr17",42888860,42888884,25,6,64,95
"9466","chr17",42892581,42892601,21,11,74,106
"9467","chr17",42956967,42956984,18,81,11,110
"9468","chr17",42965118,42965144,27,13,3,43
"9469","chr17",42974773,42974791,19,86,74,179
"9470","chr17",43009753,43009778,26,72,74,172
"9471","chr17",43022194,43022211,18,76,50,144
"9472","chr17",43025793,43025811,19,140,32,191
"9473","chr17",43044805,43044823,19,10,53,82
"9474","chr17",43072012,43072044,33,86,30,149
"9475","chr17",43096377,43096394,18,117,6,141
"9476","chr17",43124748,43124777,30,22,143,195
"9477","chr17",43132757,43132778,22,73,63,158
"9478","chr17",43137875,43137894,20,137,8,165
"9479","chr17",43192021,43192038,18,8,146,172
"9480","chr17",43212273,43212302,30,9,109,148
"9481","chr17",43238349,43238375,27,36,62,125
"9482","chr17",43250241,43250267,27,36,62,125
"9483","chr17",43265036,43265062,27,36,62,125
"9484","chr17",43276790,43276807,18,6,4,28
"9485","chr17",43282556,43282582,27,36,62,125
"9486","chr17",43288720,43288746,27,36,62,125
"9487","chr17",43294855,43294881,27,36,62,125
"9488","chr17",43316474,43316505,32,113,26,171
"9489","chr17",43322477,43322507,31,6,73,110
"9490","chr17",43388060,43388081,22,70,7,99
"9491","chr17",43388240,43388266,27,33,72,132
"9492","chr17",43425709,43425735,27,108,6,141
"9493","chr17",43459732,43459756,25,8,38,71
"9494","chr17",43488278,43488304,27,122,6,155
"9495","chr17",43510029,43510064,36,6,35,77
"9496","chr17",43545195,43545235,41,28,49,118
"9497","chr17",43571675,43571716,42,5,8,55
"9498","chr17",43629123,43629145,23,12,25,60
"9499","chr17",43645172,43645194,23,8,108,139
"9500","chr17",43655053,43655074,22,31,73,126
"9501","chr17",43679041,43679060,20,74,24,118
"9502","chr17",43681923,43681964,42,3,7,52
"9503","chr17",43693988,43694014,27,36,144,207
"9504","chr17",43749037,43749055,19,82,4,105
"9505","chr17",43832723,43832752,30,16,105,151
"9506","chr17",43835251,43835268,18,13,74,105
"9507","chr17",43838732,43838768,37,75,75,187
"9508","chr17",43926395,43926418,24,8,107,139
"9509","chr17",43980465,43980493,29,47,9,85
"9510","chr17",44010305,44010330,26,100,71,197
"9511","chr17",44045937,44045954,18,8,81,107
"9512","chr17",44049192,44049226,35,143,5,183
"9513","chr17",44093652,44093678,27,8,24,59
"9514","chr17",44123532,44123567,36,1,77,114
"9515","chr17",44162771,44162794,24,37,75,136
"9516","chr17",44173084,44173107,24,148,90,262
"9517","chr17",44174038,44174057,20,8,116,144
"9518","chr17",44179650,44179669,20,7,4,31
"9519","chr17",44196778,44196799,22,46,74,142
"9520","chr17",44199461,44199487,27,5,11,43
"9521","chr17",44219579,44219637,59,19,17,95
"9522","chr17",44220053,44220072,20,12,1,33
"9523","chr17",44220905,44220939,35,48,10,93
"9524","chr17",44242024,44242047,24,69,134,227
"9525","chr17",44245088,44245111,24,7,7,38
"9526","chr17",44308345,44308364,20,43,49,112
"9527","chr17",44326826,44326864,39,2,37,78
"9528","chr17",44329705,44329751,47,140,133,320
"9529","chr17",44354058,44354087,30,2,3,35
"9530","chr17",44475380,44475406,27,137,74,238
"9531","chr17",44513938,44513958,21,77,74,172
"9532","chr17",44557716,44557740,25,102,64,191
"9533","chr17",44613607,44613626,20,74,77,171
"9534","chr17",44628533,44628575,43,2,79,124
"9535","chr17",44648896,44648914,19,65,71,155
"9536","chr17",44657533,44657562,30,36,93,159
"9537","chr17",44658155,44658172,18,8,7,33
"9538","chr17",44696980,44697001,22,8,140,170
"9539","chr17",44756935,44756955,21,122,74,217
"9540","chr17",44811996,44812029,34,10,13,57
"9541","chr17",44830229,44830272,44,86,18,148
"9542","chr17",44835892,44835930,39,134,7,180
"9543","chr17",44876856,44876881,26,29,71,126
"9544","chr17",44921842,44921871,30,77,38,145
"9545","chr17",44924047,44924072,26,125,35,186
"9546","chr17",44947114,44947142,29,128,69,226
"9547","chr17",44954751,44954785,35,55,7,97
"9548","chr17",44968223,44968249,27,19,36,82
"9549","chr17",44991079,44991105,27,70,74,171
"9550","chr17",45011436,45011456,21,120,42,183
"9551","chr17",45011455,45011474,20,138,23,181
"9552","chr17",45015328,45015362,35,37,6,78
"9553","chr17",45047505,45047523,19,76,88,183
"9554","chr17",45080466,45080486,21,8,5,34
"9555","chr17",45115364,45115410,47,84,13,144
"9556","chr17",45132560,45132617,58,7,16,81
"9557","chr17",45150159,45150179,21,101,100,222
"9558","chr17",45154527,45154545,19,147,73,239
"9559","chr17",45154961,45154984,24,67,75,166
"9560","chr17",45155146,45155164,19,109,72,200
"9561","chr17",45182837,45182891,55,38,146,239
"9562","chr17",45199519,45199548,30,63,74,167
"9563","chr17",45201095,45201134,40,76,61,177
"9564","chr17",45214778,45214803,26,5,54,85
"9565","chr17",45218570,45218588,19,9,2,30
"9566","chr17",45234664,45234704,41,7,6,54
"9567","chr17",45242068,45242093,26,71,58,155
"9568","chr17",45370393,45370420,28,74,106,208
"9569","chr17",45373113,45373134,22,29,6,57
"9570","chr17",45434968,45434987,20,8,75,103
"9571","chr17",45485909,45485929,21,7,56,84
"9572","chr17",45488937,45488964,28,120,8,156
"9573","chr17",45550568,45550599,32,122,69,223
"9574","chr17",45570260,45570287,28,112,12,152
"9575","chr17",45590834,45590854,21,4,74,99
"9576","chr17",45602116,45602154,39,49,133,221
"9577","chr17",45614662,45614711,50,58,8,116
"9578","chr17",45618909,45618932,24,76,68,168
"9579","chr17",45784173,45784214,42,22,25,89
"9580","chr17",45784362,45784385,24,26,76,126
"9581","chr17",46105866,46105948,83,44,11,138
"9582","chr17",46208617,46208637,21,33,38,92
"9583","chr17",46213468,46213489,22,37,143,202
"9584","chr17",46226781,46226805,25,59,74,158
"9585","chr17",46231019,46231056,38,10,56,104
"9586","chr17",46243783,46243821,39,135,56,230
"9587","chr17",46294870,46294901,32,71,120,223
"9588","chr17",46492680,46492711,32,8,109,149
"9589","chr17",46512449,46512480,32,71,120,223
"9590","chr17",46771761,46771788,28,65,30,123
"9591","chr17",46771879,46771908,30,31,145,206
"9592","chr17",46779054,46779104,51,24,135,210
"9593","chr17",46806176,46806228,53,9,54,116
"9594","chr17",46976373,46976397,25,108,137,270
"9595","chr17",46976546,46976577,32,52,44,128
"9596","chr17",47060904,47060924,21,58,90,169
"9597","chr17",47099777,47099803,27,5,70,102
"9598","chr17",47100725,47100775,51,19,109,179
"9599","chr17",47104757,47104803,47,8,2,57
"9600","chr17",47110927,47110984,58,13,127,198
"9601","chr17",47253771,47253789,19,57,95,171
"9602","chr17",47272057,47272075,19,10,142,171
"9603","chr17",47424875,47424900,26,8,138,172
"9604","chr17",47531713,47531790,78,35,13,126
"9605","chr17",47532659,47532681,23,116,68,207
"9606","chr17",47594587,47594645,59,3,66,128
"9607","chr17",47650555,47650579,25,94,110,229
"9608","chr17",47693976,47694024,49,104,26,179
"9609","chr17",47734430,47734465,36,88,89,213
"9610","chr17",47743880,47743918,39,47,74,160
"9611","chr17",47794161,47794183,23,7,4,34
"9612","chr17",47863739,47863756,18,8,72,98
"9613","chr17",47872501,47872519,19,15,39,73
"9614","chr17",47892870,47892889,20,143,6,169
"9615","chr17",47954924,47954948,25,9,14,48
"9616","chr17",47968498,47968533,36,74,134,244
"9617","chr17",48018616,48018635,20,76,21,117
"9618","chr17",48020221,48020240,20,28,75,123
"9619","chr17",48101208,48101226,19,10,91,120
"9620","chr17",48124385,48124426,42,76,74,192
"9621","chr17",48138371,48138388,18,9,69,96
"9622","chr17",48158178,48158198,21,81,73,175
"9623","chr17",48564425,48564447,23,33,18,74
"9624","chr17",48619224,48619270,47,31,141,219
"9625","chr17",48719206,48719250,45,69,29,143
"9626","chr17",48728854,48728999,146,20,58,224
"9627","chr17",48740301,48740324,24,78,29,131
"9628","chr17",48807039,48807058,20,29,65,114
"9629","chr17",48807819,48807856,38,8,3,49
"9630","chr17",48916251,48916273,23,76,74,173
"9631","chr17",48926475,48926492,18,69,68,155
"9632","chr17",48935513,48935531,19,145,6,170
"9633","chr17",48942848,48942883,36,8,145,189
"9634","chr17",48950513,48950531,19,30,145,194
"9635","chr17",48964160,48964188,29,67,6,102
"9636","chr17",49003778,49003807,30,1,130,161
"9637","chr17",49027854,49027881,28,144,4,176
"9638","chr17",49097306,49097340,35,8,101,144
"9639","chr17",49151374,49151412,39,94,6,139
"9640","chr17",49199268,49199289,22,8,15,45
"9641","chr17",49220847,49220893,47,106,3,156
"9642","chr17",49225028,49225045,18,116,4,138
"9643","chr17",49230741,49230765,25,9,21,55
"9644","chr17",49250706,49250727,22,148,68,238
"9645","chr17",49267178,49267195,18,58,70,146
"9646","chr17",49286697,49286726,30,108,31,169
"9647","chr17",49286876,49286895,20,143,8,171
"9648","chr17",49418800,49418828,29,10,73,112
"9649","chr17",49495341,49495358,18,13,27,58
"9650","chr17",49514042,49514070,29,25,86,140
"9651","chr17",49569711,49569729,19,5,118,142
"9652","chr17",49575651,49575672,22,63,72,157
"9653","chr17",49657697,49657718,22,75,145,242
"9654","chr17",49678050,49678084,35,146,100,281
"9655","chr17",49679067,49679094,28,108,10,146
"9656","chr17",49679247,49679273,27,12,40,79
"9657","chr17",49769297,49769320,24,51,72,147
"9658","chr17",49964348,49964380,33,4,38,75
"9659","chr17",49983801,49983818,18,16,71,105
"9660","chr17",50054703,50054726,24,139,2,165
"9661","chr17",50055727,50055750,24,124,137,285
"9662","chr17",50070645,50070668,24,23,7,54
"9663","chr17",50129804,50129842,39,2,8,49
"9664","chr17",50129845,50129867,23,27,6,56
"9665","chr17",50130068,50130096,29,11,2,42
"9666","chr17",50151017,50151038,22,15,9,46
"9667","chr17",50273970,50273996,27,8,38,73
"9668","chr17",50325132,50325154,23,143,65,231
"9669","chr17",50345996,50346021,26,42,29,97
"9670","chr17",50508363,50508380,18,57,144,219
"9671","chr17",50515983,50516006,24,75,135,234
"9672","chr17",50589895,50589913,19,14,28,61
"9673","chr17",50589913,50589949,37,50,10,97
"9674","chr17",50591602,50591619,18,114,75,207
"9675","chr17",50611253,50611271,19,79,7,105
"9676","chr17",50673901,50674075,175,117,134,426
"9677","chr17",50717926,50717950,25,74,87,186
"9678","chr17",50792877,50792902,26,87,75,188
"9679","chr17",50796271,50796291,21,12,43,76
"9680","chr17",50835991,50836014,24,99,118,241
"9681","chr17",50920341,50920363,23,70,16,109
"9682","chr17",50951412,50951439,28,93,42,163
"9683","chr17",50993096,50993114,19,93,6,118
"9684","chr17",51117709,51117732,24,28,74,126
"9685","chr17",51136755,51136789,35,147,76,258
"9686","chr17",51152030,51152059,30,34,6,70
"9687","chr17",51152243,51152273,31,4,38,73
"9688","chr17",51166116,51166144,29,3,76,108
"9689","chr17",51170143,51170160,18,9,64,91
"9690","chr17",51300497,51300519,23,9,1,33
"9691","chr17",52079287,52079309,23,77,5,105
"9692","chr17",52158102,52158124,23,25,16,64
"9693","chr17",52179267,52179316,50,79,143,272
"9694","chr17",52494526,52494567,42,126,74,242
"9695","chr17",52519190,52519211,22,29,75,126
"9696","chr17",52825473,52825517,45,26,138,209
"9697","chr17",53264380,53264398,19,29,75,123
"9698","chr17",53468027,53468046,20,32,74,126
"9699","chr17",54225046,54225074,29,51,113,193
"9700","chr17",55439019,55439037,19,83,74,176
"9701","chr17",55714176,55714199,24,6,118,148
"9702","chr17",55899908,55899959,52,77,85,214
"9703","chr17",56592925,56592951,27,110,2,139
"9704","chr17",56593722,56593742,21,54,131,206
"9705","chr17",56595032,56595057,26,16,66,108
"9706","chr17",56978200,56978222,23,35,69,127
"9707","chr17",57048570,57048591,22,146,34,202
"9708","chr17",57049686,57049724,39,117,141,297
"9709","chr17",57056145,57056176,32,42,117,191
"9710","chr17",57058428,57058447,20,109,74,203
"9711","chr17",57062172,57062382,211,3,24,238
"9712","chr17",57068544,57068569,26,122,66,214
"9713","chr17",57091680,57091706,27,36,37,100
"9714","chr17",57256435,57256485,51,18,37,106
"9715","chr17",57460129,57460174,46,27,74,147
"9716","chr17",57461534,57461551,18,7,106,131
"9717","chr17",57549313,57549331,19,46,1,66
"9718","chr17",57659057,57659087,31,18,100,149
"9719","chr17",57783306,57783324,19,11,17,47
"9720","chr17",57878648,57878686,39,79,114,232
"9721","chr17",57932282,57932303,22,12,74,108
"9722","chr17",57955457,57955494,38,54,75,167
"9723","chr17",57987807,57987839,33,5,26,64
"9724","chr17",57988189,57988223,35,5,22,62
"9725","chr17",58083454,58083478,25,70,15,110
"9726","chr17",58112542,58112568,27,4,10,41
"9727","chr17",58218448,58218480,33,127,6,166
"9728","chr17",58328826,58328855,30,86,136,252
"9729","chr17",58356887,58356911,25,8,128,161
"9730","chr17",58457285,58457313,29,9,99,137
"9731","chr17",58629457,58629477,21,82,71,174
"9732","chr17",58658388,58658409,22,128,146,296
"9733","chr17",58740633,58740655,23,70,1,94
"9734","chr17",58756097,58756154,58,54,25,137
"9735","chr17",59141724,59141743,20,53,74,147
"9736","chr17",59200483,59200510,28,8,33,69
"9737","chr17",59218007,59218030,24,57,4,85
"9738","chr17",59224625,59224661,37,134,74,245
"9739","chr17",59280724,59280741,18,135,74,227
"9740","chr17",59309176,59309202,27,140,6,173
"9741","chr17",59309492,59309516,25,142,74,241
"9742","chr17",59319637,59319655,19,62,31,112
"9743","chr17",59349656,59349680,25,10,131,166
"9744","chr17",59490624,59490644,21,77,114,212
"9745","chr17",59556916,59556955,40,98,6,144
"9746","chr17",59760925,59760943,19,31,139,189
"9747","chr17",59791492,59791509,18,35,144,197
"9748","chr17",59794220,59794240,21,76,145,242
"9749","chr17",59809485,59809524,40,8,74,122
"9750","chr17",59832762,59832782,21,27,74,122
"9751","chr17",59873868,59873894,27,134,71,232
"9752","chr17",60078659,60078676,18,38,141,197
"9753","chr17",60079228,60079249,22,77,27,126
"9754","chr17",60430474,60430496,23,73,57,153
"9755","chr17",60556623,60556645,23,77,10,110
"9756","chr17",60609090,60609108,19,123,102,244
"9757","chr17",60625147,60625170,24,128,1,153
"9758","chr17",60724421,60724442,22,12,76,110
"9759","chr17",60792125,60792146,22,55,72,149
"9760","chr17",61190527,61190550,24,5,74,103
"9761","chr17",61193758,61193785,28,98,73,199
"9762","chr17",61202060,61202082,23,3,39,65
"9763","chr17",61202134,61202152,19,73,69,161
"9764","chr17",61262692,61262709,18,7,134,159
"9765","chr17",61400131,61400152,22,11,31,64
"9766","chr17",61400595,61400617,23,20,121,164
"9767","chr17",61471893,61471923,31,36,75,142
"9768","chr17",61483614,61483653,40,2,76,118
"9769","chr17",61553935,61553959,25,104,9,138
"9770","chr17",61934624,61934646,23,83,27,133
"9771","chr17",61935329,61935356,28,8,11,47
"9772","chr17",61937043,61937062,20,41,75,136
"9773","chr17",62008017,62008036,20,104,76,200
"9774","chr17",62065374,62065401,28,63,4,95
"9775","chr17",62187663,62187682,20,52,100,172
"9776","chr17",62223229,62223251,23,14,73,110
"9777","chr17",62235447,62235466,20,54,6,80
"9778","chr17",62246070,62246088,19,23,5,47
"9779","chr17",62479269,62479288,20,36,12,68
"9780","chr17",62503416,62503435,20,76,86,182
"9781","chr17",62564536,62564558,23,77,74,174
"9782","chr17",62663959,62663977,19,8,131,158
"9783","chr17",62756248,62756288,41,93,74,208
"9784","chr17",62808389,62808409,21,112,37,170
"9785","chr17",62831761,62831779,19,32,30,81
"9786","chr17",62952848,62952874,27,18,80,125
"9787","chr17",63467114,63467133,20,25,4,49
"9788","chr17",63477127,63477161,35,86,139,260
"9789","chr17",63477433,63477475,43,127,70,240
"9790","chr17",63551892,63551931,40,148,26,214
"9791","chr17",63559305,63559458,154,86,130,370
"9792","chr17",63622591,63622609,19,54,12,85
"9793","chr17",63740087,63740148,62,67,3,132
"9794","chr17",63761518,63761537,20,67,30,117
"9795","chr17",63774202,63774259,58,89,53,200
"9796","chr17",63889560,63889592,33,84,54,171
"9797","chr17",64113682,64113701,20,9,46,75
"9798","chr17",64128162,64128182,21,27,143,191
"9799","chr17",64129987,64130015,29,4,63,96
"9800","chr17",64143883,64143926,44,144,5,193
"9801","chr17",64214065,64214091,27,21,44,92
"9802","chr17",64298693,64298724,32,74,93,199
"9803","chr17",64302097,64302125,29,145,6,180
"9804","chr17",64341097,64341114,18,77,73,168
"9805","chr17",64345712,64345733,22,53,7,82
"9806","chr17",64414473,64414496,24,136,70,230
"9807","chr17",64460507,64460525,19,117,73,209
"9808","chr17",64584352,64584377,26,77,39,142
"9809","chr17",64661886,64661917,32,57,72,161
"9810","chr17",64662374,64662411,38,117,32,187
"9811","chr17",64681662,64681684,23,138,72,233
"9812","chr17",64747868,64747885,18,78,72,168
"9813","chr17",64817316,64817333,18,76,44,138
"9814","chr17",64826242,64826264,23,78,74,175
"9815","chr17",64832663,64832684,22,5,25,52
"9816","chr17",64897490,64897521,32,122,69,223
"9817","chr17",64917246,64917270,25,112,6,143
"9818","chr17",64919170,64919189,20,2,22,44
"9819","chr17",65001912,65001939,28,13,85,126
"9820","chr17",65028228,65028246,19,64,4,87
"9821","chr17",65056597,65056614,18,8,98,124
"9822","chr17",65056782,65056804,23,94,19,136
"9823","chr17",65083498,65083515,18,35,137,190
"9824","chr17",65100557,65100630,74,71,144,289
"9825","chr17",65122871,65122892,22,35,135,192
"9826","chr17",65309236,65309254,19,6,120,145
"9827","chr17",65537615,65537633,19,33,89,141
"9828","chr17",65561686,65561722,37,32,45,114
"9829","chr17",66302333,66302377,45,38,49,132
"9830","chr17",66564991,66565008,18,93,63,174
"9831","chr17",66690828,66690852,25,138,6,169
"9832","chr17",66884133,66884156,24,44,5,73
"9833","chr17",66964856,66964891,36,86,40,162
"9834","chr17",66990648,66990697,50,7,48,105
"9835","chr17",67017499,67017535,37,76,23,136
"9836","chr17",67023271,67023293,23,8,86,117
"9837","chr17",67223092,67223110,19,77,27,123
"9838","chr17",67304645,67304670,26,8,103,137
"9839","chr17",67319479,67319499,21,117,6,144
"9840","chr17",67324901,67324936,36,11,10,57
"9841","chr17",67336280,67336303,24,146,76,246
"9842","chr17",67346393,67346415,23,77,8,108
"9843","chr17",67373364,67373386,23,97,34,154
"9844","chr17",67377496,67377515,20,19,29,68
"9845","chr17",67451630,67451656,27,76,55,158
"9846","chr17",67509235,67509253,19,144,5,168
"9847","chr17",67514190,67514217,28,27,53,108
"9848","chr17",67583866,67583918,53,31,64,148
"9849","chr17",67766358,67766376,19,7,131,157
"9850","chr17",67779090,67779111,22,49,6,77
"9851","chr17",67825794,67825816,23,23,1,47
"9852","chr17",67825952,67825970,19,45,21,85
"9853","chr17",67826118,67826140,23,40,1,64
"9854","chr17",67826151,67826170,20,70,60,150
"9855","chr17",67827931,67827949,19,8,43,70
"9856","chr17",67844071,67844097,27,45,5,77
"9857","chr17",67869828,67869852,25,77,23,125
"9858","chr17",67931303,67931323,21,145,36,202
"9859","chr17",67989674,67989692,19,74,89,182
"9860","chr17",67992568,67992594,27,138,74,239
"9861","chr17",67993386,67993414,29,69,132,230
"9862","chr17",68001950,68001968,19,76,7,102
"9863","chr17",68003816,68003861,46,70,7,123
"9864","chr17",68005181,68005206,26,132,28,186
"9865","chr17",68021555,68021576,22,60,7,89
"9866","chr17",68051134,68051162,29,7,119,155
"9867","chr17",68111846,68111863,18,73,43,134
"9868","chr17",68164297,68164314,18,79,27,124
"9869","chr17",68164462,68164481,20,42,74,136
"9870","chr17",68205968,68205994,27,126,93,246
"9871","chr17",68209577,68209605,29,42,62,133
"9872","chr17",68209605,68209633,29,3,34,66
"9873","chr17",68247337,68247360,24,23,5,52
"9874","chr17",68282780,68282800,21,29,35,85
"9875","chr17",68388923,68388951,29,34,8,71
"9876","chr17",68425371,68425400,30,35,143,208
"9877","chr17",68465626,68465649,24,36,70,130
"9878","chr17",68767538,68767561,24,8,106,138
"9879","chr17",68918931,68918955,25,125,97,247
"9880","chr17",69041730,69041762,33,38,48,119
"9881","chr17",69462951,69462970,20,17,15,52
"9882","chr17",69518191,69518220,30,130,73,233
"9883","chr17",69675885,69675914,30,37,75,142
"9884","chr17",69808231,69808259,29,8,140,177
"9885","chr17",69937806,69937827,22,121,43,186
"9886","chr17",70066492,70066512,21,79,86,186
"9887","chr17",70377339,70377374,36,13,2,51
"9888","chr17",71729376,71729399,24,7,57,88
"9889","chr17",71999590,71999612,23,42,75,140
"9890","chr17",72120684,72120705,22,79,73,174
"9891","chr17",72412490,72412508,19,27,75,121
"9892","chr17",72468162,72468243,82,69,4,155
"9893","chr17",72585373,72585399,27,129,4,160
"9894","chr17",72873055,72873081,27,13,6,46
"9895","chr17",73026118,73026233,116,139,74,329
"9896","chr17",73047011,73047042,32,8,4,44
"9897","chr17",73050129,73050146,18,146,66,230
"9898","chr17",73165296,73165336,41,55,34,130
"9899","chr17",73355175,73355195,21,8,68,97
"9900","chr17",73355346,73355364,19,54,142,215
"9901","chr17",73436577,73436602,26,65,74,165
"9902","chr17",73645334,73645354,21,1,34,56
"9903","chr17",73712359,73712384,26,13,94,133
"9904","chr17",73925452,73925475,24,38,6,68
"9905","chr17",74113402,74113435,34,1,42,77
"9906","chr17",74213466,74213520,55,136,5,196
"9907","chr17",74220702,74220719,18,36,111,165
"9908","chr17",74241263,74241302,40,21,135,196
"9909","chr17",74263734,74263763,30,98,4,132
"9910","chr17",74278774,74278800,27,62,9,98
"9911","chr17",74324899,74324921,23,62,117,202
"9912","chr17",74340557,74340574,18,36,96,150
"9913","chr17",74456764,74456782,19,123,6,148
"9914","chr17",74689443,74689477,35,123,124,282
"9915","chr17",74706670,74706693,24,6,72,102
"9916","chr17",74745261,74745289,29,116,41,186
"9917","chr17",74774850,74774872,23,20,10,53
"9918","chr17",74859884,74859909,26,2,43,71
"9919","chr17",74861564,74861588,25,1,54,80
"9920","chr17",74861776,74861794,19,36,29,84
"9921","chr17",74972701,74972733,33,105,1,139
"9922","chr17",74983006,74983084,79,72,36,187
"9923","chr17",74997920,74997937,18,146,97,261
"9924","chr17",75073096,75073140,45,29,21,95
"9925","chr17",75113008,75113041,34,8,52,94
"9926","chr17",75127060,75127078,19,66,8,93
"9927","chr17",75132115,75132151,37,73,63,173
"9928","chr17",75133791,75133810,20,106,77,203
"9929","chr17",75158308,75158330,23,8,10,41
"9930","chr17",75161580,75161602,23,3,140,166
"9931","chr17",75166026,75166053,28,7,6,41
"9932","chr17",75183457,75183481,25,70,126,221
"9933","chr17",75185223,75185243,21,122,75,218
"9934","chr17",75196757,75196780,24,25,7,56
"9935","chr17",75204014,75204040,27,29,76,132
"9936","chr17",75217505,75217525,21,9,142,172
"9937","chr17",75248469,75248494,26,137,76,239
"9938","chr17",75269727,75269758,32,123,143,298
"9939","chr17",75276842,75276864,23,37,75,135
"9940","chr17",75282860,75282895,36,25,115,176
"9941","chr17",75323122,75323142,21,54,71,146
"9942","chr17",75376027,75376048,22,146,4,172
"9943","chr17",75405625,75405648,24,12,41,77
"9944","chr17",75416513,75416550,38,8,57,103
"9945","chr17",75425796,75425819,24,140,68,232
"9946","chr17",75428020,75428042,23,8,17,48
"9947","chr17",75443348,75443368,21,76,144,241
"9948","chr17",75461094,75461116,23,7,53,83
"9949","chr17",75470921,75470946,26,4,4,34
"9950","chr17",75478330,75478376,47,32,47,126
"9951","chr17",75515181,75515210,30,124,121,275
"9952","chr17",75516564,75516582,19,41,98,158
"9953","chr17",75517103,75517132,30,26,16,72
"9954","chr17",75541716,75541746,31,120,27,178
"9955","chr17",75616381,75616424,44,97,5,146
"9956","chr17",75715346,75715364,19,44,45,108
"9957","chr17",75735401,75735431,31,77,131,239
"9958","chr17",75857170,75857197,28,119,6,153
"9959","chr17",75878257,75878299,43,37,115,195
"9960","chr17",75896670,75896697,28,20,98,146
"9961","chr17",75907860,75907889,30,8,102,140
"9962","chr17",75938556,75938577,22,145,73,240
"9963","chr17",75968436,75968455,20,144,6,170
"9964","chr17",76001311,76001336,26,95,45,166
"9965","chr17",76012738,76012762,25,8,120,153
"9966","chr17",76069392,76069432,41,20,70,131
"9967","chr17",76072415,76072467,53,48,88,189
"9968","chr17",76075857,76075889,33,15,84,132
"9969","chr17",76109651,76109673,23,32,5,60
"9970","chr17",76110824,76110846,23,46,145,214
"9971","chr17",76147387,76147418,32,129,62,223
"9972","chr17",76268732,76268751,20,58,122,200
"9973","chr17",76345238,76345255,18,131,3,152
"9974","chr17",76488950,76488969,20,70,4,94
"9975","chr17",76504040,76504061,22,10,73,105
"9976","chr17",76516236,76516270,35,122,142,299
"9977","chr17",76523903,76523946,44,6,78,128
"9978","chr17",76527442,76527475,34,22,3,59
"9979","chr17",76528121,76528152,32,68,65,165
"9980","chr17",76537700,76537728,29,27,13,69
"9981","chr17",76599484,76599512,29,138,74,241
"9982","chr17",76642923,76642942,20,3,125,148
"9983","chr17",76695162,76695188,27,55,72,154
"9984","chr17",76728793,76728810,18,7,63,88
"9985","chr17",76750365,76750386,22,20,71,113
"9986","chr17",76759757,76759786,30,72,145,247
"9987","chr17",76925236,76925254,19,46,10,75
"9988","chr17",77040341,77040367,27,94,6,127
"9989","chr17",77040375,77040402,28,129,40,197
"9990","chr17",77063704,77063725,22,45,6,73
"9991","chr17",77078383,77078406,24,13,6,43
"9992","chr17",77078706,77078724,19,96,137,252
"9993","chr17",77111186,77111209,24,97,13,134
"9994","chr17",77152536,77152554,19,140,6,165
"9995","chr17",77239877,77239920,44,121,4,169
"9996","chr17",77253341,77253359,19,12,11,42
"9997","chr17",77271366,77271390,25,50,5,80
"9998","chr17",77281160,77281182,23,118,17,158
"9999","chr17",77281361,77281398,38,96,4,138
"10000","chr17",77289408,77289425,18,7,47,72
"10001","chr17",77369234,77369255,22,58,124,204
"10002","chr17",77373272,77373297,26,4,20,50
"10003","chr17",77385544,77385561,18,71,120,209
"10004","chr17",77395527,77395544,18,16,20,54
"10005","chr17",77468264,77468297,34,71,7,112
"10006","chr17",77504422,77504453,32,46,24,102
"10007","chr17",77529120,77529142,23,7,22,52
"10008","chr17",77530185,77530207,23,19,61,103
"10009","chr17",77598669,77598687,19,15,13,47
"10010","chr17",77656967,77657021,55,80,123,258
"10011","chr17",77920859,77920904,46,76,7,129
"10012","chr17",77958086,77958104,19,8,7,34
"10013","chr17",77958769,77958794,26,47,139,212
"10014","chr17",77958949,77958968,20,62,14,96
"10015","chr17",77959084,77959111,28,9,42,79
"10016","chr17",78051340,78051365,26,105,121,252
"10017","chr17",78119808,78119826,19,35,19,73
"10018","chr17",78128334,78128352,19,19,8,46
"10019","chr17",78139729,78139753,25,149,32,206
"10020","chr17",78157799,78157824,26,125,4,155
"10021","chr17",78168588,78168614,27,2,103,132
"10022","chr17",78207274,78207301,28,76,64,168
"10023","chr17",78218267,78218297,31,62,54,147
"10024","chr17",78286200,78286221,22,145,27,194
"10025","chr17",78290017,78290184,168,44,4,216
"10026","chr17",78331208,78331247,40,77,22,139
"10027","chr17",78341453,78341474,22,69,29,120
"10028","chr17",78352968,78353003,36,15,62,113
"10029","chr17",78382637,78382660,24,8,134,166
"10030","chr17",78405962,78405981,20,98,136,254
"10031","chr17",78425757,78425783,27,76,21,124
"10032","chr17",78433914,78433994,81,40,2,123
"10033","chr17",78443546,78443567,22,76,61,159
"10034","chr17",78456299,78456330,32,62,74,168
"10035","chr17",78591710,78591739,30,58,57,145
"10036","chr17",78638089,78638110,22,115,58,195
"10037","chr17",78730370,78730389,20,145,27,192
"10038","chr17",78770326,78770368,43,8,71,122
"10039","chr17",78865625,78865642,18,77,73,168
"10040","chr17",78865793,78865810,18,102,73,193
"10041","chr17",78917252,78917272,21,69,6,96
"10042","chr17",78926708,78926731,24,10,6,40
"10043","chr17",78938880,78938906,27,8,85,120
"10044","chr17",78988963,78988999,37,8,89,134
"10045","chr17",78989878,78989969,92,3,7,102
"10046","chr17",79009700,79009734,35,78,50,163
"10047","chr17",79023705,79023738,34,21,54,109
"10048","chr17",79030995,79031020,26,5,51,82
"10049","chr17",79093792,79093827,36,6,58,100
"10050","chr17",79219405,79219438,34,96,103,233
"10051","chr17",79220599,79220616,18,106,46,170
"10052","chr17",79546670,79546687,18,8,119,145
"10053","chr17",79581247,79581294,48,120,7,175
"10054","chr17",79610436,79610496,61,40,24,125
"10055","chr17",79611091,79611213,123,22,19,164
"10056","chr17",79656606,79656850,245,42,14,301
"10057","chr17",79742009,79742042,34,18,56,108
"10058","chr17",79753308,79753356,49,93,6,148
"10059","chr17",79755475,79755492,18,95,2,115
"10060","chr17",79777908,79777944,37,8,43,88
"10061","chr17",79778004,79778030,27,16,90,133
"10062","chr17",79778066,79778148,83,71,28,182
"10063","chr17",79795323,79795363,41,17,8,66
"10064","chr17",79796792,79796823,32,57,67,156
"10065","chr17",79834442,79834474,33,13,6,52
"10066","chr17",79834865,79834883,19,38,83,140
"10067","chr17",79840702,79840719,18,116,41,175
"10068","chr17",79915188,79915256,69,111,121,301
"10069","chr17",79929941,79930059,119,34,126,279
"10070","chr17",79998515,79998532,18,43,123,184
"10071","chr17",80005057,80005096,40,44,61,145
"10072","chr17",80015437,80015463,27,69,3,99
"10073","chr17",80030755,80030778,24,38,23,85
"10074","chr17",80035192,80035233,42,41,109,192
"10075","chr17",80043606,80043625,20,98,50,168
"10076","chr17",80071832,80071853,22,4,100,126
"10077","chr17",80072985,80073019,35,75,87,197
"10078","chr17",80098979,80098996,18,147,2,167
"10079","chr17",80148859,80148894,36,12,37,85
"10080","chr17",80200230,80200254,25,8,126,159
"10081","chr17",80284368,80284395,28,78,2,108
"10082","chr17",80336901,80336923,23,65,74,162
"10083","chr17",80374005,80374024,20,4,72,96
"10084","chr17",80461435,80461459,25,3,115,143
"10085","chr17",80466062,80466100,39,125,85,249
"10086","chr17",80477752,80477774,23,19,43,85
"10087","chr17",80561068,80561087,20,7,34,61
"10088","chr17",80594029,80594106,78,3,106,187
"10089","chr17",80598883,80598929,47,47,22,116
"10090","chr17",80665318,80665564,247,10,33,290
"10091","chr17",80753633,80753652,20,55,6,81
"10092","chr17",80888107,80888136,30,80,44,154
"10093","chr17",80894765,80894787,23,106,70,199
"10094","chr17",80973315,80973334,20,30,76,126
"10095","chr17",81004171,81004209,39,10,78,127
"10096","chr17",81033754,81033776,23,12,106,141
"10097","chr17",81093079,81093131,53,59,17,129
"10098","chr17",81100136,81100163,28,140,122,290
"10099","chr17",81119257,81119276,20,139,128,287
"10100","chr17",81120445,81120462,18,58,65,141
"10101","chr17",81125020,81125044,25,1,8,34
"10102","chr17",81167342,81167395,54,29,75,158
"10103","chr17",81212323,81212353,31,30,6,67
"10104","chr17",81217996,81218038,43,54,97,194
"10105","chr17",81218036,81218056,21,4,57,82
"10106","chr17",81221125,81221146,22,90,6,118
"10107","chr17",81271749,81271770,22,34,86,142
"10108","chr17",81289616,81289636,21,90,70,181
"10109","chr17",81313144,81313170,27,46,73,146
"10110","chr17",81315697,81315714,18,53,131,202
"10111","chr17",81322865,81322897,33,84,9,126
"10112","chr17",81327558,81327599,42,76,105,223
"10113","chr17",81346085,81346110,26,101,37,164
"10114","chr17",81346222,81346254,33,6,82,121
"10115","chr17",81356842,81356864,23,17,26,66
"10116","chr17",81359433,81359493,61,26,129,216
"10117","chr17",81362781,81362801,21,104,80,205
"10118","chr17",81419790,81419810,21,43,38,102
"10119","chr17",81437338,81437357,20,1,117,138
"10120","chr17",81441669,81441690,22,99,67,188
"10121","chr17",81454540,81454557,18,57,95,170
"10122","chr17",81458900,81458931,32,54,72,158
"10123","chr17",81495058,81495077,20,77,101,198
"10124","chr17",81498555,81498575,21,146,8,175
"10125","chr17",81549042,81549073,32,40,4,76
"10126","chr17",81559728,81559748,21,74,120,215
"10127","chr17",81572168,81572203,36,5,30,71
"10128","chr17",81597784,81597801,18,135,73,226
"10129","chr17",81619378,81619399,22,77,5,104
"10130","chr17",81623465,81623484,20,115,45,180
"10131","chr17",81644007,81644028,22,30,143,195
"10132","chr17",81654380,81654397,18,45,129,192
"10133","chr17",81657881,81657915,35,135,6,176
"10134","chr17",81667320,81667338,19,69,103,191
"10135","chr17",81700634,81700665,32,90,56,178
"10136","chr17",81705194,81705232,39,135,123,297
"10137","chr17",81705202,81705241,40,144,115,299
"10138","chr17",81711642,81711680,39,8,62,109
"10139","chr17",81734705,81734723,19,64,34,117
"10140","chr17",81833183,81833253,71,34,30,135
"10141","chr17",81836988,81837005,18,77,27,122
"10142","chr17",81871218,81871285,68,51,3,122
"10143","chr17",81891462,81891496,35,6,26,67
"10144","chr17",81925808,81925826,19,47,6,72
"10145","chr17",81927701,81927719,19,86,4,109
"10146","chr17",81960945,81960964,20,2,29,51
"10147","chr17",81973122,81973149,28,13,74,115
"10148","chr17",81974859,81974880,22,74,4,100
"10149","chr17",81994673,81994692,20,4,94,118
"10150","chr17",81999627,81999649,23,75,74,172
"10151","chr17",82013480,82013499,20,4,142,166
"10152","chr17",82026565,82026600,36,79,34,149
"10153","chr17",82031569,82031605,37,6,19,62
"10154","chr17",82031953,82031975,23,17,8,48
"10155","chr17",82040872,82040893,22,135,6,163
"10156","chr17",82051638,82051680,43,22,4,69
"10157","chr17",82079080,82079103,24,134,104,262
"10158","chr17",82094787,82094822,36,15,8,59
"10159","chr17",82123294,82123312,19,41,144,204
"10160","chr17",82143944,82143961,18,134,26,178
"10161","chr17",82144057,82144080,24,65,71,160
"10162","chr17",82170508,82170525,18,13,6,37
"10163","chr17",82212398,82212416,19,77,62,158
"10164","chr17",82293206,82293481,276,65,101,442
"10165","chr17",82313013,82313037,25,9,4,38
"10166","chr17",82346288,82346310,23,126,68,217
"10167","chr17",82370334,82370375,42,145,120,307
"10168","chr17",82379432,82379473,42,13,6,61
"10169","chr17",82401145,82401162,18,9,51,78
"10170","chr17",82491216,82491238,23,59,62,144
"10171","chr17",82498650,82498672,23,149,9,181
"10172","chr17",82499975,82499993,19,136,74,229
"10173","chr17",82508917,82508977,61,3,6,70
"10174","chr17",82515595,82515621,27,8,14,49
"10175","chr17",82516366,82516383,18,77,143,238
"10176","chr17",82537620,82537642,23,15,7,45
"10177","chr17",82560002,82560025,24,78,39,141
"10178","chr17",82599098,82599117,20,10,6,36
"10179","chr17",82636090,82636115,26,81,71,178
"10180","chr17",82657017,82657037,21,134,3,158
"10181","chr17",82661889,82661909,21,65,72,158
"10182","chr17",82669478,82669501,24,75,3,102
"10183","chr17",82670179,82670203,25,77,66,168
"10184","chr17",82674638,82674673,36,42,7,85
"10185","chr17",82676938,82676961,24,71,133,228
"10186","chr17",82714424,82714446,23,67,66,156
"10187","chr17",82735562,82735581,20,30,32,82
"10188","chr17",82751351,82751369,19,51,102,172
"10189","chr17",82751567,82751597,31,11,52,94
"10190","chr17",82882774,82882795,22,65,134,221
"10191","chr17",82940222,82940246,25,63,58,146
"10192","chr17",83028523,83028553,31,3,7,41
"10193","chr17",83079505,83079547,43,36,9,88
"10194","chr17",83080602,83080624,23,14,25,62
"10195","chr17",83080858,83080884,27,25,53,105
"10196","chr17",83209516,83209533,18,78,49,145
"10197","chr17",83214390,83214418,29,72,5,106
"10198","chr18",72971,72988,18,41,2,61
"10199","chr18",112007,112029,23,46,15,84
"10200","chr18",137206,137242,37,48,39,124
"10201","chr18",239296,239319,24,5,44,73
"10202","chr18",334628,334649,22,48,74,144
"10203","chr18",406516,406540,25,133,67,225
"10204","chr18",503755,503773,19,96,75,190
"10205","chr18",503773,503790,18,113,57,188
"10206","chr18",509166,509191,26,72,18,116
"10207","chr18",542449,542497,49,41,27,117
"10208","chr18",560144,560163,20,3,42,65
"10209","chr18",713471,713493,23,17,37,77
"10210","chr18",804610,804630,21,11,74,106
"10211","chr18",812017,812039,23,68,11,102
"10212","chr18",828882,828909,28,63,9,100
"10213","chr18",844074,844091,18,8,130,156
"10214","chr18",1116866,1116889,24,8,131,163
"10215","chr18",1840135,1840167,33,143,130,306
"10216","chr18",2580732,2580760,29,10,99,138
"10217","chr18",2671586,2671613,28,76,72,176
"10218","chr18",3087489,3087507,19,76,64,159
"10219","chr18",3150058,3150075,18,74,135,227
"10220","chr18",3224974,3225005,32,76,136,244
"10221","chr18",3349568,3349593,26,78,141,245
"10222","chr18",3405166,3405184,19,16,67,102
"10223","chr18",3430672,3430691,20,35,143,198
"10224","chr18",3450966,3450985,20,133,85,238
"10225","chr18",3476192,3476211,20,9,6,35
"10226","chr18",3602018,3602035,18,82,65,165
"10227","chr18",3623777,3623797,21,13,6,40
"10228","chr18",3646926,3646948,23,129,5,157
"10229","chr18",3651973,3651997,25,128,4,157
"10230","chr18",3920353,3920373,21,35,88,144
"10231","chr18",4011176,4011199,24,71,6,101
"10232","chr18",4265469,4265706,238,76,41,355
"10233","chr18",4510185,4510216,32,37,4,73
"10234","chr18",4512311,4512355,45,31,53,129
"10235","chr18",4707301,4707320,20,145,26,191
"10236","chr18",5064826,5064846,21,76,43,140
"10237","chr18",5469774,5469791,18,69,41,128
"10238","chr18",5629410,5629450,41,13,17,71
"10239","chr18",5891374,5891406,33,65,32,130
"10240","chr18",5895561,5895585,25,13,5,43
"10241","chr18",6185961,6186029,69,35,82,186
"10242","chr18",6414604,6414622,19,60,63,142
"10243","chr18",6491564,6491583,20,7,76,103
"10244","chr18",6920268,6920474,207,28,66,301
"10245","chr18",6937471,6937489,19,93,29,141
"10246","chr18",7003418,7003440,23,38,75,136
"10247","chr18",7012478,7012522,45,75,135,255
"10248","chr18",7023836,7023854,19,6,87,112
"10249","chr18",7115815,7115833,19,24,27,70
"10250","chr18",7136583,7136605,23,8,63,94
"10251","chr18",7139060,7139089,30,77,35,142
"10252","chr18",7139239,7139256,18,145,74,237
"10253","chr18",7149610,7149628,19,104,5,128
"10254","chr18",7160891,7160911,21,12,6,39
"10255","chr18",7251228,7251258,31,8,139,178
"10256","chr18",7253371,7253396,26,28,4,58
"10257","chr18",7266121,7266138,18,7,75,100
"10258","chr18",7296902,7296920,19,8,115,142
"10259","chr18",7331515,7331533,19,73,77,169
"10260","chr18",7343230,7343255,26,59,71,156
"10261","chr18",7345135,7345161,27,145,73,245
"10262","chr18",7427011,7427034,24,10,27,61
"10263","chr18",7567432,7567466,35,92,15,142
"10264","chr18",8427208,8427226,19,109,82,210
"10265","chr18",8609487,8609510,24,4,15,43
"10266","chr18",8705586,8705611,26,10,61,97
"10267","chr18",8775409,8775426,18,81,33,132
"10268","chr18",8785013,8785035,23,18,114,155
"10269","chr18",8823036,8823057,22,13,62,97
"10270","chr18",9038988,9039028,41,60,5,106
"10271","chr18",9486210,9486315,106,81,81,268
"10272","chr18",9614686,9614704,19,76,12,107
"10273","chr18",9653851,9653875,25,33,140,198
"10274","chr18",9700791,9700810,20,32,69,121
"10275","chr18",9770853,9770871,19,88,5,112
"10276","chr18",10844423,10844453,31,94,3,128
"10277","chr18",11045296,11045321,26,21,7,54
"10278","chr18",11596721,11596773,53,48,3,104
"10279","chr18",11689660,11689682,23,88,130,241
"10280","chr18",11896096,11896119,24,45,64,133
"10281","chr18",11912953,11912974,22,38,109,169
"10282","chr18",11933817,11933858,42,37,33,112
"10283","chr18",11969550,11969571,22,72,130,224
"10284","chr18",11973049,11973068,20,7,83,110
"10285","chr18",11978191,11978214,24,53,131,208
"10286","chr18",11978212,11978237,26,8,110,144
"10287","chr18",12007959,12007983,25,70,12,107
"10288","chr18",12308186,12308203,18,121,12,151
"10289","chr18",12375984,12376007,24,42,48,114
"10290","chr18",12389443,12389465,23,41,74,138
"10291","chr18",12407249,12407287,39,8,19,66
"10292","chr18",12426251,12426268,18,143,31,192
"10293","chr18",12658110,12658166,57,7,2,66
"10294","chr18",12709024,12709054,31,67,136,234
"10295","chr18",12761130,12761153,24,27,5,56
"10296","chr18",12883871,12883889,19,14,36,69
"10297","chr18",12884352,12884370,19,93,6,118
"10298","chr18",12897193,12897233,41,77,49,167
"10299","chr18",12910286,12910323,38,25,2,65
"10300","chr18",12910347,12910372,26,74,10,110
"10301","chr18",12923673,12923719,47,18,19,84
"10302","chr18",13132457,13132485,29,13,4,46
"10303","chr18",13224475,13224497,23,8,19,50
"10304","chr18",13253139,13253156,18,32,14,64
"10305","chr18",13459370,13459398,29,6,11,46
"10306","chr18",13475428,13475446,19,69,13,101
"10307","chr18",13578828,13578855,28,94,144,266
"10308","chr18",13677480,13677517,38,59,39,136
"10309","chr18",13790599,13790630,32,126,74,232
"10310","chr18",14178924,14178941,18,7,8,33
"10311","chr18",14378589,14378611,23,4,141,168
"10312","chr18",14431001,14431023,23,54,19,96
"10313","chr18",14450362,14450387,26,27,109,162
"10314","chr18",14993332,14993352,21,124,23,168
"10315","chr18",15021650,15021672,23,126,83,232
"10316","chr18",21078342,21078374,33,20,61,114
"10317","chr18",21078374,21078400,27,46,29,102
"10318","chr18",21207616,21207634,19,72,37,128
"10319","chr18",21257005,21257025,21,49,74,144
"10320","chr18",21397525,21397543,19,69,6,94
"10321","chr18",21428711,21428733,23,124,113,260
"10322","chr18",21551113,21551140,28,99,5,132
"10323","chr18",21595365,21595386,22,145,83,250
"10324","chr18",21611048,21611082,35,20,3,58
"10325","chr18",21719613,21719630,18,29,94,141
"10326","chr18",21741528,21741563,36,13,83,132
"10327","chr18",21980528,21980566,39,28,7,74
"10328","chr18",22001146,22001168,23,63,146,232
"10329","chr18",22050230,22050248,19,68,35,122
"10330","chr18",22050408,22050431,24,136,5,165
"10331","chr18",22052257,22052276,20,8,12,40
"10332","chr18",22086690,22086711,22,61,73,156
"10333","chr18",22127985,22128028,44,93,57,194
"10334","chr18",22172112,22172142,31,29,18,78
"10335","chr18",22994015,22994038,24,11,133,168
"10336","chr18",23121086,23121103,18,28,76,122
"10337","chr18",23132939,23132969,31,27,100,158
"10338","chr18",23135765,23135782,18,14,59,91
"10339","chr18",23161755,23161775,21,80,27,128
"10340","chr18",23215743,23215771,29,76,54,159
"10341","chr18",23450564,23450581,18,146,21,185
"10342","chr18",23466690,23466712,23,5,42,70
"10343","chr18",23477767,23477785,19,58,2,79
"10344","chr18",23503513,23503530,18,22,16,56
"10345","chr18",23524942,23524965,24,77,24,125
"10346","chr18",23586972,23587018,47,143,82,272
"10347","chr18",23662614,23662651,38,12,91,141
"10348","chr18",23854645,23854669,25,114,70,209
"10349","chr18",23860694,23860711,18,8,10,36
"10350","chr18",24014742,24014766,25,40,67,132
"10351","chr18",24272237,24272270,34,79,11,124
"10352","chr18",24302064,24302081,18,143,36,197
"10353","chr18",24302978,24303013,36,3,109,148
"10354","chr18",24376890,24376907,18,60,5,83
"10355","chr18",24861269,24861292,24,48,147,219
"10356","chr18",25308194,25308219,26,54,82,162
"10357","chr18",25351873,25351922,50,39,67,156
"10358","chr18",25351928,25351974,47,91,12,150
"10359","chr18",26184774,26184792,19,135,6,160
"10360","chr18",26421215,26421238,24,76,115,215
"10361","chr18",26550558,26550605,48,76,43,167
"10362","chr18",26632051,26632072,22,116,5,143
"10363","chr18",27185103,27185127,25,6,102,133
"10364","chr18",27888979,27889006,28,42,19,89
"10365","chr18",28176824,28176846,23,58,95,176
"10366","chr18",28622563,28622580,18,29,64,111
"10367","chr18",29118338,29118355,18,65,39,122
"10368","chr18",29413461,29413491,31,141,72,244
"10369","chr18",30172630,30172655,26,74,133,233
"10370","chr18",30231782,30231823,42,77,68,187
"10371","chr18",31446609,31446626,18,50,6,74
"10372","chr18",31446624,31446646,23,70,59,152
"10373","chr18",31618065,31618092,28,8,30,66
"10374","chr18",31741070,31741092,23,145,53,221
"10375","chr18",31785432,31785451,20,74,6,100
"10376","chr18",31911757,31911780,24,135,119,278
"10377","chr18",31943294,31943331,38,131,85,254
"10378","chr18",32026243,32026266,24,76,145,245
"10379","chr18",32048258,32048276,19,145,25,189
"10380","chr18",32091268,32091296,29,78,10,117
"10381","chr18",32093943,32093966,24,26,62,112
"10382","chr18",32143326,32143362,37,35,33,105
"10383","chr18",32922521,32922547,27,62,74,163
"10384","chr18",33015261,33015295,35,25,1,61
"10385","chr18",33067835,33067853,19,108,15,142
"10386","chr18",33448171,33448188,18,7,128,153
"10387","chr18",33578359,33578408,50,18,49,117
"10388","chr18",33578459,33578505,47,115,9,171
"10389","chr18",34976872,34976902,31,39,3,73
"10390","chr18",34976948,34976966,19,45,124,188
"10391","chr18",35146714,35146732,19,4,14,37
"10392","chr18",35384934,35384952,19,77,33,129
"10393","chr18",35581829,35581855,27,19,24,70
"10394","chr18",35843971,35843995,25,31,143,199
"10395","chr18",36927762,36927784,23,6,119,148
"10396","chr18",37165587,37165608,22,7,143,172
"10397","chr18",37243909,37243928,20,106,57,183
"10398","chr18",37298725,37298742,18,52,43,113
"10399","chr18",37311789,37311806,18,124,74,216
"10400","chr18",37320336,37320356,21,85,74,180
"10401","chr18",37367682,37367710,29,50,51,130
"10402","chr18",38050868,38050904,37,76,6,119
"10403","chr18",39799770,39799788,19,6,74,99
"10404","chr18",40591527,40591574,48,145,35,228
"10405","chr18",40780974,40780998,25,45,73,143
"10406","chr18",40863131,40863156,26,27,76,129
"10407","chr18",40963884,40963938,55,126,5,186
"10408","chr18",43221949,43221977,29,5,6,40
"10409","chr18",43873759,43873796,38,4,6,48
"10410","chr18",43979836,43979856,21,7,51,79
"10411","chr18",44031899,44031933,35,80,112,227
"10412","chr18",44663903,44663924,22,68,63,153
"10413","chr18",44679622,44679669,48,68,84,200
"10414","chr18",44679683,44679708,26,107,23,156
"10415","chr18",44716326,44716348,23,78,1,102
"10416","chr18",44716561,44716579,19,7,10,36
"10417","chr18",44744770,44744794,25,118,37,180
"10418","chr18",44839407,44839433,27,111,76,214
"10419","chr18",45013413,45013437,25,56,33,114
"10420","chr18",45788035,45788056,22,3,74,99
"10421","chr18",45966061,45966086,26,9,66,101
"10422","chr18",45974919,45974955,37,8,75,120
"10423","chr18",45997633,45997673,41,88,55,184
"10424","chr18",46131465,46131486,22,74,71,167
"10425","chr18",46170725,46170755,31,69,54,154
"10426","chr18",46302457,46302483,27,137,77,241
"10427","chr18",46334242,46334261,20,23,79,122
"10428","chr18",46432948,46432977,30,13,3,46
"10429","chr18",46441862,46441880,19,12,99,130
"10430","chr18",47044761,47044791,31,136,6,173
"10431","chr18",47246663,47246685,23,1,109,133
"10432","chr18",47247070,47247101,32,1,106,139
"10433","chr18",47247179,47247222,44,63,76,183
"10434","chr18",47271284,47271311,28,76,89,193
"10435","chr18",47930558,47930614,57,1,91,149
"10436","chr18",48005597,48005623,27,8,143,178
"10437","chr18",48032423,48032452,30,76,1,107
"10438","chr18",48150582,48150601,20,51,74,145
"10439","chr18",48161691,48161711,21,15,19,55
"10440","chr18",48161713,48161736,24,6,33,63
"10441","chr18",48328182,48328200,19,24,6,49
"10442","chr18",48408913,48408942,30,29,33,92
"10443","chr18",48539090,48539144,55,68,64,187
"10444","chr18",48681773,48681803,31,8,12,51
"10445","chr18",48796171,48796191,21,76,67,164
"10446","chr18",48937265,48937307,43,4,72,119
"10447","chr18",48976180,48976201,22,32,29,83
"10448","chr18",49027461,49027503,43,31,113,187
"10449","chr18",49232604,49232627,24,77,143,244
"10450","chr18",49258782,49258840,59,91,76,226
"10451","chr18",49258840,49258886,47,137,18,202
"10452","chr18",49497315,49497359,45,75,23,143
"10453","chr18",49502278,49502307,30,65,6,101
"10454","chr18",50039324,50039350,27,9,8,44
"10455","chr18",50207291,50207337,47,58,33,138
"10456","chr18",50525804,50525823,20,133,34,187
"10457","chr18",50560063,50560088,26,25,40,91
"10458","chr18",50841432,50841450,19,35,76,130
"10459","chr18",51030712,51030733,22,75,92,189
"10460","chr18",51196768,51196793,26,36,26,88
"10461","chr18",51197217,51197267,51,62,9,122
"10462","chr18",51448001,51448040,40,11,55,106
"10463","chr18",51545453,51545482,30,63,67,160
"10464","chr18",51664020,51664041,22,10,55,87
"10465","chr18",51832461,51832496,36,21,6,63
"10466","chr18",52459457,52459483,27,6,67,100
"10467","chr18",52711154,52711177,24,8,34,66
"10468","chr18",53876196,53876216,21,106,6,133
"10469","chr18",54000823,54000851,29,35,7,71
"10470","chr18",54134874,54135149,276,93,105,474
"10471","chr18",54224199,54224247,49,20,39,108
"10472","chr18",54224273,54224337,65,63,12,140
"10473","chr18",54577650,54577668,19,25,5,49
"10474","chr18",55566213,55566253,41,101,7,149
"10475","chr18",55588100,55588122,23,34,44,101
"10476","chr18",55588157,55588179,23,91,21,135
"10477","chr18",55695956,55695978,23,87,61,171
"10478","chr18",56411239,56411259,21,11,7,39
"10479","chr18",56568505,56568527,23,42,8,73
"10480","chr18",56596425,56596444,20,52,2,74
"10481","chr18",56611846,56611864,19,6,143,168
"10482","chr18",57327829,57327846,18,69,11,98
"10483","chr18",57352733,57352770,38,53,20,111
"10484","chr18",57434377,57434420,44,36,42,122
"10485","chr18",57435824,57435874,51,145,25,221
"10486","chr18",57546960,57546977,18,133,5,156
"10487","chr18",57685933,57685957,25,139,72,236
"10488","chr18",57803350,57803372,23,82,74,179
"10489","chr18",58128012,58128064,53,8,140,201
"10490","chr18",58574439,58574460,22,97,16,135
"10491","chr18",58663742,58663767,26,18,74,118
"10492","chr18",58835995,58836012,18,3,74,95
"10493","chr18",58863505,58863525,21,12,22,55
"10494","chr18",59034903,59034947,45,5,21,71
"10495","chr18",59100160,59100212,53,54,127,234
"10496","chr18",59825682,59825710,29,8,14,51
"10497","chr18",59838247,59838272,26,18,6,50
"10498","chr18",60415828,60415845,18,78,74,170
"10499","chr18",60422046,60422068,23,103,7,133
"10500","chr18",61538579,61538637,59,77,45,181
"10501","chr18",61648831,61648860,30,39,6,75
"10502","chr18",61769250,61769272,23,17,137,177
"10503","chr18",61820021,61820041,21,141,74,236
"10504","chr18",61966724,61966765,42,125,14,181
"10505","chr18",62041641,62041706,66,33,147,246
"10506","chr18",62252163,62252180,18,38,143,199
"10507","chr18",62281091,62281119,29,42,126,197
"10508","chr18",62523530,62523573,44,55,130,229
"10509","chr18",62523598,62523615,18,97,62,177
"10510","chr18",62712666,62712688,23,6,71,100
"10511","chr18",63133320,63133340,21,40,75,136
"10512","chr18",63320076,63320127,52,1,31,84
"10513","chr18",63320691,63320739,49,24,26,99
"10514","chr18",63324177,63324203,27,125,69,221
"10515","chr18",63361002,63361072,71,88,24,183
"10516","chr18",63367331,63367356,26,22,66,114
"10517","chr18",63851612,63851631,20,7,33,60
"10518","chr18",63970131,63970150,20,109,2,131
"10519","chr18",63970149,63970167,19,126,66,211
"10520","chr18",64026713,64026739,27,110,50,187
"10521","chr18",64878066,64878088,23,86,143,252
"10522","chr18",65440702,65440731,30,77,83,190
"10523","chr18",65732752,65732779,28,109,129,266
"10524","chr18",66187526,66187544,19,7,12,38
"10525","chr18",67296384,67296419,36,30,5,71
"10526","chr18",68623992,68624019,28,68,6,102
"10527","chr18",68889589,68889615,27,32,141,200
"10528","chr18",69232967,69232986,20,148,25,193
"10529","chr18",69471251,69471279,29,87,4,120
"10530","chr18",70247826,70247848,23,69,5,97
"10531","chr18",70283478,70283496,19,4,69,92
"10532","chr18",70288985,70289017,33,5,18,56
"10533","chr18",70289589,70289616,28,10,24,62
"10534","chr18",70384108,70384149,42,44,67,153
"10535","chr18",70394591,70394646,56,72,75,203
"10536","chr18",70429121,70429154,34,131,77,242
"10537","chr18",71643998,71644044,47,75,107,229
"10538","chr18",71652152,71652181,30,15,30,75
"10539","chr18",72024466,72024492,27,29,143,199
"10540","chr18",72544613,72544641,29,53,29,111
"10541","chr18",72590266,72590297,32,78,5,115
"10542","chr18",72867706,72867724,19,14,19,52
"10543","chr18",72867777,72867805,29,95,66,190
"10544","chr18",73459842,73459881,40,11,114,165
"10545","chr18",73460028,73460048,21,88,143,252
"10546","chr18",74164769,74164805,37,8,4,49
"10547","chr18",74173702,74173725,24,9,28,61
"10548","chr18",74174071,74174101,31,58,79,168
"10549","chr18",74485203,74485244,42,68,53,163
"10550","chr18",74738423,74738448,26,138,71,235
"10551","chr18",75060486,75060523,38,8,53,99
"10552","chr18",75079678,75079699,22,76,75,173
"10553","chr18",75196633,75196657,25,81,5,111
"10554","chr18",75208784,75208801,18,12,72,102
"10555","chr18",75901934,75901951,18,141,47,206
"10556","chr18",76038403,76038445,43,120,128,291
"10557","chr18",76491274,76491300,27,18,59,104
"10558","chr18",76631554,76631576,23,77,73,173
"10559","chr18",76681688,76681711,24,45,34,103
"10560","chr18",76685058,76685087,30,75,70,175
"10561","chr18",76686534,76686562,29,37,78,144
"10562","chr18",76772775,76772934,160,43,101,304
"10563","chr18",76794058,76794076,19,130,4,153
"10564","chr18",76807426,76807448,23,128,70,221
"10565","chr18",76814740,76814773,34,66,11,111
"10566","chr18",76820472,76820492,21,52,71,144
"10567","chr18",76820667,76820686,20,29,74,123
"10568","chr18",76822326,76822345,20,22,3,45
"10569","chr18",76822553,76822579,27,28,5,60
"10570","chr18",76826278,76826295,18,27,76,121
"10571","chr18",76843776,76843805,30,137,7,174
"10572","chr18",77087659,77087678,20,22,30,72
"10573","chr18",77676228,77676248,21,77,27,125
"10574","chr18",77690439,77690463,25,43,37,105
"10575","chr18",77690586,77690605,20,34,40,94
"10576","chr18",77690637,77690661,25,39,37,101
"10577","chr18",77690737,77690761,25,45,35,105
"10578","chr18",77690882,77690906,25,42,41,108
"10579","chr18",77691120,77691144,25,45,45,115
"10580","chr18",77822974,77823000,27,69,15,111
"10581","chr18",78014286,78014303,18,90,8,116
"10582","chr18",78919200,78919224,25,26,3,54
"10583","chr18",78929795,78929815,21,10,76,107
"10584","chr18",78974328,78974348,21,96,97,214
"10585","chr18",78979746,78979780,35,10,38,83
"10586","chr18",79394391,79394413,23,54,7,84
"10587","chr18",79400257,79400296,40,1,2,43
"10588","chr18",79400357,79400383,27,42,5,74
"10589","chr18",79424466,79425278,813,65,15,893
"10590","chr18",79429221,79429240,20,86,7,113
"10591","chr18",79598988,79599005,18,33,84,135
"10592","chr18",79710687,79710718,32,28,144,204
"10593","chr18",79783479,79783515,37,74,33,144
"10594","chr18",79857994,79858018,25,76,115,216
"10595","chr18",79884542,79884565,24,36,6,66
"10596","chr18",79964473,79964492,20,9,93,122
"10597","chr18",79967148,79967165,18,41,7,66
"10598","chr18",80111567,80111584,18,76,32,126
"10599","chr18",80247422,80247449,28,21,88,137
"10600","chr18",80247581,80247608,28,97,1,126
"10601","chr19",291427,291626,200,2,81,283
"10602","chr19",297344,297372,29,9,43,81
"10603","chr19",317532,317571,40,68,1,109
"10604","chr19",321887,321922,36,76,62,174
"10605","chr19",344923,344945,23,104,42,169
"10606","chr19",347670,347692,23,76,1,100
"10607","chr19",409115,409132,18,4,2,24
"10608","chr19",409177,409194,18,12,3,33
"10609","chr19",409213,409241,29,14,13,56
"10610","chr19",421048,421086,39,117,76,232
"10611","chr19",463301,463320,20,11,74,105
"10612","chr19",471140,471163,24,5,34,63
"10613","chr19",504256,504279,24,74,140,238
"10614","chr19",523980,524001,22,79,6,107
"10615","chr19",529372,529394,23,8,74,105
"10616","chr19",530825,530844,20,30,8,58
"10617","chr19",570146,570168,23,76,72,171
"10618","chr19",588055,588087,33,140,38,211
"10619","chr19",589795,589828,34,4,98,136
"10620","chr19",589896,589914,19,61,146,226
"10621","chr19",590008,590067,60,10,34,104
"10622","chr19",590340,590366,27,54,10,91
"10623","chr19",613675,613724,50,6,35,91
"10624","chr19",627925,627944,20,74,6,100
"10625","chr19",645601,645618,18,64,7,89
"10626","chr19",654643,654679,37,142,6,185
"10627","chr19",669614,669651,38,8,14,60
"10628","chr19",693231,693250,20,19,7,46
"10629","chr19",698897,698925,29,28,142,199
"10630","chr19",709066,709084,19,32,34,85
"10631","chr19",714347,714376,30,8,3,41
"10632","chr19",759400,759417,18,76,69,163
"10633","chr19",770295,770318,24,71,6,101
"10634","chr19",771343,771363,21,136,3,160
"10635","chr19",776100,776120,21,106,72,199
"10636","chr19",776416,776468,53,27,73,153
"10637","chr19",777205,777227,23,144,2,169
"10638","chr19",783537,783563,27,13,86,126
"10639","chr19",784460,784477,18,146,55,219
"10640","chr19",800102,800119,18,41,107,166
"10641","chr19",807643,807679,37,128,96,261
"10642","chr19",812611,812642,32,103,21,156
"10643","chr19",813343,813407,65,119,18,202
"10644","chr19",821974,822004,31,13,24,68
"10645","chr19",822284,822307,24,4,8,36
"10646","chr19",825312,825332,21,5,44,70
"10647","chr19",829937,829975,39,143,23,205
"10648","chr19",834670,834687,18,8,59,85
"10649","chr19",845950,845972,23,33,79,135
"10650","chr19",847473,847597,125,49,38,212
"10651","chr19",864794,864831,38,3,6,47
"10652","chr19",879000,879020,21,125,71,217
"10653","chr19",888203,888225,23,133,7,163
"10654","chr19",898405,898422,18,49,74,141
"10655","chr19",911125,911149,25,133,2,160
"10656","chr19",914583,914608,26,12,10,48
"10657","chr19",921444,921473,30,94,52,176
"10658","chr19",924391,924409,19,7,142,168
"10659","chr19",929363,929380,18,16,73,107
"10660","chr19",929482,929512,31,17,26,74
"10661","chr19",946251,946279,29,8,17,54
"10662","chr19",946440,946460,21,10,64,95
"10663","chr19",971934,971951,18,1,9,28
"10664","chr19",973105,973125,21,40,13,74
"10665","chr19",981475,981498,24,9,37,70
"10666","chr19",996857,996883,27,74,17,118
"10667","chr19",1000581,1000602,22,23,56,101
"10668","chr19",1008314,1008340,27,1,52,80
"10669","chr19",1009187,1009206,20,111,8,139
"10670","chr19",1025576,1025609,34,8,16,58
"10671","chr19",1026609,1026627,19,2,2,23
"10672","chr19",1043938,1043955,18,9,6,33
"10673","chr19",1044239,1044263,25,6,8,39
"10674","chr19",1048497,1048524,28,144,74,246
"10675","chr19",1052347,1052741,395,106,98,599
"10676","chr19",1060515,1060537,23,8,141,172
"10677","chr19",1070297,1070348,52,8,145,205
"10678","chr19",1070498,1070526,29,6,143,178
"10679","chr19",1072013,1072076,64,33,58,155
"10680","chr19",1085847,1085870,24,28,145,197
"10681","chr19",1103313,1103330,18,141,65,224
"10682","chr19",1108582,1108608,27,3,30,60
"10683","chr19",1135046,1135069,24,110,74,208
"10684","chr19",1144515,1145085,571,48,48,667
"10685","chr19",1156428,1156448,21,1,78,100
"10686","chr19",1161907,1161925,19,102,30,151
"10687","chr19",1172991,1173008,18,80,105,203
"10688","chr19",1176636,1176655,20,9,112,141
"10689","chr19",1181407,1181605,199,16,133,348
"10690","chr19",1183211,1183234,24,12,97,133
"10691","chr19",1183233,1183250,18,28,75,121
"10692","chr19",1194867,1194901,35,69,13,117
"10693","chr19",1200153,1200176,24,6,67,97
"10694","chr19",1208307,1208325,19,8,34,61
"10695","chr19",1248491,1248524,34,16,80,130
"10696","chr19",1249595,1249625,31,34,5,70
"10697","chr19",1275576,1275606,31,20,20,71
"10698","chr19",1286085,1286105,21,94,2,117
"10699","chr19",1299238,1299270,33,9,6,48
"10700","chr19",1299556,1299574,19,61,6,86
"10701","chr19",1306355,1306372,18,73,8,99
"10702","chr19",1307106,1307123,18,81,145,244
"10703","chr19",1307265,1307285,21,36,78,135
"10704","chr19",1319446,1319482,37,5,55,97
"10705","chr19",1326278,1326298,21,76,41,138
"10706","chr19",1328596,1328619,24,97,5,126
"10707","chr19",1331496,1331522,27,29,8,64
"10708","chr19",1343720,1343738,19,66,4,89
"10709","chr19",1347796,1347813,18,77,27,122
"10710","chr19",1354985,1355021,37,3,14,54
"10711","chr19",1389884,1389919,36,15,19,70
"10712","chr19",1395489,1395508,20,45,14,79
"10713","chr19",1403176,1403199,24,24,75,123
"10714","chr19",1407620,1407662,43,71,52,166
"10715","chr19",1461852,1461878,27,112,6,145
"10716","chr19",1465821,1465839,19,53,9,81
"10717","chr19",1470554,1470581,28,8,129,165
"10718","chr19",1478413,1478445,33,27,70,130
"10719","chr19",1483947,1483967,21,63,9,93
"10720","chr19",1525092,1525110,19,78,106,203
"10721","chr19",1530605,1530637,33,8,78,119
"10722","chr19",1532522,1532540,19,76,42,137
"10723","chr19",1534650,1534667,18,77,27,122
"10724","chr19",1539684,1539710,27,59,4,90
"10725","chr19",1541246,1541286,41,66,9,116
"10726","chr19",1543351,1543371,21,145,3,169
"10727","chr19",1545310,1545331,22,7,6,35
"10728","chr19",1553855,1553884,30,8,44,82
"10729","chr19",1556142,1556172,31,52,2,85
"10730","chr19",1567986,1568032,47,36,83,166
"10731","chr19",1568182,1568248,67,2,115,184
"10732","chr19",1568272,1568329,58,16,25,99
"10733","chr19",1568436,1568467,32,105,86,223
"10734","chr19",1579182,1579209,28,93,76,197
"10735","chr19",1592382,1592420,39,24,64,127
"10736","chr19",1592688,1592733,46,90,9,145
"10737","chr19",1603607,1603639,33,72,4,109
"10738","chr19",1605253,1605272,20,24,36,80
"10739","chr19",1652619,1652673,55,106,20,181
"10740","chr19",1666202,1666223,22,7,106,135
"10741","chr19",1683663,1683697,35,9,74,118
"10742","chr19",1714167,1714197,31,99,71,201
"10743","chr19",1743709,1743726,18,8,101,127
"10744","chr19",1744650,1744682,33,41,30,104
"10745","chr19",1747418,1747454,37,44,22,103
"10746","chr19",1753827,1753894,68,87,59,214
"10747","chr19",1755184,1755207,24,39,43,106
"10748","chr19",1763367,1763396,30,117,3,150
"10749","chr19",1777023,1777078,56,50,97,203
"10750","chr19",1784523,1784541,19,23,66,108
"10751","chr19",1795551,1795588,38,74,74,186
"10752","chr19",1798745,1798770,26,57,67,150
"10753","chr19",1815644,1815670,27,33,105,165
"10754","chr19",1827016,1827048,33,93,16,142
"10755","chr19",1836744,1836767,24,124,8,156
"10756","chr19",1863583,1863608,26,5,124,155
"10757","chr19",1864579,1864596,18,23,5,46
"10758","chr19",1897237,1897269,33,3,34,70
"10759","chr19",1929697,1929734,38,118,73,229
"10760","chr19",1946590,1946609,20,55,146,221
"10761","chr19",1946605,1946624,20,70,131,221
"10762","chr19",1950112,1950157,46,76,50,172
"10763","chr19",1969225,1969247,23,15,103,141
"10764","chr19",1978760,1978778,19,28,96,143
"10765","chr19",2015542,2015580,39,69,63,171
"10766","chr19",2031475,2031502,28,71,14,113
"10767","chr19",2031725,2031758,34,8,7,49
"10768","chr19",2034318,2034341,24,7,17,48
"10769","chr19",2081887,2081906,20,59,31,110
"10770","chr19",2085374,2085392,19,59,63,141
"10771","chr19",2085964,2085986,23,140,6,169
"10772","chr19",2094042,2094064,23,8,61,92
"10773","chr19",2102729,2102788,60,136,73,269
"10774","chr19",2163757,2163784,28,8,27,63
"10775","chr19",2164031,2164053,23,81,3,107
"10776","chr19",2166078,2166103,26,65,1,92
"10777","chr19",2182230,2182255,26,57,3,86
"10778","chr19",2190428,2190450,23,132,48,203
"10779","chr19",2203096,2203118,23,74,68,165
"10780","chr19",2206522,2206544,23,80,134,237
"10781","chr19",2221179,2221201,23,49,4,76
"10782","chr19",2227907,2227929,23,122,124,269
"10783","chr19",2259313,2259335,23,97,6,126
"10784","chr19",2269358,2269375,18,69,62,149
"10785","chr19",2289963,2289980,18,79,110,207
"10786","chr19",2299417,2299439,23,6,125,154
"10787","chr19",2299724,2299741,18,8,10,36
"10788","chr19",2300024,2300045,22,72,10,104
"10789","chr19",2304711,2304735,25,18,96,139
"10790","chr19",2308143,2308175,33,105,60,198
"10791","chr19",2330276,2330294,19,35,75,129
"10792","chr19",2393899,2393921,23,104,73,200
"10793","chr19",2405999,2406017,19,65,142,226
"10794","chr19",2414942,2414960,19,73,57,149
"10795","chr19",2456961,2456990,30,94,44,168
"10796","chr19",2462701,2462719,19,27,5,51
"10797","chr19",2462869,2462901,33,3,6,42
"10798","chr19",2466108,2466132,25,134,117,276
"10799","chr19",2470679,2470699,21,13,17,51
"10800","chr19",2481057,2481082,26,43,74,143
"10801","chr19",2494356,2494383,28,149,131,308
"10802","chr19",2495898,2495920,23,133,110,266
"10803","chr19",2506052,2506094,43,94,121,258
"10804","chr19",2508782,2508799,18,5,42,65
"10805","chr19",2514952,2515005,54,58,37,149
"10806","chr19",2521613,2521631,19,8,37,64
"10807","chr19",2529207,2529234,28,7,31,66
"10808","chr19",2548482,2548503,22,9,123,154
"10809","chr19",2580287,2580308,22,8,66,96
"10810","chr19",2586985,2587009,25,83,6,114
"10811","chr19",2602870,2603080,211,72,22,305
"10812","chr19",2624529,2624565,37,58,8,103
"10813","chr19",2624550,2624578,29,71,24,124
"10814","chr19",2655839,2655860,22,12,6,40
"10815","chr19",2673259,2673298,40,35,73,148
"10816","chr19",2682656,2682680,25,99,81,205
"10817","chr19",2684136,2684154,19,8,2,29
"10818","chr19",2696238,2696453,216,8,43,267
"10819","chr19",2721405,2721470,66,49,2,117
"10820","chr19",2729634,2729651,18,144,19,181
"10821","chr19",2752241,2752260,20,24,5,49
"10822","chr19",2765527,2765550,24,85,58,167
"10823","chr19",2867439,2867461,23,56,35,114
"10824","chr19",2872819,2872836,18,133,74,225
"10825","chr19",2894487,2894504,18,44,74,136
"10826","chr19",2942371,2942391,21,23,144,188
"10827","chr19",2952985,2953011,27,43,3,73
"10828","chr19",2961804,2961826,23,10,27,60
"10829","chr19",2966099,2966125,27,13,20,60
"10830","chr19",2970928,2970950,23,10,73,106
"10831","chr19",2974912,2974934,23,46,36,105
"10832","chr19",2990633,2990713,81,6,45,132
"10833","chr19",2993027,2993053,27,18,33,78
"10834","chr19",2993921,2993942,22,20,15,57
"10835","chr19",3015023,3015048,26,47,6,79
"10836","chr19",3016420,3016440,21,145,27,193
"10837","chr19",3042215,3042247,33,143,60,236
"10838","chr19",3059209,3059235,27,8,61,96
"10839","chr19",3059524,3059542,19,61,4,84
"10840","chr19",3065304,3065323,20,93,6,119
"10841","chr19",3070039,3070061,23,45,142,210
"10842","chr19",3081175,3081197,23,75,2,100
"10843","chr19",3086241,3086270,30,7,23,60
"10844","chr19",3087387,3087413,27,139,75,241
"10845","chr19",3092037,3092055,19,11,145,175
"10846","chr19",3094057,3094122,66,107,69,242
"10847","chr19",3094214,3094238,25,19,50,94
"10848","chr19",3110787,3110816,30,47,55,132
"10849","chr19",3141304,3141321,18,33,23,74
"10850","chr19",3148069,3148107,39,9,62,110
"10851","chr19",3195241,3195264,24,73,65,162
"10852","chr19",3198507,3198542,36,78,6,120
"10853","chr19",3206051,3206107,57,87,42,186
"10854","chr19",3213413,3213436,24,13,17,54
"10855","chr19",3224696,3224720,25,36,4,65
"10856","chr19",3225347,3225365,19,63,46,128
"10857","chr19",3228876,3228915,40,19,146,205
"10858","chr19",3237312,3237336,25,33,6,64
"10859","chr19",3263564,3263590,27,115,71,213
"10860","chr19",3263907,3263936,30,72,4,106
"10861","chr19",3268387,3268420,34,21,65,120
"10862","chr19",3275439,3275469,31,139,143,313
"10863","chr19",3290564,3290581,18,76,92,186
"10864","chr19",3296160,3296182,23,70,63,156
"10865","chr19",3296327,3296355,29,107,86,222
"10866","chr19",3301317,3301367,51,59,6,116
"10867","chr19",3314381,3314419,39,132,63,234
"10868","chr19",3314510,3314581,72,18,78,168
"10869","chr19",3317835,3317857,23,7,110,140
"10870","chr19",3343819,3343837,19,63,50,132
"10871","chr19",3354622,3354644,23,76,77,176
"10872","chr19",3367473,3367498,26,30,7,63
"10873","chr19",3371322,3371342,21,83,68,172
"10874","chr19",3381396,3381415,20,19,73,112
"10875","chr19",3397520,3397546,27,30,20,77
"10876","chr19",3407419,3407454,36,78,5,119
"10877","chr19",3417793,3417819,27,37,75,139
"10878","chr19",3436134,3436160,27,111,3,141
"10879","chr19",3436310,3436337,28,30,40,98
"10880","chr19",3439334,3439375,42,28,123,193
"10881","chr19",3462958,3462976,19,37,23,79
"10882","chr19",3483698,3483723,26,40,111,177
"10883","chr19",3508196,3508221,26,16,119,161
"10884","chr19",3525428,3525460,33,8,80,121
"10885","chr19",3539295,3539314,20,44,15,79
"10886","chr19",3553758,3553797,40,10,18,68
"10887","chr19",3559695,3559725,31,8,134,173
"10888","chr19",3569610,3569634,25,11,38,74
"10889","chr19",3570320,3570341,22,77,35,134
"10890","chr19",3570494,3570539,46,121,71,238
"10891","chr19",3575944,3575976,33,138,74,245
"10892","chr19",3597630,3597647,18,8,7,33
"10893","chr19",3597945,3597962,18,35,113,166
"10894","chr19",3602222,3602241,20,66,5,91
"10895","chr19",3613229,3613274,46,94,31,171
"10896","chr19",3633845,3633865,21,49,108,178
"10897","chr19",3694212,3694232,21,49,6,76
"10898","chr19",3706019,3706041,23,73,65,161
"10899","chr19",3710149,3710167,19,45,43,107
"10900","chr19",3720856,3720898,43,49,31,123
"10901","chr19",3732999,3733052,54,75,91,220
"10902","chr19",3736879,3736897,19,76,6,101
"10903","chr19",3740982,3741001,20,19,31,70
"10904","chr19",3740995,3741022,28,40,18,86
"10905","chr19",3748268,3748289,22,8,2,32
"10906","chr19",3780594,3780613,20,37,143,200
"10907","chr19",3789894,3789914,21,71,23,115
"10908","chr19",3815751,3815770,20,77,26,123
"10909","chr19",3821605,3821629,25,74,10,109
"10910","chr19",3896776,3896793,18,7,75,100
"10911","chr19",3940735,3940753,19,12,74,105
"10912","chr19",3948194,3948217,24,8,6,38
"10913","chr19",3951054,3951079,26,61,65,152
"10914","chr19",3952612,3952631,20,75,139,234
"10915","chr19",3954563,3954583,21,22,91,134
"10916","chr19",3987537,3987557,21,124,1,146
"10917","chr19",3991398,3991428,31,4,72,107
"10918","chr19",3996492,3996523,32,5,100,137
"10919","chr19",4023460,4023493,34,32,74,140
"10920","chr19",4037770,4037802,33,74,77,184
"10921","chr19",4038719,4038736,18,14,14,46
"10922","chr19",4047601,4047640,40,28,71,139
"10923","chr19",4047868,4047891,24,46,45,115
"10924","chr19",4051097,4051124,28,80,8,116
"10925","chr19",4065465,4065492,28,35,11,74
"10926","chr19",4072433,4072456,24,11,139,174
"10927","chr19",4074187,4074210,24,146,82,252
"10928","chr19",4076060,4076080,21,22,6,49
"10929","chr19",4085018,4085047,30,13,97,140
"10930","chr19",4100247,4100276,30,77,5,112
"10931","chr19",4100430,4100455,26,78,70,174
"10932","chr19",4107524,4107546,23,106,6,135
"10933","chr19",4117927,4117955,29,8,51,88
"10934","chr19",4125964,4125987,24,56,65,145
"10935","chr19",4129198,4129225,28,46,115,189
"10936","chr19",4154051,4154088,38,7,34,79
"10937","chr19",4160901,4160929,29,76,75,180
"10938","chr19",4163306,4163386,81,80,8,169
"10939","chr19",4167974,4168015,42,75,21,138
"10940","chr19",4172312,4172368,57,13,24,94
"10941","chr19",4172406,4172455,50,66,26,142
"10942","chr19",4183911,4183933,23,128,94,245
"10943","chr19",4191476,4191498,23,75,75,173
"10944","chr19",4197962,4198009,48,13,147,208
"10945","chr19",4203958,4203981,24,8,137,169
"10946","chr19",4206145,4206201,57,136,3,196
"10947","chr19",4218279,4218314,36,42,57,135
"10948","chr19",4219286,4219314,29,11,74,114
"10949","chr19",4255057,4255074,18,77,72,167
"10950","chr19",4259067,4259100,34,12,78,124
"10951","chr19",4267936,4267970,35,17,13,65
"10952","chr19",4278978,4279013,36,49,23,108
"10953","chr19",4282421,4282439,19,58,18,95
"10954","chr19",4330712,4330733,22,77,126,225
"10955","chr19",4339030,4339052,23,40,55,118
"10956","chr19",4344736,4344756,21,76,13,110
"10957","chr19",4345041,4345065,25,76,145,246
"10958","chr19",4364728,4364756,29,48,66,143
"10959","chr19",4457796,4457823,28,12,66,106
"10960","chr19",4460155,4460190,36,21,4,61
"10961","chr19",4472272,4472302,31,6,25,62
"10962","chr19",4476190,4476211,22,77,10,109
"10963","chr19",4484089,4484107,19,14,145,178
"10964","chr19",4493787,4493816,30,62,127,219
"10965","chr19",4514729,4514759,31,13,4,48
"10966","chr19",4544626,4544650,25,5,59,89
"10967","chr19",4549475,4549495,21,75,69,165
"10968","chr19",4563076,4563093,18,76,45,139
"10969","chr19",4572272,4572293,22,76,133,231
"10970","chr19",4596864,4596902,39,10,115,164
"10971","chr19",4630332,4630351,20,10,11,41
"10972","chr19",4635481,4635499,19,104,85,208
"10973","chr19",4639506,4639536,31,42,29,102
"10974","chr19",4650988,4651026,39,75,39,153
"10975","chr19",4651010,4651031,22,80,17,119
"10976","chr19",4695885,4695913,29,3,50,82
"10977","chr19",4707615,4707641,27,6,44,77
"10978","chr19",4739740,4739760,21,41,8,70
"10979","chr19",4744121,4744144,24,12,76,112
"10980","chr19",4750610,4750633,24,76,57,157
"10981","chr19",4750925,4750945,21,45,135,201
"10982","chr19",4751847,4751969,123,6,74,203
"10983","chr19",4759742,4759772,31,32,129,192
"10984","chr19",4798232,4798263,32,84,7,123
"10985","chr19",4806942,4806976,35,75,142,252
"10986","chr19",4841905,4841937,33,74,74,181
"10987","chr19",4850588,4850615,28,6,143,177
"10988","chr19",4876929,4876952,24,140,32,196
"10989","chr19",4883316,4883354,39,76,138,253
"10990","chr19",4894511,4894534,24,145,6,175
"10991","chr19",4899765,4899789,25,77,36,138
"10992","chr19",4900125,4900165,41,76,138,255
"10993","chr19",4910512,4910539,28,124,22,174
"10994","chr19",4927068,4927098,31,147,1,179
"10995","chr19",4931928,4931950,23,77,75,175
"10996","chr19",4941081,4941108,28,76,37,141
"10997","chr19",4974404,4974451,48,8,1,57
"10998","chr19",5021637,5021656,20,13,10,43
"10999","chr19",5050901,5050926,26,8,5,39
"11000","chr19",5057030,5057066,37,23,60,120
"11001","chr19",5065723,5065748,26,5,56,87
"11002","chr19",5119792,5119809,18,95,18,131
"11003","chr19",5145592,5145609,18,36,63,117
"11004","chr19",5208478,5208496,19,4,16,39
"11005","chr19",5229457,5229482,26,32,145,203
"11006","chr19",5229694,5229711,18,38,53,109
"11007","chr19",5240890,5240907,18,8,23,49
"11008","chr19",5244968,5244998,31,77,145,253
"11009","chr19",5293921,5293946,26,15,144,185
"11010","chr19",5305747,5305766,20,53,16,89
"11011","chr19",5340880,5340899,20,54,44,118
"11012","chr19",5341616,5341635,20,34,146,200
"11013","chr19",5365540,5365664,125,13,145,283
"11014","chr19",5395541,5395568,28,76,23,127
"11015","chr19",5405752,5405774,23,24,6,53
"11016","chr19",5405966,5406001,36,140,85,261
"11017","chr19",5465041,5465066,26,89,117,232
"11018","chr19",5467988,5468017,30,3,73,106
"11019","chr19",5471975,5471994,20,8,146,174
"11020","chr19",5494436,5494457,22,148,4,174
"11021","chr19",5511850,5511905,56,3,135,194
"11022","chr19",5539526,5539552,27,27,7,61
"11023","chr19",5559335,5559352,18,8,40,66
"11024","chr19",5574494,5574522,29,8,134,171
"11025","chr19",5591273,5591295,23,75,71,169
"11026","chr19",5613943,5613969,27,6,125,158
"11027","chr19",5622840,5622858,19,37,7,63
"11028","chr19",5723767,5723794,28,76,7,111
"11029","chr19",5751198,5751242,45,4,21,70
"11030","chr19",5760074,5760097,24,147,9,180
"11031","chr19",5772215,5772245,31,8,143,182
"11032","chr19",5792008,5792026,19,147,76,242
"11033","chr19",5796923,5796941,19,8,6,33
"11034","chr19",5802676,5802719,44,2,146,192
"11035","chr19",5802767,5802798,32,5,55,92
"11036","chr19",5804997,5805036,40,56,22,118
"11037","chr19",5810266,5810284,19,27,75,121
"11038","chr19",5815738,5815762,25,76,8,109
"11039","chr19",5830600,5830625,26,9,130,165
"11040","chr19",5836207,5836230,24,73,132,229
"11041","chr19",5837769,5837800,32,7,71,110
"11042","chr19",5859789,5859807,19,69,35,123
"11043","chr19",5869279,5869300,22,40,13,75
"11044","chr19",5910676,5910713,38,117,27,182
"11045","chr19",5936423,5936442,20,96,2,118
"11046","chr19",5961410,5961439,30,136,39,205
"11047","chr19",5986079,5986107,29,67,86,182
"11048","chr19",6019502,6019545,44,10,45,99
"11049","chr19",6019586,6019605,20,70,4,94
"11050","chr19",6107295,6107318,24,131,7,162
"11051","chr19",6110501,6110524,24,77,6,107
"11052","chr19",6144688,6144712,25,76,73,174
"11053","chr19",6162265,6162283,19,147,75,241
"11054","chr19",6200533,6200555,23,6,11,40
"11055","chr19",6201316,6201339,24,79,92,195
"11056","chr19",6222261,6222278,18,40,77,135
"11057","chr19",6222390,6222417,28,47,4,79
"11058","chr19",6232238,6232270,33,33,72,138
"11059","chr19",6279708,6279743,36,87,3,126
"11060","chr19",6279823,6279868,46,53,19,118
"11061","chr19",6279885,6279910,26,95,72,193
"11062","chr19",6285395,6285427,33,77,26,136
"11063","chr19",6326121,6326142,22,5,107,134
"11064","chr19",6336820,6336843,24,97,124,245
"11065","chr19",6382800,6382819,20,127,4,151
"11066","chr19",6424745,6424765,21,30,11,62
"11067","chr19",6430269,6430290,22,130,122,274
"11068","chr19",6442935,6442954,20,6,61,87
"11069","chr19",6447470,6447500,31,14,143,188
"11070","chr19",6464402,6464429,28,25,3,56
"11071","chr19",6475038,6475067,30,26,105,161
"11072","chr19",6478410,6478427,18,109,76,203
"11073","chr19",6485798,6485822,25,9,144,178
"11074","chr19",6497899,6497919,21,52,40,113
"11075","chr19",6517773,6517794,22,27,76,125
"11076","chr19",6557938,6557998,61,86,33,180
"11077","chr19",6591876,6591927,52,8,85,145
"11078","chr19",6653414,6653436,23,11,3,37
"11079","chr19",6657892,6657919,28,8,93,129
"11080","chr19",6789589,6789614,26,7,107,140
"11081","chr19",6859414,6859433,20,8,11,39
"11082","chr19",6865195,6865218,24,103,8,135
"11083","chr19",6987271,6987290,20,78,24,122
"11084","chr19",6987467,6987493,27,121,46,194
"11085","chr19",7023136,7023160,25,82,114,221
"11086","chr19",7034532,7036299,1768,117,37,1922
"11087","chr19",7047609,7047633,25,116,80,221
"11088","chr19",7102834,7102853,20,27,76,123
"11089","chr19",7191347,7191373,27,1,24,52
"11090","chr19",7232206,7232229,24,125,20,169
"11091","chr19",7238618,7238639,22,65,9,96
"11092","chr19",7266384,7266402,19,7,8,34
"11093","chr19",7280271,7280296,26,8,67,101
"11094","chr19",7290766,7290789,24,13,124,161
"11095","chr19",7294486,7294511,26,33,102,161
"11096","chr19",7317407,7317426,20,76,133,229
"11097","chr19",7335999,7336028,30,145,31,206
"11098","chr19",7346146,7346177,32,7,50,89
"11099","chr19",7349742,7349769,28,35,110,173
"11100","chr19",7378685,7378710,26,8,87,121
"11101","chr19",7409941,7409969,29,37,143,209
"11102","chr19",7489852,7489875,24,8,14,46
"11103","chr19",7516280,7516313,34,2,25,61
"11104","chr19",7582863,7582959,97,62,55,214
"11105","chr19",7595878,7595908,31,30,26,87
"11106","chr19",7595946,7595963,18,85,28,131
"11107","chr19",7605144,7605177,34,33,143,210
"11108","chr19",7609318,7609335,18,25,6,49
"11109","chr19",7619766,7619787,22,46,120,188
"11110","chr19",7658175,7658192,18,117,54,189
"11111","chr19",7670433,7670463,31,112,36,179
"11112","chr19",7703132,7703156,25,77,34,136
"11113","chr19",7779109,7779129,21,11,145,177
"11114","chr19",7800907,7800933,27,71,5,103
"11115","chr19",7857472,7857515,44,147,65,256
"11116","chr19",7859191,7859210,20,45,74,139
"11117","chr19",7875480,7875511,32,101,7,140
"11118","chr19",7916914,7916935,22,118,18,158
"11119","chr19",7925641,7925658,18,13,21,52
"11120","chr19",7926052,7926070,19,77,50,146
"11121","chr19",7950799,7950840,42,75,68,185
"11122","chr19",7973230,7973248,19,76,28,123
"11123","chr19",8005584,8005624,41,25,82,148
"11124","chr19",8019825,8019850,26,65,35,126
"11125","chr19",8020843,8020936,94,48,99,241
"11126","chr19",8030166,8030184,19,4,75,98
"11127","chr19",8042887,8042907,21,39,74,134
"11128","chr19",8051475,8051515,41,75,107,223
"11129","chr19",8055335,8055354,20,9,28,57
"11130","chr19",8063447,8063469,23,28,69,120
"11131","chr19",8127049,8127075,27,76,24,127
"11132","chr19",8145374,8145397,24,146,19,189
"11133","chr19",8150827,8150855,29,6,64,99
"11134","chr19",8157894,8157925,32,46,67,145
"11135","chr19",8157924,8157994,71,115,37,223
"11136","chr19",8188433,8188459,27,125,140,292
"11137","chr19",8190082,8190115,34,76,5,115
"11138","chr19",8190397,8190418,22,8,145,175
"11139","chr19",8192781,8192798,18,34,77,129
"11140","chr19",8192808,8192853,46,89,50,185
"11141","chr19",8194246,8194281,36,8,65,109
"11142","chr19",8209061,8209130,70,8,25,103
"11143","chr19",8224105,8224126,22,14,3,39
"11144","chr19",8245526,8245557,32,76,35,143
"11145","chr19",8254323,8254342,20,73,6,99
"11146","chr19",8268621,8268673,53,115,4,172
"11147","chr19",8372393,8372411,19,76,111,206
"11148","chr19",8413344,8413368,25,19,9,53
"11149","chr19",8419816,8419875,60,12,6,78
"11150","chr19",8440983,8441009,27,67,93,187
"11151","chr19",8481968,8481988,21,6,6,33
"11152","chr19",8503161,8503186,26,8,38,72
"11153","chr19",8511976,8511994,19,2,5,26
"11154","chr19",8518323,8518341,19,46,47,112
"11155","chr19",8518341,8518375,35,80,29,144
"11156","chr19",8520593,8520611,19,56,11,86
"11157","chr19",8546057,8546081,25,8,104,137
"11158","chr19",8549506,8549529,24,7,47,78
"11159","chr19",8555377,8555406,30,131,67,228
"11160","chr19",8563500,8563518,19,68,40,127
"11161","chr19",8574493,8574766,274,37,99,410
"11162","chr19",8581835,8581874,40,138,74,252
"11163","chr19",8582028,8582057,30,17,9,56
"11164","chr19",8609393,8609411,19,13,115,147
"11165","chr19",8634865,8634918,54,42,89,185
"11166","chr19",8640317,8640336,20,45,25,90
"11167","chr19",8648172,8648194,23,133,8,164
"11168","chr19",8666913,8666930,18,123,132,273
"11169","chr19",8917379,8917401,23,136,75,234
"11170","chr19",8984989,8985011,23,41,42,106
"11171","chr19",9050116,9050151,36,11,4,51
"11172","chr19",9052015,9052036,22,15,13,50
"11173","chr19",9070874,9070893,20,46,142,208
"11174","chr19",9080342,9080361,20,75,139,234
"11175","chr19",9101715,9101733,19,36,6,61
"11176","chr19",9129144,9129179,36,129,7,172
"11177","chr19",9183956,9183993,38,29,7,74
"11178","chr19",9221341,9221368,28,8,5,41
"11179","chr19",9260600,9260627,28,6,101,135
"11180","chr19",9578029,9578057,29,38,35,102
"11181","chr19",9599847,9599911,65,148,4,217
"11182","chr19",9643045,9643063,19,141,3,163
"11183","chr19",9767131,9767154,24,77,141,242
"11184","chr19",9802557,9802575,19,77,4,100
"11185","chr19",9802726,9802753,28,49,5,82
"11186","chr19",9802905,9802925,21,8,100,129
"11187","chr19",9826640,9826668,29,119,79,227
"11188","chr19",9837629,9837651,23,10,143,176
"11189","chr19",9865818,9865845,28,42,119,189
"11190","chr19",9905457,9905492,36,78,6,120
"11191","chr19",9905625,9905642,18,109,90,217
"11192","chr19",9915497,9915535,39,8,19,66
"11193","chr19",9924104,9924128,25,147,2,174
"11194","chr19",9924407,9924433,27,30,73,130
"11195","chr19",10049363,10049380,18,109,5,132
"11196","chr19",10060231,10060256,26,7,136,169
"11197","chr19",10060532,10060552,21,16,18,55
"11198","chr19",10062055,10062075,21,118,91,230
"11199","chr19",10096932,10096949,18,27,33,78
"11200","chr19",10097101,10097119,19,124,122,265
"11201","chr19",10102116,10102138,23,55,6,84
"11202","chr19",10143385,10143403,19,142,27,188
"11203","chr19",10172406,10172424,19,28,74,121
"11204","chr19",10186839,10186859,21,39,73,133
"11205","chr19",10190766,10190824,59,141,5,205
"11206","chr19",10213632,10213649,18,136,5,159
"11207","chr19",10228139,10228162,24,77,33,134
"11208","chr19",10228310,10228339,30,50,8,88
"11209","chr19",10237724,10237746,23,97,74,194
"11210","chr19",10239272,10239290,19,111,34,164
"11211","chr19",10239982,10240022,41,8,14,63
"11212","chr19",10241003,10241026,24,116,75,215
"11213","chr19",10241482,10241502,21,145,6,172
"11214","chr19",10253471,10253502,32,6,14,52
"11215","chr19",10280869,10280891,23,76,145,244
"11216","chr19",10298050,10298078,29,64,7,100
"11217","chr19",10311704,10311721,18,79,141,238
"11218","chr19",10324379,10324402,24,126,39,189
"11219","chr19",10331357,10331412,56,145,67,268
"11220","chr19",10374585,10374606,22,148,74,244
"11221","chr19",10387931,10387957,27,24,4,55
"11222","chr19",10419057,10419080,24,50,45,119
"11223","chr19",10423158,10423179,22,48,32,102
"11224","chr19",10432452,10432474,23,69,32,124
"11225","chr19",10455635,10455655,21,122,5,148
"11226","chr19",10458603,10458635,33,35,13,81
"11227","chr19",10482822,10482856,35,134,2,171
"11228","chr19",10487656,10487697,42,131,74,247
"11229","chr19",10487689,10487713,25,14,41,80
"11230","chr19",10489095,10489120,26,29,6,61
"11231","chr19",10493558,10493579,22,76,49,147
"11232","chr19",10494328,10494348,21,8,59,88
"11233","chr19",10505255,10505283,29,15,6,50
"11234","chr19",10530718,10530735,18,138,7,163
"11235","chr19",10576259,10576280,22,8,75,105
"11236","chr19",10586454,10586474,21,139,75,235
"11237","chr19",10602237,10602256,20,49,78,147
"11238","chr19",10610632,10610656,25,75,10,110
"11239","chr19",10618172,10618192,21,8,75,104
"11240","chr19",10618475,10618497,23,8,10,41
"11241","chr19",10634138,10634161,24,29,75,128
"11242","chr19",10659393,10659418,26,15,141,182
"11243","chr19",10668951,10668973,23,75,8,106
"11244","chr19",10699666,10699701,36,25,21,82
"11245","chr19",10704282,10704305,24,39,10,73
"11246","chr19",10705841,10705870,30,6,4,40
"11247","chr19",10731954,10731971,18,7,17,42
"11248","chr19",10742904,10742931,28,8,23,59
"11249","chr19",10755629,10755681,53,8,142,203
"11250","chr19",10764949,10764977,29,10,117,156
"11251","chr19",10853900,10853918,19,93,141,253
"11252","chr19",10871486,10871512,27,4,2,33
"11253","chr19",10871564,10871651,88,41,40,169
"11254","chr19",10873625,10873657,33,8,87,128
"11255","chr19",10899707,10899738,32,76,84,192
"11256","chr19",10905943,10905966,24,76,143,243
"11257","chr19",10931429,10931450,22,78,5,105
"11258","chr19",10932514,10932538,25,8,141,174
"11259","chr19",10949746,10949768,23,141,72,236
"11260","chr19",10953723,10953757,35,101,7,143
"11261","chr19",10967872,10967890,19,72,123,214
"11262","chr19",10971956,10971973,18,5,69,92
"11263","chr19",10986524,10986552,29,10,92,131
"11264","chr19",11009688,11009706,19,8,74,101
"11265","chr19",11086432,11086457,26,8,30,64
"11266","chr19",11097867,11097886,20,43,4,67
"11267","chr19",11108221,11108242,22,11,6,39
"11268","chr19",11112099,11112125,27,75,106,208
"11269","chr19",11140981,11141000,20,41,74,135
"11270","chr19",11157495,11157512,18,72,130,220
"11271","chr19",11168006,11168026,21,14,40,75
"11272","chr19",11219175,11219201,27,76,147,250
"11273","chr19",11262453,11262496,44,58,14,116
"11274","chr19",11262514,11262546,33,14,104,151
"11275","chr19",11262970,11262987,18,112,67,197
"11276","chr19",11270971,11270994,24,76,8,108
"11277","chr19",11280252,11280279,28,126,115,269
"11278","chr19",11293711,11293733,23,14,34,71
"11279","chr19",11307110,11307136,27,7,16,50
"11280","chr19",11343786,11343808,23,103,73,199
"11281","chr19",11386845,11386872,28,9,142,179
"11282","chr19",11412281,11412299,19,92,5,116
"11283","chr19",11429200,11429218,19,65,124,208
"11284","chr19",11454450,11454486,37,144,27,208
"11285","chr19",11481003,11481020,18,74,43,135
"11286","chr19",11487788,11487808,21,141,135,297
"11287","chr19",11487952,11488001,50,71,16,137
"11288","chr19",11505738,11505762,25,80,44,149
"11289","chr19",11525743,11525761,19,138,30,187
"11290","chr19",11542187,11542204,18,70,59,147
"11291","chr19",11547395,11547421,27,3,76,106
"11292","chr19",11567876,11567907,32,72,5,109
"11293","chr19",11584835,11584855,21,75,36,132
"11294","chr19",11595674,11595714,41,6,134,181
"11295","chr19",11612423,11612441,19,13,8,40
"11296","chr19",11649176,11649199,24,45,6,75
"11297","chr19",11669955,11669974,20,52,112,184
"11298","chr19",11699138,11699155,18,10,13,41
"11299","chr19",11701488,11701521,34,73,80,187
"11300","chr19",11716450,11716476,27,8,103,138
"11301","chr19",11825787,11825832,46,7,140,193
"11302","chr19",12040471,12040491,21,145,74,240
"11303","chr19",12051096,12051128,33,58,6,97
"11304","chr19",12054308,12054331,24,140,3,167
"11305","chr19",12056808,12056827,20,6,73,99
"11306","chr19",12062141,12062163,23,148,4,175
"11307","chr19",12062976,12062998,23,7,26,56
"11308","chr19",12086527,12086545,19,29,51,99
"11309","chr19",12094350,12094375,26,73,50,149
"11310","chr19",12153806,12153825,20,8,89,117
"11311","chr19",12157878,12157910,33,16,76,125
"11312","chr19",12161269,12161289,21,34,36,91
"11313","chr19",12169780,12169809,30,5,71,106
"11314","chr19",12249508,12249530,23,36,4,63
"11315","chr19",12257799,12257820,22,76,8,106
"11316","chr19",12312951,12312972,22,76,8,106
"11317","chr19",12395141,12395159,19,8,32,59
"11318","chr19",12406169,12406197,29,8,75,112
"11319","chr19",12505323,12505343,21,144,8,173
"11320","chr19",12518366,12518383,18,22,43,83
"11321","chr19",12542015,12542034,20,20,74,114
"11322","chr19",12565966,12565986,21,147,6,174
"11323","chr19",12573694,12573713,20,26,36,82
"11324","chr19",12636191,12636215,25,8,35,68
"11325","chr19",12638665,12638692,28,5,74,107
"11326","chr19",12649478,12649499,22,8,26,56
"11327","chr19",12657955,12657981,27,51,6,84
"11328","chr19",12680834,12680852,19,9,10,38
"11329","chr19",12682014,12682036,23,8,35,66
"11330","chr19",12682325,12682348,24,7,4,35
"11331","chr19",12683108,12683127,20,9,79,108
"11332","chr19",12683573,12683594,22,8,70,100
"11333","chr19",12722562,12722612,51,27,5,83
"11334","chr19",12725089,12725107,19,43,134,196
"11335","chr19",12725105,12725141,37,77,118,232
"11336","chr19",12740675,12740706,32,14,45,91
"11337","chr19",12761068,12761104,37,5,72,114
"11338","chr19",12768964,12768982,19,7,143,169
"11339","chr19",12780655,12780683,29,134,145,308
"11340","chr19",12780979,12781011,33,3,5,41
"11341","chr19",12789175,12789230,56,40,54,150
"11342","chr19",12816909,12816926,18,80,21,119
"11343","chr19",12819881,12819905,25,147,73,245
"11344","chr19",12833850,12833872,23,28,68,119
"11345","chr19",12833891,12833940,50,64,27,141
"11346","chr19",12838508,12838534,27,59,36,122
"11347","chr19",12848629,12848667,39,139,4,182
"11348","chr19",12868104,12868126,23,8,7,38
"11349","chr19",12870181,12870206,26,118,74,218
"11350","chr19",12870493,12870512,20,145,72,237
"11351","chr19",12876460,12876477,18,8,42,68
"11352","chr19",12881783,12881813,31,7,60,98
"11353","chr19",12906896,12906932,37,21,119,177
"11354","chr19",12908277,12908297,21,31,68,120
"11355","chr19",12971246,12971268,23,48,53,124
"11356","chr19",12971273,12971295,23,75,26,124
"11357","chr19",12975793,12975816,24,112,32,168
"11358","chr19",12992302,12992465,164,6,113,283
"11359","chr19",12992912,12992955,44,61,38,143
"11360","chr19",12995498,12995525,28,28,25,81
"11361","chr19",12995568,12995639,72,5,33,110
"11362","chr19",12995746,12995769,24,3,46,73
"11363","chr19",12996143,12996171,29,83,67,179
"11364","chr19",13111551,13111569,19,27,75,121
"11365","chr19",13117548,13117566,19,3,22,44
"11366","chr19",13118791,13118818,28,81,77,186
"11367","chr19",13147894,13147916,23,145,74,242
"11368","chr19",13149412,13149451,40,50,6,96
"11369","chr19",13178741,13178764,24,8,12,44
"11370","chr19",13194240,13194259,20,59,69,148
"11371","chr19",13203397,13203414,18,4,134,156
"11372","chr19",13207859,13207898,40,96,3,139
"11373","chr19",13208880,13208908,29,43,30,102
"11374","chr19",13259313,13259342,30,26,115,171
"11375","chr19",13281380,13281398,19,84,72,175
"11376","chr19",13298648,13298668,21,79,118,218
"11377","chr19",13308989,13309024,36,6,143,185
"11378","chr19",13321026,13321051,26,126,52,204
"11379","chr19",13417890,13417908,19,80,74,173
"11380","chr19",13432104,13432126,23,6,75,104
"11381","chr19",13461341,13461384,44,145,73,262
"11382","chr19",13506277,13506300,24,13,34,71
"11383","chr19",13506485,13506521,37,66,93,196
"11384","chr19",13514272,13514300,29,10,13,52
"11385","chr19",13567429,13567452,24,15,7,46
"11386","chr19",13631320,13631345,26,13,8,47
"11387","chr19",13686885,13686909,25,124,5,154
"11388","chr19",13727226,13727247,22,7,46,75
"11389","chr19",13738893,13738914,22,77,3,102
"11390","chr19",13775954,13775971,18,5,137,160
"11391","chr19",13781931,13781966,36,76,22,134
"11392","chr19",13790007,13790029,23,14,1,38
"11393","chr19",13792925,13792949,25,125,137,287
"11394","chr19",13794439,13794467,29,65,8,102
"11395","chr19",13795615,13795641,27,53,17,97
"11396","chr19",13800245,13800283,39,8,20,67
"11397","chr19",13803807,13803824,18,21,4,43
"11398","chr19",13804470,13804496,27,144,6,177
"11399","chr19",13808741,13808761,21,57,72,150
"11400","chr19",13810910,13810931,22,8,10,40
"11401","chr19",13812459,13812476,18,75,133,226
"11402","chr19",13815457,13815488,32,58,9,99
"11403","chr19",13845100,13845143,44,93,51,188
"11404","chr19",13854722,13854749,28,76,75,179
"11405","chr19",13860447,13860471,25,79,10,114
"11406","chr19",13862530,13862556,27,8,10,45
"11407","chr19",13865498,13865520,23,11,25,59
"11408","chr19",13878924,13878942,19,61,56,136
"11409","chr19",13891136,13891168,33,9,10,52
"11410","chr19",13948184,13948215,32,5,41,78
"11411","chr19",13988025,13988044,20,9,86,115
"11412","chr19",14006205,14006222,18,10,12,40
"11413","chr19",14015155,14015176,22,144,7,173
"11414","chr19",14046025,14046051,27,135,6,168
"11415","chr19",14080883,14080904,22,27,141,190
"11416","chr19",14090582,14090601,20,18,4,42
"11417","chr19",14090601,14090628,28,8,34,70
"11418","chr19",14090781,14090799,19,37,103,159
"11419","chr19",14091089,14091111,23,22,18,63
"11420","chr19",14104337,14104355,19,38,6,63
"11421","chr19",14104696,14104715,20,68,74,162
"11422","chr19",14117629,14117646,18,70,12,100
"11423","chr19",14133798,14133821,24,8,64,96
"11424","chr19",14140616,14140634,19,21,1,41
"11425","chr19",14140843,14140870,28,85,71,184
"11426","chr19",14173944,14173968,25,26,9,60
"11427","chr19",14202959,14202976,18,132,61,211
"11428","chr19",14204673,14204760,88,43,50,181
"11429","chr19",14206171,14206204,34,27,21,82
"11430","chr19",14211597,14211620,24,52,125,201
"11431","chr19",14212521,14212544,24,136,76,236
"11432","chr19",14216900,14216934,35,62,74,171
"11433","chr19",14222524,14222546,23,28,74,125
"11434","chr19",14233838,14233862,25,14,78,117
"11435","chr19",14235490,14235537,48,33,71,152
"11436","chr19",14270412,14270436,25,14,140,179
"11437","chr19",14284809,14284828,20,36,2,58
"11438","chr19",14332905,14332945,41,144,6,191
"11439","chr19",14334465,14334500,36,143,118,297
"11440","chr19",14362598,14362778,181,17,41,239
"11441","chr19",14381266,14381305,40,83,19,142
"11442","chr19",14386379,14386404,26,143,74,243
"11443","chr19",14386694,14386714,21,62,74,157
"11444","chr19",14387022,14387045,24,110,67,201
"11445","chr19",14395302,14395325,24,103,5,132
"11446","chr19",14399564,14399594,31,78,6,115
"11447","chr19",14418121,14418145,25,38,54,117
"11448","chr19",14427814,14427838,25,17,88,130
"11449","chr19",14471786,14471817,32,112,7,151
"11450","chr19",14493635,14493674,40,73,133,246
"11451","chr19",14496042,14496085,44,60,6,110
"11452","chr19",14501992,14502017,26,43,6,75
"11453","chr19",14507604,14507645,42,118,25,185
"11454","chr19",14522488,14522507,20,119,3,142
"11455","chr19",14523612,14523636,25,9,145,179
"11456","chr19",14535544,14535602,59,28,37,124
"11457","chr19",14540836,14540855,20,48,88,156
"11458","chr19",14549212,14549231,20,77,49,146
"11459","chr19",14609838,14609862,25,96,6,127
"11460","chr19",14620382,14620569,188,37,115,340
"11461","chr19",14690094,14690120,27,2,86,115
"11462","chr19",14703203,14703222,20,66,7,93
"11463","chr19",14776977,14777015,39,13,84,136
"11464","chr19",14780328,14780360,33,67,124,224
"11465","chr19",14782269,14782319,51,133,7,191
"11466","chr19",15011735,15011752,18,123,5,146
"11467","chr19",15091829,15091854,26,94,75,195
"11468","chr19",15107327,15107386,60,43,11,114
"11469","chr19",15113804,15113821,18,129,57,204
"11470","chr19",15126958,15126981,24,126,121,271
"11471","chr19",15161968,15162001,34,78,24,136
"11472","chr19",15173422,15173442,21,6,74,101
"11473","chr19",15177072,15177094,23,72,74,169
"11474","chr19",15189500,15189533,34,6,5,45
"11475","chr19",15200838,15200857,20,3,32,55
"11476","chr19",15203580,15203605,26,124,142,292
"11477","chr19",15208806,15208829,24,4,6,34
"11478","chr19",15220492,15220530,39,112,5,156
"11479","chr19",15223242,15223276,35,11,36,82
"11480","chr19",15238858,15238912,55,118,42,215
"11481","chr19",15244604,15244630,27,54,108,189
"11482","chr19",15308116,15308136,21,140,72,233
"11483","chr19",15309015,15309040,26,133,6,165
"11484","chr19",15310359,15310380,22,78,133,233
"11485","chr19",15313374,15313392,19,11,5,35
"11486","chr19",15325998,15326037,40,10,74,124
"11487","chr19",15331873,15331895,23,26,16,65
"11488","chr19",15332502,15332531,30,96,19,145
"11489","chr19",15333806,15333823,18,63,6,87
"11490","chr19",15344171,15344202,32,43,132,207
"11491","chr19",15432494,15432559,66,85,33,184
"11492","chr19",15434259,15434278,20,10,73,103
"11493","chr19",15449681,15449701,21,26,7,54
"11494","chr19",15484290,15484312,23,81,73,177
"11495","chr19",15494501,15494551,51,6,8,65
"11496","chr19",15494838,15494866,29,74,8,111
"11497","chr19",15684757,15684799,43,11,126,180
"11498","chr19",15723513,15723530,18,76,1,95
"11499","chr19",15798752,15798774,23,76,29,128
"11500","chr19",15863800,15863846,47,6,34,87
"11501","chr19",16110263,16110285,23,8,3,34
"11502","chr19",16158537,16158555,19,105,3,127
"11503","chr19",16181576,16181593,18,146,119,283
"11504","chr19",16182469,16182505,37,9,143,189
"11505","chr19",16193197,16193219,23,7,65,95
"11506","chr19",16244838,16244863,26,24,35,85
"11507","chr19",16244876,16244915,40,76,28,144
"11508","chr19",16263303,16263326,24,138,76,238
"11509","chr19",16274782,16274813,32,6,10,48
"11510","chr19",16277776,16277799,24,71,65,160
"11511","chr19",16301873,16301895,23,104,71,198
"11512","chr19",16325329,16325352,24,12,63,99
"11513","chr19",16350582,16350613,32,145,74,251
"11514","chr19",16432773,16432795,23,109,5,137
"11515","chr19",16441630,16441651,22,9,5,36
"11516","chr19",16458673,16458720,48,73,134,255
"11517","chr19",16507460,16507481,22,48,76,146
"11518","chr19",16529753,16529789,37,78,88,203
"11519","chr19",16534044,16534069,26,74,31,131
"11520","chr19",16554268,16554290,23,131,4,158
"11521","chr19",16554821,16554845,25,48,71,144
"11522","chr19",16558034,16558060,27,75,90,192
"11523","chr19",16579104,16579129,26,13,71,110
"11524","chr19",16638290,16638320,31,7,52,90
"11525","chr19",16668503,16668522,20,38,85,143
"11526","chr19",16718994,16719023,30,40,73,143
"11527","chr19",16745740,16745767,28,77,123,228
"11528","chr19",16823692,16823716,25,51,6,82
"11529","chr19",16828323,16828345,23,141,8,172
"11530","chr19",16861764,16861784,21,144,5,170
"11531","chr19",16885465,16885491,27,128,66,221
"11532","chr19",16906703,16906726,24,75,60,159
"11533","chr19",16987822,16987843,22,35,71,128
"11534","chr19",17026678,17026708,31,4,9,44
"11535","chr19",17041361,17041378,18,34,9,61
"11536","chr19",17072950,17072968,19,84,37,140
"11537","chr19",17099816,17099835,20,9,76,105
"11538","chr19",17129399,17129422,24,129,77,230
"11539","chr19",17174023,17174048,26,77,20,123
"11540","chr19",17174938,17174960,23,94,69,186
"11541","chr19",17174953,17174979,27,113,54,194
"11542","chr19",17175825,17175849,25,75,65,165
"11543","chr19",17176001,17176046,46,7,74,127
"11544","chr19",17237341,17237358,18,6,55,79
"11545","chr19",17237395,17237426,32,74,1,107
"11546","chr19",17245827,17245852,26,89,36,151
"11547","chr19",17245941,17245975,35,57,106,198
"11548","chr19",17246433,17246472,40,16,98,154
"11549","chr19",17286648,17286713,66,12,46,124
"11550","chr19",17323550,17323572,23,45,58,126
"11551","chr19",17328584,17328646,63,68,1,132
"11552","chr19",17331932,17331954,23,78,146,247
"11553","chr19",17339739,17339759,21,71,3,95
"11554","chr19",17342053,17342129,77,16,32,125
"11555","chr19",17354597,17354615,19,12,6,37
"11556","chr19",17363742,17363760,19,8,49,76
"11557","chr19",17372412,17372437,26,39,71,136
"11558","chr19",17372449,17372471,23,73,34,130
"11559","chr19",17374161,17374185,25,44,7,76
"11560","chr19",17426363,17426390,28,49,10,87
"11561","chr19",17449184,17449205,22,123,4,149
"11562","chr19",17449351,17449373,23,144,32,199
"11563","chr19",17463455,17463473,19,4,70,93
"11564","chr19",17491031,17491050,20,144,72,236
"11565","chr19",17501803,17501821,19,139,6,164
"11566","chr19",17509607,17509627,21,78,57,156
"11567","chr19",17510985,17511004,20,40,140,200
"11568","chr19",17520555,17520580,26,76,65,167
"11569","chr19",17547351,17547372,22,8,9,39
"11570","chr19",17551089,17551111,23,6,52,81
"11571","chr19",17554798,17554821,24,68,56,148
"11572","chr19",17563188,17563208,21,8,79,108
"11573","chr19",17565323,17565347,25,36,143,204
"11574","chr19",17598668,17598686,19,7,107,133
"11575","chr19",17607877,17607897,21,6,90,117
"11576","chr19",17713044,17713067,24,9,11,44
"11577","chr19",17713936,17713961,26,3,74,103
"11578","chr19",17719699,17719721,23,36,33,92
"11579","chr19",17745825,17745844,20,13,18,51
"11580","chr19",17746120,17746147,28,78,12,118
"11581","chr19",17769275,17769294,20,9,6,35
"11582","chr19",17817485,17817502,18,137,6,161
"11583","chr19",17869856,17869886,31,5,6,42
"11584","chr19",17878975,17879001,27,3,74,104
"11585","chr19",17883775,17883806,32,122,126,280
"11586","chr19",17905535,17905562,28,138,33,199
"11587","chr19",17947067,17947085,19,106,12,137
"11588","chr19",17955905,17955948,44,69,63,176
"11589","chr19",17979433,17979454,22,4,74,100
"11590","chr19",18003436,18003469,34,102,141,277
"11591","chr19",18003629,18003656,28,7,39,74
"11592","chr19",18004246,18004265,20,8,141,169
"11593","chr19",18097346,18097378,33,36,50,119
"11594","chr19",18101337,18101391,55,73,31,159
"11595","chr19",18102482,18102499,18,77,142,237
"11596","chr19",18106967,18106996,30,36,53,119
"11597","chr19",18112330,18112353,24,9,140,173
"11598","chr19",18139812,18139837,26,8,94,128
"11599","chr19",18147080,18147121,42,76,17,135
"11600","chr19",18189707,18189726,20,97,74,191
"11601","chr19",18190005,18190044,40,78,108,226
"11602","chr19",18214949,18214968,20,95,7,122
"11603","chr19",18221071,18221095,25,23,97,145
"11604","chr19",18226182,18226216,35,24,128,187
"11605","chr19",18226606,18226625,20,10,78,108
"11606","chr19",18256319,18256336,18,7,143,168
"11607","chr19",18268962,18268981,20,78,74,172
"11608","chr19",18279834,18279858,25,136,44,205
"11609","chr19",18281997,18282020,24,140,14,178
"11610","chr19",18284034,18284067,34,77,5,116
"11611","chr19",18334855,18334900,46,76,57,179
"11612","chr19",18336192,18336232,41,24,73,138
"11613","chr19",18352267,18352287,21,70,11,102
"11614","chr19",18417058,18417086,29,135,69,233
"11615","chr19",18419469,18419496,28,21,85,134
"11616","chr19",18435729,18435749,21,123,121,265
"11617","chr19",18443194,18443211,18,86,35,139
"11618","chr19",18454841,18454858,18,12,6,36
"11619","chr19",18497816,18497840,25,7,43,75
"11620","chr19",18530936,18530955,20,146,74,240
"11621","chr19",18538809,18538834,26,78,31,135
"11622","chr19",18541831,18541865,35,94,26,155
"11623","chr19",18552833,18552851,19,5,5,29
"11624","chr19",18587587,18587620,34,39,3,76
"11625","chr19",18606842,18606874,33,10,37,80
"11626","chr19",18611652,18611690,39,1,129,169
"11627","chr19",18631911,18631960,50,73,144,267
"11628","chr19",18641620,18641646,27,8,9,44
"11629","chr19",18683901,18683957,57,36,111,204
"11630","chr19",18695867,18695889,23,47,72,142
"11631","chr19",18703429,18703478,50,6,104,160
"11632","chr19",18710597,18710626,30,5,45,80
"11633","chr19",18720526,18720547,22,37,66,125
"11634","chr19",18729426,18729450,25,66,6,97
"11635","chr19",18755594,18755618,25,6,78,109
"11636","chr19",18791562,18791601,40,34,28,102
"11637","chr19",18884710,18884732,23,9,8,40
"11638","chr19",18925557,18925595,39,49,72,160
"11639","chr19",18927071,18927093,23,127,76,226
"11640","chr19",18929297,18929331,35,43,8,86
"11641","chr19",18970895,18970948,54,27,46,127
"11642","chr19",18973793,18973820,28,72,144,244
"11643","chr19",18992349,18992366,18,74,145,237
"11644","chr19",19007756,19007776,21,7,9,37
"11645","chr19",19099728,19099752,25,15,46,86
"11646","chr19",19106935,19106961,27,85,4,116
"11647","chr19",19125515,19125535,21,77,77,175
"11648","chr19",19133463,19133489,27,75,88,190
"11649","chr19",19142959,19142977,19,65,10,94
"11650","chr19",19145113,19145144,32,18,74,124
"11651","chr19",19148681,19148726,46,73,15,134
"11652","chr19",19174386,19174405,20,77,139,236
"11653","chr19",19203657,19203675,19,10,12,41
"11654","chr19",19214728,19214764,37,81,103,221
"11655","chr19",19230884,19230928,45,39,146,230
"11656","chr19",19244711,19244743,33,73,43,149
"11657","chr19",19272693,19272729,37,133,3,173
"11658","chr19",19309922,19309948,27,105,64,196
"11659","chr19",19314140,19314177,38,148,4,190
"11660","chr19",19364807,19364830,24,38,143,205
"11661","chr19",19374266,19374291,26,8,5,39
"11662","chr19",19406452,19406479,28,31,119,178
"11663","chr19",19483782,19483801,20,29,75,124
"11664","chr19",19512993,19513022,30,45,82,157
"11665","chr19",19513338,19513390,53,3,145,201
"11666","chr19",19609550,19609567,18,11,73,102
"11667","chr19",19622207,19622226,20,15,42,77
"11668","chr19",19643609,19643632,24,86,33,143
"11669","chr19",19664779,19664801,23,85,8,116
"11670","chr19",19667310,19667333,24,145,27,196
"11671","chr19",19706721,19706739,19,14,70,103
"11672","chr19",19772043,19772070,28,145,131,304
"11673","chr19",19801173,19801206,34,145,61,240
"11674","chr19",19815259,19815292,34,113,75,222
"11675","chr19",19865511,19865681,171,35,65,271
"11676","chr19",19929938,19929962,25,99,6,130
"11677","chr19",20034775,20034811,37,10,4,51
"11678","chr19",20134072,20134090,19,110,141,270
"11679","chr19",20144155,20144196,42,65,6,113
"11680","chr19",20313434,20313470,37,77,34,148
"11681","chr19",20797190,20797225,36,9,106,151
"11682","chr19",21068910,21068933,24,16,35,75
"11683","chr19",21176686,21176715,30,9,2,41
"11684","chr19",21187434,21187455,22,11,76,109
"11685","chr19",21396310,21396358,49,49,52,150
"11686","chr19",21401933,21401983,51,6,142,199
"11687","chr19",21464660,21464691,32,40,74,146
"11688","chr19",21534986,21535008,23,37,66,126
"11689","chr19",21590168,21590193,26,8,47,81
"11690","chr19",21605624,21605652,29,148,27,204
"11691","chr19",21709170,21709204,35,25,33,93
"11692","chr19",21780221,21780239,19,71,29,119
"11693","chr19",21829033,21829065,33,145,6,184
"11694","chr19",21834336,21834353,18,24,27,69
"11695","chr19",21834743,21834822,80,10,90,180
"11696","chr19",21851368,21851390,23,143,30,196
"11697","chr19",21851540,21851563,24,69,8,101
"11698","chr19",21854873,21854891,19,76,135,230
"11699","chr19",22039132,22039150,19,149,75,243
"11700","chr19",22138201,22138232,32,116,13,161
"11701","chr19",22172318,22172355,38,97,6,141
"11702","chr19",22251787,22251804,18,148,7,173
"11703","chr19",22367887,22367904,18,8,51,77
"11704","chr19",22441648,22441668,21,87,10,118
"11705","chr19",22441810,22441844,35,8,72,115
"11706","chr19",22517247,22517275,29,35,2,66
"11707","chr19",22518313,22518336,24,122,7,153
"11708","chr19",22541990,22542016,27,84,110,221
"11709","chr19",22542018,22542053,36,121,82,239
"11710","chr19",22787143,22787164,22,110,3,135
"11711","chr19",22833927,22833948,22,23,124,169
"11712","chr19",23114476,23114534,59,39,73,171
"11713","chr19",23134295,23134322,28,11,144,183
"11714","chr19",23197876,23197919,44,110,6,160
"11715","chr19",23201824,23201853,30,8,130,168
"11716","chr19",23374560,23374585,26,13,6,45
"11717","chr19",23622819,23622882,64,74,142,280
"11718","chr19",23629122,23629143,22,80,8,110
"11719","chr19",23677077,23677117,41,22,74,137
"11720","chr19",23708146,23708169,24,8,17,49
"11721","chr19",23708501,23708524,24,67,94,185
"11722","chr19",23766937,23766959,23,65,132,220
"11723","chr19",23971579,23971610,32,32,82,146
"11724","chr19",24011825,24011842,18,76,62,156
"11725","chr19",24055206,24055232,27,12,71,110
"11726","chr19",24055267,24055290,24,70,10,104
"11727","chr19",27806275,27806296,22,18,5,45
"11728","chr19",28020726,28020751,26,1,26,53
"11729","chr19",28520284,28520329,46,23,58,127
"11730","chr19",29255646,29255668,23,76,99,198
"11731","chr19",29525383,29525401,19,30,30,79
"11732","chr19",29644194,29644214,21,130,5,156
"11733","chr19",29699303,29699325,23,19,36,78
"11734","chr19",29760509,29760531,23,72,9,104
"11735","chr19",29773509,29773545,37,8,29,74
"11736","chr19",29795077,29795094,18,55,6,79
"11737","chr19",29809180,29809211,32,147,4,183
"11738","chr19",29812077,29812115,39,16,11,66
"11739","chr19",29812602,29812628,27,101,89,217
"11740","chr19",29843368,29843414,47,11,75,133
"11741","chr19",29844484,29844520,37,52,15,104
"11742","chr19",29847963,29847985,23,145,25,193
"11743","chr19",29869868,29869885,18,35,76,129
"11744","chr19",29890412,29891550,1139,120,69,1328
"11745","chr19",30072224,30072242,19,4,22,45
"11746","chr19",30125045,30125216,172,32,18,222
"11747","chr19",30213072,30213089,18,8,124,150
"11748","chr19",30214076,30214125,50,68,75,193
"11749","chr19",30226674,30226691,18,124,6,148
"11750","chr19",30227740,30227762,23,23,11,57
"11751","chr19",30473038,30473056,19,145,25,189
"11752","chr19",30576993,30577014,22,11,46,79
"11753","chr19",30620348,30620372,25,16,56,97
"11754","chr19",30722171,30722192,22,79,7,108
"11755","chr19",31216625,31216653,29,75,98,202
"11756","chr19",31349479,31349523,45,141,9,195
"11757","chr19",31379828,31379860,33,74,50,157
"11758","chr19",32305642,32305664,23,77,32,132
"11759","chr19",32322516,32322564,49,69,75,193
"11760","chr19",32332906,32332923,18,17,4,39
"11761","chr19",32645606,32645650,45,76,143,264
"11762","chr19",32852906,32852929,24,9,46,79
"11763","chr19",32868231,32868250,20,33,6,59
"11764","chr19",33003358,33003382,25,122,6,153
"11765","chr19",33032017,33032038,22,126,13,161
"11766","chr19",33066896,33066917,22,112,110,244
"11767","chr19",33099766,33099786,21,74,75,170
"11768","chr19",33113119,33113145,27,134,116,277
"11769","chr19",33126956,33126985,30,77,32,139
"11770","chr19",33132092,33132118,27,10,24,61
"11771","chr19",33142852,33142880,29,147,27,203
"11772","chr19",33183967,33183991,25,88,6,119
"11773","chr19",33187572,33187597,26,62,13,101
"11774","chr19",33187578,33187612,35,77,7,119
"11775","chr19",33194658,33194746,89,9,130,228
"11776","chr19",33301826,33301846,21,41,6,68
"11777","chr19",33301849,33301869,21,14,49,84
"11778","chr19",33302102,33302120,19,3,4,26
"11779","chr19",33442709,33442761,53,24,6,83
"11780","chr19",33624076,33624098,23,111,93,227
"11781","chr19",33666699,33666717,19,73,29,121
"11782","chr19",33692990,33693011,22,45,30,97
"11783","chr19",33694904,33694971,68,124,34,226
"11784","chr19",33796707,33796730,24,1,2,27
"11785","chr19",33810663,33810708,46,12,23,81
"11786","chr19",33916175,33916202,28,8,108,144
"11787","chr19",34001095,34001121,27,6,73,106
"11788","chr19",34067150,34067178,29,8,105,142
"11789","chr19",34069157,34069188,32,52,97,181
"11790","chr19",34128180,34128203,24,8,15,47
"11791","chr19",34172434,34172474,41,113,60,214
"11792","chr19",34237260,34237286,27,58,71,156
"11793","chr19",34246629,34246658,30,75,73,178
"11794","chr19",34259169,34259201,33,100,55,188
"11795","chr19",34284128,34284150,23,35,142,200
"11796","chr19",34301983,34302009,27,9,10,46
"11797","chr19",34302293,34302312,20,10,8,38
"11798","chr19",34365134,34365157,24,26,3,53
"11799","chr19",34374131,34374153,23,26,72,121
"11800","chr19",34501945,34501971,27,7,117,151
"11801","chr19",34975709,34975727,19,85,123,227
"11802","chr19",34983550,34983568,19,77,74,170
"11803","chr19",35000418,35000449,32,62,42,136
"11804","chr19",35030438,35030466,29,5,32,66
"11805","chr19",35031362,35031384,23,57,80,160
"11806","chr19",35072046,35072068,23,22,74,119
"11807","chr19",35268514,35268537,24,34,59,117
"11808","chr19",35268837,35268905,69,1,118,188
"11809","chr19",35269029,35269065,37,6,122,165
"11810","chr19",35269072,35269098,27,19,79,125
"11811","chr19",35269188,35269217,30,12,30,72
"11812","chr19",35290021,35290052,32,9,61,102
"11813","chr19",35331459,35331487,29,72,37,138
"11814","chr19",35335078,35335099,22,96,74,192
"11815","chr19",35362282,35362306,25,13,8,46
"11816","chr19",35652776,35652794,19,54,115,188
"11817","chr19",35688539,35688557,19,49,72,140
"11818","chr19",35699732,35699753,22,76,147,245
"11819","chr19",35704124,35704143,20,20,6,46
"11820","chr19",35718289,35718325,37,3,46,86
"11821","chr19",35775723,35775757,35,97,61,193
"11822","chr19",35794876,35794908,33,11,5,49
"11823","chr19",35817925,35817943,19,19,3,41
"11824","chr19",35895806,35895832,27,68,72,167
"11825","chr19",35899558,35899582,25,8,13,46
"11826","chr19",35935347,35935369,23,6,77,106
"11827","chr19",35978117,35978142,26,123,14,163
"11828","chr19",35999688,35999708,21,78,144,243
"11829","chr19",36032287,36032317,31,21,6,58
"11830","chr19",36105681,36105708,28,68,65,161
"11831","chr19",36109736,36109768,33,95,4,132
"11832","chr19",36122755,36122773,19,89,74,182
"11833","chr19",36141039,36141058,20,90,2,112
"11834","chr19",36143864,36143893,30,12,5,47
"11835","chr19",36144177,36144207,31,54,5,90
"11836","chr19",36152531,36152557,27,38,47,112
"11837","chr19",36232596,36232623,28,73,42,143
"11838","chr19",36267081,36267115,35,30,89,154
"11839","chr19",36269611,36269667,57,65,12,134
"11840","chr19",36279740,36279798,59,65,1,125
"11841","chr19",36287344,36287404,61,65,1,127
"11842","chr19",36292417,36292469,53,67,1,121
"11843","chr19",36302538,36302592,55,65,1,121
"11844","chr19",36305057,36305107,51,65,12,128
"11845","chr19",36307583,36307635,53,65,1,119
"11846","chr19",36342176,36342198,23,8,124,155
"11847","chr19",36358046,36358118,73,66,142,281
"11848","chr19",36421277,36421294,18,12,104,134
"11849","chr19",36570361,36570405,45,5,6,56
"11850","chr19",36575835,36575867,33,9,30,72
"11851","chr19",36592285,36592307,23,74,74,171
"11852","chr19",36614881,36614981,101,57,104,262
"11853","chr19",36667645,36667669,25,10,88,123
"11854","chr19",36763937,36763964,28,62,75,165
"11855","chr19",36795744,36795779,36,5,75,116
"11856","chr19",36844008,36844038,31,147,6,184
"11857","chr19",36886994,36887013,20,77,6,103
"11858","chr19",36890856,36890878,23,27,6,56
"11859","chr19",37270968,37271032,65,5,63,133
"11860","chr19",37273509,37273560,52,5,63,120
"11861","chr19",37276036,37276097,62,4,63,129
"11862","chr19",37278574,37278620,47,3,63,113
"11863","chr19",37281102,37281150,49,5,63,117
"11864","chr19",37283628,37283675,48,5,63,116
"11865","chr19",37286147,37286199,53,5,63,121
"11866","chr19",37288675,37288721,47,3,63,113
"11867","chr19",37291199,37291249,51,5,63,119
"11868","chr19",37293726,37293772,47,3,63,113
"11869","chr19",37296250,37296300,51,5,63,119
"11870","chr19",37298775,37298827,53,5,63,121
"11871","chr19",37301303,37301364,62,4,63,129
"11872","chr19",37316358,37316382,25,3,30,58
"11873","chr19",37317180,37317203,24,7,37,68
"11874","chr19",37349965,37349983,19,42,135,196
"11875","chr19",37350107,37350130,24,11,135,170
"11876","chr19",37549292,37549322,31,69,35,135
"11877","chr19",37662779,37662798,20,60,74,154
"11878","chr19",37730226,37730247,22,78,55,155
"11879","chr19",37788849,37788872,24,148,74,246
"11880","chr19",37845094,37845125,32,147,6,185
"11881","chr19",37854056,37854091,36,18,95,149
"11882","chr19",37855039,37855070,32,42,1,75
"11883","chr19",37855786,37855810,25,28,74,127
"11884","chr19",37919706,37919727,22,75,68,165
"11885","chr19",38007452,38007483,32,127,75,234
"11886","chr19",38016887,38016914,28,76,88,192
"11887","chr19",38028693,38028710,18,8,115,141
"11888","chr19",38065903,38065948,46,124,137,307
"11889","chr19",38079531,38079555,25,58,115,198
"11890","chr19",38090331,38090348,18,48,73,139
"11891","chr19",38134708,38134732,25,40,5,70
"11892","chr19",38141058,38141082,25,41,6,72
"11893","chr19",38152762,38152782,21,12,41,74
"11894","chr19",38161341,38161361,21,66,7,94
"11895","chr19",38217380,38217397,18,71,33,122
"11896","chr19",38220203,38220339,137,147,59,343
"11897","chr19",38239881,38239903,23,120,4,147
"11898","chr19",38243377,38243395,19,137,5,161
"11899","chr19",38243553,38243580,28,126,6,160
"11900","chr19",38261442,38261468,27,8,75,110
"11901","chr19",38261758,38261777,20,8,3,31
"11902","chr19",38262201,38262220,20,8,143,171
"11903","chr19",38302055,38302079,25,76,39,140
"11904","chr19",38365699,38365726,28,77,18,123
"11905","chr19",38372961,38372994,34,12,57,103
"11906","chr19",38414299,38414335,37,67,71,175
"11907","chr19",38430370,38430390,21,85,35,141
"11908","chr19",38458611,38458637,27,3,1,31
"11909","chr19",38474565,38474592,28,8,143,179
"11910","chr19",38570455,38570478,24,10,71,105
"11911","chr19",38592918,38592947,30,123,5,158
"11912","chr19",38617246,38617273,28,31,6,65
"11913","chr19",38637731,38637748,18,123,32,173
"11914","chr19",38637914,38637952,39,7,12,58
"11915","chr19",38641323,38641353,31,148,64,243
"11916","chr19",38645656,38645675,20,9,46,75
"11917","chr19",38691903,38691921,19,62,6,87
"11918","chr19",38728411,38728450,40,46,20,106
"11919","chr19",38756297,38756323,27,139,6,172
"11920","chr19",38758354,38758376,23,135,10,168
"11921","chr19",38804829,38804862,34,136,3,173
"11922","chr19",38806368,38806402,35,85,6,126
"11923","chr19",38809174,38809196,23,7,30,60
"11924","chr19",38846907,38846925,19,126,7,152
"11925","chr19",38849704,38849753,50,3,113,166
"11926","chr19",38849836,38849862,27,69,40,136
"11927","chr19",38865832,38865849,18,100,66,184
"11928","chr19",38875197,38875230,34,35,12,81
"11929","chr19",38881674,38881705,32,8,17,57
"11930","chr19",38962107,38962128,22,146,1,169
"11931","chr19",39011818,39011846,29,76,55,160
"11932","chr19",39050276,39050306,31,6,52,89
"11933","chr19",39060935,39060963,29,78,10,117
"11934","chr19",39090477,39090498,22,74,137,233
"11935","chr19",39118885,39118904,20,77,145,242
"11936","chr19",39123838,39123920,83,144,39,266
"11937","chr19",39136756,39136782,27,91,37,155
"11938","chr19",39144771,39144794,24,51,39,114
"11939","chr19",39165347,39165365,19,77,27,123
"11940","chr19",39192704,39192742,39,52,34,125
"11941","chr19",39299193,39299230,38,11,5,54
"11942","chr19",39306731,39306804,74,5,70,149
"11943","chr19",39322411,39322456,46,76,143,265
"11944","chr19",39335919,39335945,27,59,69,155
"11945","chr19",39342443,39342466,24,22,65,111
"11946","chr19",39365243,39365262,20,138,9,167
"11947","chr19",39392027,39392049,23,75,4,102
"11948","chr19",39406768,39406802,35,126,47,208
"11949","chr19",39437279,39437306,28,8,134,170
"11950","chr19",39444186,39444205,20,10,94,124
"11951","chr19",39463007,39463028,22,19,75,116
"11952","chr19",39515578,39515597,20,24,22,66
"11953","chr19",39517965,39517991,27,15,33,75
"11954","chr19",40167516,40167539,24,126,1,151
"11955","chr19",40183801,40183818,18,145,21,184
"11956","chr19",40191798,40191829,32,19,68,119
"11957","chr19",40195472,40195508,37,73,145,255
"11958","chr19",40210270,40210291,22,57,71,150
"11959","chr19",40244046,40244099,54,18,4,76
"11960","chr19",40246089,40246108,20,142,12,174
"11961","chr19",40289278,40289305,28,25,5,58
"11962","chr19",40307090,40307115,26,77,10,113
"11963","chr19",40333255,40333309,55,11,9,75
"11964","chr19",40384294,40384321,28,8,63,99
"11965","chr19",40394268,40394295,28,23,110,161
"11966","chr19",40402354,40402387,34,49,6,89
"11967","chr19",40433143,40433162,20,74,84,178
"11968","chr19",40433287,40433307,21,137,35,193
"11969","chr19",40544441,40544464,24,75,12,111
"11970","chr19",40595771,40595789,19,49,2,70
"11971","chr19",40597140,40597177,38,119,32,189
"11972","chr19",40597317,40597340,24,117,6,147
"11973","chr19",40663220,40663243,24,65,93,182
"11974","chr19",40690743,40690760,18,24,5,47
"11975","chr19",40732240,40732258,19,23,71,113
"11976","chr19",40732522,40732547,26,77,14,117
"11977","chr19",40746387,40746414,28,97,26,151
"11978","chr19",40757947,40757978,32,70,69,171
"11979","chr19",40782811,40782843,33,134,8,175
"11980","chr19",40790665,40790685,21,62,16,99
"11981","chr19",40799074,40799096,23,6,24,53
"11982","chr19",40837714,40837735,22,91,74,187
"11983","chr19",41119684,41119724,41,10,79,130
"11984","chr19",41119724,41119749,26,35,39,100
"11985","chr19",41119749,41119785,37,71,14,122
"11986","chr19",41149400,41149427,28,145,74,247
"11987","chr19",41151413,41151449,37,20,8,65
"11988","chr19",41163582,41163608,27,22,6,55
"11989","chr19",41166316,41166347,32,74,26,132
"11990","chr19",41166505,41166525,21,73,69,163
"11991","chr19",41173732,41173751,20,29,43,92
"11992","chr19",41203738,41203786,49,33,102,184
"11993","chr19",41289714,41289733,20,128,56,204
"11994","chr19",41309833,41309852,20,39,9,68
"11995","chr19",41375264,41375298,35,10,77,122
"11996","chr19",41376121,41376143,23,101,73,197
"11997","chr19",41376166,41376184,19,142,28,189
"11998","chr19",41395034,41395060,27,90,6,123
"11999","chr19",41404285,41404303,19,4,140,163
"12000","chr19",41452467,41452490,24,68,89,181
"12001","chr19",41501338,41501362,25,69,144,238
"12002","chr19",41644083,41644143,61,75,63,199
"12003","chr19",41714200,41714222,23,108,89,220
"12004","chr19",41768943,41768964,22,9,11,42
"12005","chr19",41816025,41816045,21,7,46,74
"12006","chr19",41817625,41817655,31,81,10,122
"12007","chr19",41863843,41863864,22,80,141,243
"12008","chr19",41865950,41865971,22,147,5,174
"12009","chr19",41894124,41894179,56,32,118,206
"12010","chr19",41913262,41913281,20,90,4,114
"12011","chr19",41928464,41928518,55,101,56,212
"12012","chr19",41928593,41928628,36,47,121,204
"12013","chr19",41963865,41963882,18,9,75,102
"12014","chr19",41970627,41970649,23,8,4,35
"12015","chr19",41977533,41977550,18,78,24,120
"12016","chr19",41977705,41977731,27,96,68,191
"12017","chr19",42007091,42007113,23,9,56,88
"12018","chr19",42018150,42018174,25,53,31,109
"12019","chr19",42026558,42026583,26,73,141,240
"12020","chr19",42058173,42058199,27,9,25,61
"12021","chr19",42084965,42084982,18,9,145,172
"12022","chr19",42089711,42089748,38,3,80,121
"12023","chr19",42101105,42101138,34,72,68,174
"12024","chr19",42177009,42177031,23,56,8,87
"12025","chr19",42177252,42177282,31,44,24,99
"12026","chr19",42223975,42224003,29,111,19,159
"12027","chr19",42253768,42253820,53,16,46,115
"12028","chr19",42253785,42253824,40,20,29,89
"12029","chr19",42253860,42253887,28,83,5,116
"12030","chr19",42267097,42267121,25,86,17,128
"12031","chr19",42386289,42386308,20,146,73,239
"12032","chr19",42386428,42386445,18,77,35,130
"12033","chr19",42387652,42387689,38,4,11,53
"12034","chr19",42391840,42391861,22,57,96,175
"12035","chr19",42676957,42676977,21,145,27,193
"12036","chr19",42855175,42855208,34,76,65,175
"12037","chr19",42879143,42879170,28,76,65,169
"12038","chr19",43129086,43129110,25,29,77,131
"12039","chr19",43185957,43185994,38,76,65,179
"12040","chr19",43415223,43415242,20,43,31,94
"12041","chr19",43444421,43444462,42,77,142,261
"12042","chr19",43487575,43487592,18,77,6,101
"12043","chr19",43537772,43537805,34,10,115,159
"12044","chr19",43559142,43559164,23,110,5,138
"12045","chr19",43583965,43583987,23,77,22,122
"12046","chr19",43607709,43607737,29,22,71,122
"12047","chr19",43630271,43630303,33,76,79,188
"12048","chr19",43639794,43639816,23,16,18,57
"12049","chr19",43639843,43639878,36,78,4,118
"12050","chr19",43645124,43645177,54,6,30,90
"12051","chr19",43757208,43757234,27,65,6,98
"12052","chr19",44140281,44140299,19,6,10,35
"12053","chr19",44212367,44212391,25,76,92,193
"12054","chr19",44523410,44523448,39,23,6,68
"12055","chr19",44525424,44525459,36,7,25,68
"12056","chr19",44590686,44590708,23,145,46,214
"12057","chr19",44621283,44621301,19,14,74,107
"12058","chr19",44650865,44650883,19,5,145,169
"12059","chr19",44665636,44665660,25,129,72,226
"12060","chr19",44716638,44716662,25,48,144,217
"12061","chr19",44730669,44730711,43,145,9,197
"12062","chr19",44731551,44731569,19,68,102,189
"12063","chr19",44809025,44809043,19,50,26,95
"12064","chr19",44828317,44828354,38,76,56,170
"12065","chr19",44846415,44846434,20,53,56,129
"12066","chr19",44846585,44846602,18,46,60,124
"12067","chr19",44862993,44863012,20,32,28,80
"12068","chr19",44915968,44915987,20,77,75,172
"12069","chr19",44928870,44928898,29,133,128,290
"12070","chr19",44936327,44936365,39,77,9,125
"12071","chr19",45001413,45001442,30,25,35,90
"12072","chr19",45064037,45064058,22,3,18,43
"12073","chr19",45064349,45064372,24,14,7,45
"12074","chr19",45064388,45064426,39,38,23,100
"12075","chr19",45064465,45064510,46,44,4,94
"12076","chr19",45067455,45067515,61,108,72,241
"12077","chr19",45076379,45076427,49,64,126,239
"12078","chr19",45095759,45095778,20,79,143,242
"12079","chr19",45106808,45106834,27,8,85,120
"12080","chr19",45111259,45111285,27,69,9,105
"12081","chr19",45171300,45171337,38,35,8,81
"12082","chr19",45179490,45179511,22,67,12,101
"12083","chr19",45251341,45251366,26,13,18,57
"12084","chr19",45281348,45281375,28,33,16,77
"12085","chr19",45288850,45288867,18,107,74,199
"12086","chr19",45301558,45301579,22,148,73,243
"12087","chr19",45309228,45309245,18,70,74,162
"12088","chr19",45330173,45330217,45,34,108,187
"12089","chr19",45334382,45334406,25,8,64,97
"12090","chr19",45344155,45344178,24,23,122,169
"12091","chr19",45344215,45344232,18,77,62,157
"12092","chr19",45347341,45347370,30,101,7,138
"12093","chr19",45378362,45378384,23,76,144,243
"12094","chr19",45383294,45383316,23,81,145,249
"12095","chr19",45384065,45384096,32,5,7,44
"12096","chr19",45390091,45390108,18,76,145,239
"12097","chr19",45398573,45398602,30,9,130,169
"12098","chr19",45409232,45409251,20,23,112,155
"12099","chr19",45409476,45409493,18,134,12,164
"12100","chr19",45433082,45433101,20,5,4,29
"12101","chr19",45434764,45434792,29,7,64,100
"12102","chr19",45438627,45438654,28,3,144,175
"12103","chr19",45450888,45450905,18,5,74,97
"12104","chr19",45454992,45455012,21,9,68,98
"12105","chr19",45455052,45455073,22,70,8,100
"12106","chr19",45467617,45467650,34,9,79,122
"12107","chr19",45473064,45473090,27,11,7,45
"12108","chr19",45486698,45486749,52,73,124,249
"12109","chr19",45496963,45496995,33,88,51,172
"12110","chr19",45506850,45506874,25,86,64,175
"12111","chr19",45544796,45544828,33,140,4,177
"12112","chr19",45544986,45545015,30,77,3,110
"12113","chr19",45546665,45546684,20,9,73,102
"12114","chr19",45548648,45548675,28,112,61,201
"12115","chr19",45548791,45548821,31,76,73,180
"12116","chr19",45562344,45562385,42,124,9,175
"12117","chr19",45574397,45574425,29,96,74,199
"12118","chr19",45611870,45611891,22,78,57,157
"12119","chr19",45615520,45615555,36,101,4,141
"12120","chr19",45625233,45625259,27,77,31,135
"12121","chr19",45634534,45634575,42,4,35,81
"12122","chr19",45640401,45640432,32,67,129,228
"12123","chr19",45640409,45640444,36,79,121,236
"12124","chr19",45649957,45649988,32,76,140,248
"12125","chr19",45661440,45661463,24,9,97,130
"12126","chr19",45681500,45681530,31,22,69,122
"12127","chr19",45700958,45700977,20,51,75,146
"12128","chr19",45732569,45732611,43,11,45,99
"12129","chr19",45749672,45749715,44,140,74,258
"12130","chr19",45759788,45759819,32,8,48,88
"12131","chr19",45760608,45760634,27,135,4,166
"12132","chr19",45761790,45761827,38,11,90,139
"12133","chr19",45762420,45762443,24,74,70,168
"12134","chr19",45770205,45770266,62,68,62,192
"12135","chr19",45771741,45771762,22,85,24,131
"12136","chr19",45774263,45774280,18,9,134,161
"12137","chr19",45776135,45776159,25,74,82,181
"12138","chr19",45810151,45810183,33,40,116,189
"12139","chr19",45863114,45863133,20,97,67,184
"12140","chr19",45888615,45888640,26,135,73,234
"12141","chr19",45888623,45888648,26,143,65,234
"12142","chr19",45890862,45890892,31,41,11,83
"12143","chr19",45893569,45893588,20,112,73,205
"12144","chr19",45919363,45919385,23,103,6,132
"12145","chr19",45959110,45959136,27,20,113,160
"12146","chr19",45963136,45963153,18,69,110,197
"12147","chr19",45973365,45973489,125,1,119,245
"12148","chr19",45973547,45973610,64,14,128,206
"12149","chr19",45973565,45973635,71,39,110,220
"12150","chr19",45987860,45987883,24,39,67,130
"12151","chr19",45992791,45992813,23,76,126,225
"12152","chr19",46241269,46241290,22,146,98,266
"12153","chr19",46247366,46247386,21,117,11,149
"12154","chr19",46293852,46293878,27,139,67,233
"12155","chr19",46361590,46361615,26,77,28,131
"12156","chr19",46422990,46423011,22,117,6,145
"12157","chr19",46432185,46432211,27,58,23,108
"12158","chr19",46463275,46463295,21,147,6,174
"12159","chr19",46480039,46480073,35,36,72,143
"12160","chr19",46497374,46497397,24,77,76,177
"12161","chr19",46507745,46507787,43,53,2,98
"12162","chr19",46523552,46523605,54,137,78,269
"12163","chr19",46536035,46536086,52,75,3,130
"12164","chr19",46601299,46601317,19,44,84,147
"12165","chr19",46650081,46650100,20,27,22,69
"12166","chr19",46689117,46689136,20,5,98,123
"12167","chr19",46717082,46717100,19,36,75,130
"12168","chr19",46735966,46735989,24,9,72,105
"12169","chr19",46745654,46745672,19,1,59,79
"12170","chr19",46745831,46745857,27,46,6,79
"12171","chr19",46746095,46746116,22,16,1,39
"12172","chr19",46747388,46747410,23,7,51,81
"12173","chr19",46749724,46749741,18,14,7,39
"12174","chr19",46771636,46771660,25,76,71,172
"12175","chr19",46800624,46800642,19,12,53,84
"12176","chr19",46830570,46830601,32,71,9,112
"12177","chr19",46849011,46849030,20,83,12,115
"12178","chr19",46855739,46855764,26,58,64,148
"12179","chr19",46861083,46861119,37,23,143,203
"12180","chr19",46874811,46874829,19,8,136,163
"12181","chr19",46879588,46879618,31,61,73,165
"12182","chr19",46892124,46892153,30,76,34,140
"12183","chr19",46907479,46907509,31,21,116,168
"12184","chr19",47007644,47007673,30,76,145,251
"12185","chr19",47029397,47029416,20,75,132,227
"12186","chr19",47040024,47040043,20,79,129,228
"12187","chr19",47056898,47056923,26,75,76,177
"12188","chr19",47092817,47092850,34,63,6,103
"12189","chr19",47103763,47103783,21,21,35,77
"12190","chr19",47112303,47112332,30,12,82,124
"12191","chr19",47112514,47112541,28,123,25,176
"12192","chr19",47116185,47116212,28,19,7,54
"12193","chr19",47121304,47121323,20,76,7,103
"12194","chr19",47127696,47127719,24,74,85,183
"12195","chr19",47213826,47213859,34,8,143,185
"12196","chr19",47215367,47215387,21,144,10,175
"12197","chr19",47216578,47216607,30,76,70,176
"12198","chr19",47222964,47222984,21,8,7,36
"12199","chr19",47226328,47226352,25,142,45,212
"12200","chr19",47231147,47231164,18,50,103,171
"12201","chr19",47231234,47231265,32,45,16,93
"12202","chr19",47243283,47243326,44,119,114,277
"12203","chr19",47287964,47287986,23,78,92,193
"12204","chr19",47309573,47309591,19,62,8,89
"12205","chr19",47314379,47314413,35,74,57,166
"12206","chr19",47319305,47319326,22,45,23,90
"12207","chr19",47330297,47330325,29,17,5,51
"12208","chr19",47386624,47386652,29,52,74,155
"12209","chr19",47410453,47410483,31,146,69,246
"12210","chr19",47457742,47457844,103,51,31,185
"12211","chr19",47528316,47528335,20,9,73,102
"12212","chr19",47552743,47552771,29,90,74,193
"12213","chr19",47604959,47604976,18,78,145,241
"12214","chr19",47607837,47607872,36,9,41,86
"12215","chr19",47608837,47608859,23,23,6,52
"12216","chr19",47609377,47609398,22,3,73,98
"12217","chr19",47619181,47619212,32,13,7,52
"12218","chr19",47622724,47622747,24,137,74,235
"12219","chr19",47641071,47641093,23,133,71,227
"12220","chr19",47655526,47655548,23,135,5,163
"12221","chr19",47658632,47658653,22,48,73,143
"12222","chr19",47701537,47701573,37,44,11,92
"12223","chr19",47709886,47709908,23,8,145,176
"12224","chr19",47725397,47725419,23,76,111,210
"12225","chr19",47743418,47743457,40,112,83,235
"12226","chr19",47810255,47810281,27,22,125,174
"12227","chr19",47810345,47810366,22,8,35,65
"12228","chr19",47831307,47831327,21,98,6,125
"12229","chr19",47839352,47839386,35,29,49,113
"12230","chr19",47840704,47840723,20,68,8,96
"12231","chr19",47849623,47849684,62,42,22,126
"12232","chr19",47861125,47861165,41,104,11,156
"12233","chr19",47865808,47865830,23,75,70,168
"12234","chr19",47876769,47876789,21,144,74,239
"12235","chr19",47894011,47894047,37,76,134,247
"12236","chr19",47908792,47908823,32,5,135,172
"12237","chr19",47914167,47914213,47,5,135,187
"12238","chr19",47919543,47919568,26,9,135,170
"12239","chr19",47924896,47924918,23,8,132,163
"12240","chr19",47929934,47929965,32,5,135,172
"12241","chr19",47935295,47935320,26,9,135,170
"12242","chr19",47940659,47940705,47,5,135,187
"12243","chr19",47946037,47946063,27,5,135,167
"12244","chr19",47951410,47951451,42,5,135,182
"12245","chr19",47956798,47956834,37,5,135,177
"12246","chr19",47998426,47998449,24,93,59,176
"12247","chr19",48033015,48033032,18,21,61,100
"12248","chr19",48132791,48132817,27,74,6,107
"12249","chr19",48192450,48192481,32,9,74,115
"12250","chr19",48192481,48192499,19,27,43,89
"12251","chr19",48192499,48192519,21,47,25,93
"12252","chr19",48214770,48214803,34,5,26,65
"12253","chr19",48272425,48272445,21,146,61,228
"12254","chr19",48273405,48273442,38,103,14,155
"12255","chr19",48276075,48276096,22,7,31,60
"12256","chr19",48292253,48292273,21,78,34,133
"12257","chr19",48321237,48321263,27,115,7,149
"12258","chr19",48331199,48331222,24,8,56,88
"12259","chr19",48334401,48334584,184,50,10,244
"12260","chr19",48345777,48345800,24,6,139,169
"12261","chr19",48357350,48357370,21,7,52,80
"12262","chr19",48452082,48452116,35,8,75,118
"12263","chr19",48493917,48493951,35,5,89,129
"12264","chr19",48503816,48503880,65,71,9,145
"12265","chr19",48505082,48505104,23,49,60,132
"12266","chr19",48505104,48505129,26,74,38,138
"12267","chr19",48523794,48523823,30,8,21,59
"12268","chr19",48530766,48530784,19,76,14,109
"12269","chr19",48533380,48533405,26,7,105,138
"12270","chr19",48545042,48545061,20,108,43,171
"12271","chr19",48552454,48552471,18,1,83,102
"12272","chr19",48558657,48558701,45,76,4,125
"12273","chr19",48565366,48565401,36,12,5,53
"12274","chr19",48599348,48599367,20,16,48,84
"12275","chr19",48605020,48605043,24,43,74,141
"12276","chr19",48611144,48611175,32,65,95,192
"12277","chr19",48625822,48625846,25,86,15,126
"12278","chr19",48640368,48640391,24,7,38,69
"12279","chr19",48686046,48686077,32,86,18,136
"12280","chr19",48717701,48717718,18,4,144,166
"12281","chr19",48727683,48727703,21,7,40,68
"12282","chr19",48734478,48734505,28,8,146,182
"12283","chr19",48749291,48749329,39,148,9,196
"12284","chr19",48758252,48758291,40,52,12,104
"12285","chr19",48772995,48773029,35,76,77,188
"12286","chr19",48786335,48786357,23,77,47,147
"12287","chr19",48788399,48788426,28,10,16,54
"12288","chr19",48811933,48811965,33,67,4,104
"12289","chr19",48812130,48812147,18,59,13,90
"12290","chr19",48814196,48814227,32,137,5,174
"12291","chr19",48846454,48846476,23,3,3,29
"12292","chr19",48850819,48850852,34,6,117,157
"12293","chr19",48854365,48854386,22,9,47,78
"12294","chr19",48870506,48870566,61,8,74,143
"12295","chr19",48881377,48881399,23,76,143,242
"12296","chr19",48906404,48906421,18,124,6,148
"12297","chr19",48911396,48911422,27,75,23,125
"12298","chr19",48928128,48928149,22,42,6,70
"12299","chr19",48929546,48929595,50,121,60,231
"12300","chr19",48930511,48930537,27,136,65,228
"12301","chr19",48937812,48937833,22,13,6,41
"12302","chr19",48953837,48953875,39,96,72,207
"12303","chr19",48978531,48978553,23,12,5,40
"12304","chr19",49026604,49026623,20,147,69,236
"12305","chr19",49041555,49041589,35,74,73,182
"12306","chr19",49052526,49052569,44,99,142,285
"12307","chr19",49072668,49072685,18,23,7,48
"12308","chr19",49073021,49073041,21,73,9,103
"12309","chr19",49079309,49079336,28,55,2,85
"12310","chr19",49107821,49107839,19,5,1,25
"12311","chr19",49121787,49121813,27,29,64,120
"12312","chr19",49122079,49122097,19,7,6,32
"12313","chr19",49152527,49152550,24,39,10,73
"12314","chr19",49159025,49159049,25,8,57,90
"12315","chr19",49166746,49166785,40,17,55,112
"12316","chr19",49181947,49182501,555,29,30,614
"12317","chr19",49198647,49198668,22,128,7,157
"12318","chr19",49219541,49219567,27,27,73,127
"12319","chr19",49251222,49251263,42,66,29,137
"12320","chr19",49338259,49338277,19,71,86,176
"12321","chr19",49356379,49356400,22,69,96,187
"12322","chr19",49362912,49362950,39,55,42,136
"12323","chr19",49423274,49423301,28,57,102,187
"12324","chr19",49479195,49479212,18,8,1,27
"12325","chr19",49483867,49483892,26,66,79,171
"12326","chr19",49491403,49491420,18,44,99,161
"12327","chr19",49527279,49527311,33,3,128,164
"12328","chr19",49532368,49532391,24,6,48,78
"12329","chr19",49538162,49538180,19,8,27,54
"12330","chr19",49538330,49538348,19,37,75,131
"12331","chr19",49548303,49548355,53,19,140,212
"12332","chr19",49549636,49549661,26,99,6,131
"12333","chr19",49589961,49589981,21,58,92,171
"12334","chr19",49591602,49591624,23,73,39,135
"12335","chr19",49591791,49591818,28,32,37,97
"12336","chr19",49597935,49597958,24,122,7,153
"12337","chr19",49611923,49611948,26,145,6,177
"12338","chr19",49618102,49618129,28,100,2,130
"12339","chr19",49618376,49618401,26,4,96,126
"12340","chr19",49619536,49619558,23,7,10,40
"12341","chr19",49630656,49630676,21,131,7,159
"12342","chr19",49631487,49631511,25,7,125,157
"12343","chr19",49642185,49642210,26,38,62,126
"12344","chr19",49651194,49651254,61,51,76,188
"12345","chr19",49652105,49652135,31,47,71,149
"12346","chr19",49652728,49652759,32,36,101,169
"12347","chr19",49653452,49653506,55,1,56,112
"12348","chr19",49672861,49672884,24,8,72,104
"12349","chr19",49675733,49675752,20,38,8,66
"12350","chr19",49694629,49694646,18,138,6,162
"12351","chr19",49720142,49720208,67,10,76,153
"12352","chr19",49728996,49729024,29,73,134,236
"12353","chr19",49733760,49733781,22,80,9,111
"12354","chr19",49738717,49738756,40,79,22,141
"12355","chr19",49743494,49743515,22,76,132,230
"12356","chr19",49766985,49767003,19,16,101,136
"12357","chr19",49772247,49772277,31,42,4,77
"12358","chr19",49816008,49816026,19,29,75,123
"12359","chr19",49816155,49816182,28,78,143,249
"12360","chr19",49851239,49851257,19,41,16,76
"12361","chr19",49898322,49898345,24,136,5,165
"12362","chr19",49902512,49902535,24,137,83,244
"12363","chr19",49908962,49908985,24,124,95,243
"12364","chr19",49920521,49920550,30,11,5,46
"12365","chr19",49932628,49932654,27,52,20,99
"12366","chr19",49934241,49934261,21,128,33,182
"12367","chr19",49946074,49946110,37,76,71,184
"12368","chr19",49947027,49947048,22,72,42,136
"12369","chr19",50068147,50068179,33,6,5,44
"12370","chr19",50078736,50078780,45,53,19,117
"12371","chr19",50091471,50091495,25,137,7,169
"12372","chr19",50132730,50132748,19,134,66,219
"12373","chr19",50138103,50138120,18,134,66,218
"12374","chr19",50151973,50151998,26,77,119,222
"12375","chr19",50163755,50163784,30,100,2,132
"12376","chr19",50170962,50170980,19,78,28,125
"12377","chr19",50171111,50171135,25,31,92,148
"12378","chr19",50205303,50205321,19,42,81,142
"12379","chr19",50244480,50244501,22,8,18,48
"12380","chr19",50278813,50278831,19,70,115,204
"12381","chr19",50284537,50284572,36,38,22,96
"12382","chr19",50299571,50299595,25,80,6,111
"12383","chr19",50364315,50364333,19,13,12,44
"12384","chr19",50364615,50364635,21,72,6,99
"12385","chr19",50371723,50371748,26,6,21,53
"12386","chr19",50378576,50378599,24,68,40,132
"12387","chr19",50407726,50407748,23,32,75,130
"12388","chr19",50447858,50447894,37,111,73,221
"12389","chr19",50454421,50454443,23,8,9,40
"12390","chr19",50482214,50482247,34,144,76,254
"12391","chr19",50496869,50496889,21,121,110,252
"12392","chr19",50509245,50509271,27,34,51,112
"12393","chr19",50525581,50525598,18,34,67,119
"12394","chr19",50532234,50532265,32,73,76,181
"12395","chr19",50538047,50538065,19,61,1,81
"12396","chr19",50566074,50566091,18,3,123,144
"12397","chr19",50568222,50568297,76,83,33,192
"12398","chr19",50568343,50568371,29,37,2,68
"12399","chr19",50568459,50568525,67,112,5,184
"12400","chr19",50579830,50579863,34,28,6,68
"12401","chr19",50616272,50616293,22,12,7,41
"12402","chr19",50619008,50619052,45,21,51,117
"12403","chr19",50639795,50639851,57,12,31,100
"12404","chr19",50665567,50665592,26,32,6,64
"12405","chr19",50668375,50668392,18,138,13,169
"12406","chr19",50695080,50695108,29,10,64,103
"12407","chr19",50719733,50719750,18,25,19,62
"12408","chr19",50719819,50719869,51,84,10,145
"12409","chr19",50790457,50790481,25,20,113,158
"12410","chr19",50800587,50800605,19,145,23,187
"12411","chr19",50800755,50800776,22,49,6,77
"12412","chr19",50833936,50833980,45,9,145,199
"12413","chr19",50837882,50837922,41,4,5,50
"12414","chr19",50875804,50875829,26,86,69,181
"12415","chr19",50921814,50921837,24,20,73,117
"12416","chr19",50946551,50946576,26,7,38,71
"12417","chr19",51018703,51018727,25,58,7,90
"12418","chr19",51030321,51030360,40,69,94,203
"12419","chr19",51084953,51084982,30,90,81,201
"12420","chr19",51084975,51085017,43,125,59,227
"12421","chr19",51086117,51086147,31,24,73,128
"12422","chr19",51131916,51131933,18,45,74,137
"12423","chr19",51311757,51311774,18,21,23,62
"12424","chr19",51358490,51358517,28,3,48,79
"12425","chr19",51419391,51419411,21,67,74,162
"12426","chr19",51575210,51575234,25,76,134,235
"12427","chr19",51966548,51966566,19,97,46,162
"12428","chr19",52023079,52023113,35,3,7,45
"12429","chr19",52297051,52297143,93,11,29,133
"12430","chr19",52334937,52334959,23,50,65,138
"12431","chr19",52369363,52369384,22,61,6,89
"12432","chr19",52526560,52526591,32,8,8,48
"12433","chr19",52527514,52527542,29,20,39,88
"12434","chr19",52579875,52579905,31,22,73,126
"12435","chr19",52639416,52639436,21,9,115,145
"12436","chr19",52695321,52695341,21,145,7,173
"12437","chr19",52700639,52700660,22,73,14,109
"12438","chr19",52714690,52714713,24,141,4,169
"12439","chr19",52715006,52715029,24,97,66,187
"12440","chr19",52736741,52736763,23,46,135,204
"12441","chr19",52764519,52764537,19,123,3,145
"12442","chr19",52824149,52824191,43,44,114,201
"12443","chr19",52872497,52872520,24,9,89,122
"12444","chr19",52942710,52942738,29,89,18,136
"12445","chr19",52978014,52978049,36,125,142,303
"12446","chr19",52991389,52991422,34,145,101,280
"12447","chr19",52998088,52998110,23,59,6,88
"12448","chr19",53002136,53002154,19,93,110,222
"12449","chr19",53055722,53055765,44,7,22,73
"12450","chr19",53059537,53059557,21,75,94,190
"12451","chr19",53152603,53152629,27,128,78,233
"12452","chr19",53158901,53158927,27,31,2,60
"12453","chr19",53358300,53358335,36,74,85,195
"12454","chr19",53401565,53401586,22,138,71,231
"12455","chr19",53444966,53444997,32,75,53,160
"12456","chr19",53521322,53521362,41,23,9,73
"12457","chr19",53548098,53548125,28,8,142,178
"12458","chr19",53582601,53582621,21,147,11,179
"12459","chr19",53583767,53583786,20,70,8,98
"12460","chr19",53589497,53589525,29,73,9,111
"12461","chr19",53608183,53608253,71,49,63,183
"12462","chr19",53624842,53624864,23,43,74,140
"12463","chr19",53646703,53646728,26,102,76,204
"12464","chr19",53714044,53714067,24,41,38,103
"12465","chr19",53755966,53755988,23,76,145,244
"12466","chr19",53762987,53763015,29,77,67,173
"12467","chr19",53773641,53773666,26,10,124,160
"12468","chr19",53775403,53775436,34,19,66,119
"12469","chr19",53809225,53809245,21,142,75,238
"12470","chr19",53878622,53878651,30,97,4,131
"12471","chr19",53901552,53901571,20,148,65,233
"12472","chr19",53938948,53938972,25,145,6,176
"12473","chr19",53966081,53966105,25,8,58,91
"12474","chr19",53980058,53980086,29,76,125,230
"12475","chr19",53982546,53982631,86,56,48,190
"12476","chr19",54002268,54002298,31,35,136,202
"12477","chr19",54004901,54004927,27,13,25,65
"12478","chr19",54064789,54064811,23,40,118,181
"12479","chr19",54088362,54088380,19,29,75,123
"12480","chr19",54099060,54099078,19,6,42,67
"12481","chr19",54103835,54103852,18,9,62,89
"12482","chr19",54104136,54104155,20,8,8,36
"12483","chr19",54135935,54135958,24,10,74,108
"12484","chr19",54148440,54148473,34,123,128,285
"12485","chr19",54161317,54161337,21,47,50,118
"12486","chr19",54163289,54163311,23,109,55,187
"12487","chr19",54163309,54163328,20,12,35,67
"12488","chr19",54163961,54163979,19,63,145,227
"12489","chr19",54171966,54171995,30,33,12,75
"12490","chr19",54184905,54184922,18,55,5,78
"12491","chr19",54189148,54189175,28,74,5,107
"12492","chr19",54196839,54196856,18,1,42,61
"12493","chr19",54210772,54210789,18,149,74,241
"12494","chr19",54216292,54216326,35,7,6,48
"12495","chr19",54219159,54219185,27,1,20,48
"12496","chr19",54259287,54259309,23,117,71,211
"12497","chr19",54259305,54259326,22,134,53,209
"12498","chr19",54310947,54310973,27,76,92,195
"12499","chr19",54381988,54382009,22,48,6,76
"12500","chr19",54395012,54395052,41,53,9,103
"12501","chr19",54430669,54430690,22,77,60,159
"12502","chr19",54448942,54448972,31,64,33,128
"12503","chr19",54550696,54550728,33,60,6,99
"12504","chr19",54663444,54663464,21,117,8,146
"12505","chr19",54702293,54702321,29,54,144,227
"12506","chr19",54894076,54894103,28,19,50,97
"12507","chr19",54909935,54909956,22,138,74,234
"12508","chr19",54911349,54911385,37,58,6,101
"12509","chr19",54930116,54930139,24,15,73,112
"12510","chr19",54945239,54945271,33,59,10,102
"12511","chr19",54959128,54959156,29,8,119,156
"12512","chr19",54962577,54962600,24,59,139,222
"12513","chr19",54964212,54964234,23,8,112,143
"12514","chr19",55037624,55037650,27,9,24,60
"12515","chr19",55068891,55068947,57,79,19,155
"12516","chr19",55075812,55075831,20,30,106,156
"12517","chr19",55098631,55098649,19,3,130,152
"12518","chr19",55117601,55117619,19,89,37,145
"12519","chr19",55119379,55119410,32,7,71,110
"12520","chr19",55132335,55132353,19,139,74,232
"12521","chr19",55140781,55140821,41,22,2,65
"12522","chr19",55149791,55149810,20,1,136,157
"12523","chr19",55163313,55163331,19,29,7,55
"12524","chr19",55164482,55164500,19,34,6,59
"12525","chr19",55169581,55169599,19,24,146,189
"12526","chr19",55178754,55178784,31,79,141,251
"12527","chr19",55183411,55183430,20,75,67,162
"12528","chr19",55203397,55203423,27,66,4,97
"12529","chr19",55213100,55213119,20,63,73,156
"12530","chr19",55213115,55213133,19,77,58,154
"12531","chr19",55257079,55257099,21,85,63,169
"12532","chr19",55284043,55284077,35,56,94,185
"12533","chr19",55289988,55290011,24,44,71,139
"12534","chr19",55312534,55312562,29,8,33,70
"12535","chr19",55319434,55319463,30,9,124,163
"12536","chr19",55324650,55324685,36,33,4,73
"12537","chr19",55327174,55327215,42,40,3,85
"12538","chr19",55328044,55328061,18,75,125,218
"12539","chr19",55331417,55331478,62,33,17,112
"12540","chr19",55331478,55331506,29,61,24,114
"12541","chr19",55344362,55344379,18,31,74,123
"12542","chr19",55414198,55414233,36,8,72,116
"12543","chr19",55444338,55444357,20,144,37,201
"12544","chr19",55452547,55452590,44,12,98,154
"12545","chr19",55481985,55482024,40,31,53,124
"12546","chr19",55507340,55507362,23,124,46,193
"12547","chr19",55522661,55522682,22,36,143,201
"12548","chr19",55533660,55533704,45,35,67,147
"12549","chr19",55556173,55556205,33,28,74,135
"12550","chr19",55605591,55605619,29,7,12,48
"12551","chr19",55630592,55630632,41,70,9,120
"12552","chr19",55630787,55630806,20,28,76,124
"12553","chr19",55634734,55634757,24,80,75,179
"12554","chr19",55634771,55634788,18,111,38,167
"12555","chr19",55653661,55653678,18,109,78,205
"12556","chr19",55703279,55703301,23,36,104,163
"12557","chr19",55723728,55723749,22,84,74,180
"12558","chr19",55751104,55751129,26,62,123,211
"12559","chr19",55956237,55956259,23,6,53,82
"12560","chr19",56040567,56040600,34,132,57,223
"12561","chr19",56096715,56096755,41,77,4,122
"12562","chr19",56115355,56115376,22,8,9,39
"12563","chr19",56129031,56129092,62,6,96,164
"12564","chr19",56132905,56132955,51,8,100,159
"12565","chr19",56140757,56140774,18,28,61,107
"12566","chr19",56162821,56162856,36,73,117,226
"12567","chr19",56165485,56165524,40,12,71,123
"12568","chr19",56237975,56238014,40,76,16,132
"12569","chr19",56362560,56362582,23,142,15,180
"12570","chr19",56538768,56538879,112,44,90,246
"12571","chr19",56637633,56637669,37,55,6,98
"12572","chr19",56659735,56659757,23,8,62,93
"12573","chr19",56663163,56663181,19,89,3,111
"12574","chr19",56667959,56667977,19,38,51,108
"12575","chr19",56667978,56668012,35,73,32,140
"12576","chr19",56871788,56871806,19,61,72,152
"12577","chr19",57092074,57092094,21,70,130,221
"12578","chr19",57092096,57092130,35,106,108,249
"12579","chr19",57093460,57093488,29,73,42,144
"12580","chr19",57106325,57106347,23,17,12,52
"12581","chr19",57173873,57173920,48,35,25,108
"12582","chr19",57179181,57179220,40,71,95,206
"12583","chr19",57207723,57207741,19,5,107,131
"12584","chr19",57365847,57365878,32,72,105,209
"12585","chr19",57366548,57366567,20,12,71,103
"12586","chr19",57457934,57457969,36,35,144,215
"12587","chr19",57524884,57524920,37,10,132,179
"12588","chr19",57675142,57675165,24,76,55,155
"12589","chr19",57726092,57726132,41,37,77,155
"12590","chr19",57742909,57742926,18,145,1,164
"12591","chr19",57743071,57743088,18,14,11,43
"12592","chr19",57762023,57762052,30,76,104,210
"12593","chr19",57766151,57766174,24,86,76,186
"12594","chr19",57767433,57767460,28,46,139,213
"12595","chr19",57791480,57791501,22,29,75,126
"12596","chr19",57834845,57834867,23,66,75,164
"12597","chr19",57886884,57886902,19,8,70,97
"12598","chr19",57948242,57948264,23,76,19,118
"12599","chr19",57949050,57949071,22,21,73,116
"12600","chr19",57969555,57969596,42,70,6,118
"12601","chr19",58059342,58059368,27,66,22,115
"12602","chr19",58101126,58101150,25,76,49,150
"12603","chr19",58101300,58101322,23,29,75,127
"12604","chr19",58118470,58118505,36,45,93,174
"12605","chr19",58171843,58171860,18,76,53,147
"12606","chr19",58220830,58220856,27,65,72,164
"12607","chr19",58242680,58242716,37,76,142,255
"12608","chr19",58314627,58314650,24,27,74,125
"12609","chr19",58363471,58363488,18,49,5,72
"12610","chr19",58371241,58371259,19,146,74,239
"12611","chr19",58371410,58371430,21,12,4,37
"12612","chr19",58396202,58396223,22,103,35,160
"12613","chr19",58399183,58399205,23,4,79,106
"12614","chr19",58401886,58401904,19,12,22,53
"12615","chr19",58425422,58425474,53,62,40,155
"12616","chr19",58442162,58442179,18,69,66,153
"12617","chr19",58465094,58465115,22,69,61,152
"12618","chr19",58514364,58514382,19,96,13,128
"12619","chr19",58521052,58521082,31,147,74,252
"12620","chr19",58524406,58524474,69,20,33,122
"12621","chr19",58558385,58558413,29,2,8,39
"12622","chr2",35064,35081,18,77,51,146
"12623","chr2",46611,46628,18,15,4,37
"12624","chr2",424647,424682,36,66,8,110
"12625","chr2",579076,579099,24,29,78,131
"12626","chr2",676987,677015,29,51,1,81
"12627","chr2",956031,956303,273,102,54,429
"12628","chr2",1475415,1475441,27,8,14,49
"12629","chr2",1743633,1743749,117,6,8,131
"12630","chr2",1757420,1757448,29,73,7,109
"12631","chr2",1812876,1812896,21,15,74,110
"12632","chr2",2536764,2536783,20,74,132,226
"12633","chr2",2536878,2536901,24,118,18,160
"12634","chr2",2671566,2671600,35,41,74,150
"12635","chr2",2703709,2703732,24,54,139,217
"12636","chr2",2908901,2908918,18,80,71,169
"12637","chr2",3264685,3264711,27,82,16,125
"12638","chr2",3403231,3403249,19,7,130,156
"12639","chr2",3574844,3574862,19,9,106,134
"12640","chr2",3597916,3597949,34,72,62,168
"12641","chr2",3602916,3602948,33,17,8,58
"12642","chr2",3658877,3658895,19,60,65,144
"12643","chr2",3669650,3669668,19,22,4,45
"12644","chr2",3703578,3703628,51,53,36,140
"12645","chr2",4147934,4147957,24,69,44,137
"12646","chr2",4185033,4185051,19,142,68,229
"12647","chr2",4991038,4991072,35,8,31,74
"12648","chr2",5363688,5363706,19,29,141,189
"12649","chr2",5609261,5609278,18,9,29,56
"12650","chr2",5693394,5693422,29,76,41,146
"12651","chr2",5693753,5693783,31,52,15,98
"12652","chr2",5854565,5854597,33,136,127,296
"12653","chr2",6917826,6917887,62,40,30,132
"12654","chr2",7447947,7447982,36,6,29,71
"12655","chr2",8067529,8067563,35,26,49,110
"12656","chr2",8285495,8285516,22,75,118,215
"12657","chr2",8456390,8456412,23,87,53,163
"12658","chr2",8678995,8679027,33,81,116,230
"12659","chr2",8896239,8896259,21,101,74,196
"12660","chr2",9159783,9159807,25,138,15,178
"12661","chr2",9187243,9187264,22,83,74,179
"12662","chr2",9192346,9192367,22,76,137,235
"12663","chr2",9254528,9254553,26,35,67,128
"12664","chr2",9398809,9398826,18,38,74,130
"12665","chr2",9436775,9436796,22,70,3,95
"12666","chr2",9474539,9474557,19,28,97,144
"12667","chr2",9496108,9496146,39,8,136,183
"12668","chr2",9502880,9502903,24,58,74,156
"12669","chr2",9576335,9576358,24,78,74,176
"12670","chr2",9668191,9668230,40,3,139,182
"12671","chr2",9730725,9730879,155,8,76,239
"12672","chr2",9775208,9775247,40,51,4,95
"12673","chr2",9790291,9790311,21,76,40,137
"12674","chr2",9820888,9820912,25,7,46,78
"12675","chr2",9824026,9824058,33,133,112,278
"12676","chr2",9923238,9923256,19,7,11,37
"12677","chr2",10026658,10026684,27,145,33,205
"12678","chr2",10043622,10043639,18,63,94,175
"12679","chr2",10113385,10113426,42,78,16,136
"12680","chr2",10134171,10134192,22,76,14,112
"12681","chr2",10203761,10203786,26,125,64,215
"12682","chr2",10213013,10213134,122,44,73,239
"12683","chr2",10227765,10227782,18,80,40,138
"12684","chr2",10399209,10399607,399,4,1,404
"12685","chr2",10409778,10409807,30,76,14,120
"12686","chr2",10448287,10448311,25,14,34,73
"12687","chr2",10448556,10448630,75,87,8,170
"12688","chr2",10489205,10489228,24,8,81,113
"12689","chr2",10496254,10496280,27,129,111,267
"12690","chr2",10690416,10690440,25,65,19,109
"12691","chr2",10723838,10723856,19,85,75,179
"12692","chr2",10745037,10745059,23,74,77,174
"12693","chr2",10749131,10749150,20,3,73,96
"12694","chr2",10779429,10779464,36,73,125,234
"12695","chr2",10827065,10827083,19,78,83,180
"12696","chr2",11129454,11129477,24,35,74,133
"12697","chr2",11132998,11133042,45,47,70,162
"12698","chr2",11133282,11133300,19,20,14,53
"12699","chr2",11155100,11155151,52,55,42,149
"12700","chr2",11155286,11155351,66,47,51,164
"12701","chr2",11176526,11176546,21,8,135,164
"12702","chr2",11344312,11344350,39,1,61,101
"12703","chr2",11344716,11344734,19,29,9,57
"12704","chr2",11361054,11361087,34,73,24,131
"12705","chr2",11414355,11414398,44,80,73,197
"12706","chr2",11417852,11417915,64,18,117,199
"12707","chr2",11539796,11539817,22,74,100,196
"12708","chr2",11624342,11624361,20,7,31,58
"12709","chr2",11633186,11633203,18,70,125,213
"12710","chr2",11654483,11654517,35,58,68,161
"12711","chr2",11746554,11746594,41,127,83,251
"12712","chr2",12621306,12621333,28,79,36,143
"12713","chr2",12862135,12862156,22,29,75,126
"12714","chr2",14520431,14520452,22,3,144,169
"12715","chr2",15174967,15174988,22,80,132,234
"12716","chr2",15237772,15237792,21,76,135,232
"12717","chr2",15240447,15240467,21,77,111,209
"12718","chr2",15590920,15590950,31,31,140,202
"12719","chr2",15616063,15616087,25,31,140,196
"12720","chr2",15873674,15873692,19,86,74,179
"12721","chr2",15945507,15945529,23,48,40,111
"12722","chr2",16001938,16001962,25,6,144,175
"12723","chr2",16110995,16111023,29,8,79,116
"12724","chr2",16173403,16173447,45,6,118,169
"12725","chr2",17878589,17878622,34,102,76,212
"12726","chr2",18096437,18096461,25,29,77,131
"12727","chr2",18177694,18177717,24,7,75,106
"12728","chr2",18584603,18584620,18,37,32,87
"12729","chr2",18818737,18818758,22,45,6,73
"12730","chr2",19296767,19296784,18,77,27,122
"12731","chr2",20108479,20108496,18,77,27,122
"12732","chr2",20344983,20345009,27,46,74,147
"12733","chr2",20350742,20350770,29,43,33,105
"12734","chr2",20442569,20442593,25,8,57,90
"12735","chr2",20446571,20446613,43,85,30,158
"12736","chr2",20593441,20593463,23,117,25,165
"12737","chr2",20598540,20598576,37,8,119,164
"12738","chr2",20608575,20608596,22,34,73,129
"12739","chr2",20624229,20624256,28,60,140,228
"12740","chr2",20667363,20667388,26,11,12,49
"12741","chr2",20822291,20822314,24,27,76,127
"12742","chr2",21043880,21043925,46,12,68,126
"12743","chr2",21741896,21741922,27,65,75,167
"12744","chr2",21741925,21741943,19,86,46,151
"12745","chr2",23385449,23385469,21,59,5,85
"12746","chr2",23385853,23385871,19,130,33,182
"12747","chr2",23621177,23621198,22,65,44,131
"12748","chr2",23858093,23858135,43,73,95,211
"12749","chr2",23949550,23949577,28,132,27,187
"12750","chr2",23952430,23952458,29,72,107,208
"12751","chr2",24059895,24059918,24,49,74,147
"12752","chr2",24084341,24084420,80,57,14,151
"12753","chr2",24331069,24331088,20,7,143,170
"12754","chr2",24372929,24372953,25,36,122,183
"12755","chr2",24374816,24374868,53,29,140,222
"12756","chr2",24430803,24430822,20,7,75,102
"12757","chr2",24491167,24491212,46,39,7,92
"12758","chr2",24491196,24491215,20,42,16,78
"12759","chr2",24491242,24491268,27,95,3,125
"12760","chr2",24730872,24730893,22,82,25,129
"12761","chr2",24760307,24760330,24,29,143,196
"12762","chr2",24829413,24829440,28,10,49,87
"12763","chr2",24870322,24870354,33,28,73,134
"12764","chr2",24920451,24920477,27,2,26,55
"12765","chr2",24950848,24950881,34,53,5,92
"12766","chr2",25052206,25052228,23,60,64,147
"12767","chr2",25059876,25059901,26,47,5,78
"12768","chr2",25068931,25068949,19,74,143,236
"12769","chr2",25113225,25113269,45,13,73,131
"12770","chr2",25124278,25124332,55,35,17,107
"12771","chr2",25131914,25131946,33,18,56,107
"12772","chr2",25131960,25131977,18,49,10,77
"12773","chr2",25206217,25206251,35,8,75,118
"12774","chr2",25208685,25208731,47,45,5,97
"12775","chr2",25210574,25210595,22,78,125,225
"12776","chr2",25271027,25271053,27,138,3,168
"12777","chr2",25340854,25340878,25,22,7,54
"12778","chr2",25353610,25353628,19,131,74,224
"12779","chr2",25458636,25458660,25,74,143,242
"12780","chr2",25502881,25502904,24,77,11,112
"12781","chr2",25536701,25536762,62,78,68,208
"12782","chr2",25541484,25541520,37,64,72,173
"12783","chr2",25855883,25855911,29,76,27,132
"12784","chr2",25860021,25860038,18,22,36,76
"12785","chr2",25897145,25897175,31,8,6,45
"12786","chr2",25901055,25901072,18,5,28,51
"12787","chr2",25913717,25913740,24,71,44,139
"12788","chr2",25921863,25921890,28,44,43,115
"12789","chr2",25922127,25922145,19,83,20,122
"12790","chr2",25939966,25939989,24,59,108,191
"12791","chr2",25953660,25953688,29,11,145,185
"12792","chr2",25970966,25970989,24,146,27,197
"12793","chr2",26138129,26138152,24,10,68,102
"12794","chr2",26160684,26160719,36,76,147,259
"12795","chr2",26175076,26175104,29,3,48,80
"12796","chr2",26178879,26178913,35,2,8,45
"12797","chr2",26241478,26241500,23,76,13,112
"12798","chr2",26271046,26271068,23,29,75,127
"12799","chr2",26286808,26286831,24,57,5,86
"12800","chr2",26459553,26459576,24,59,73,156
"12801","chr2",26683150,26683177,28,9,127,164
"12802","chr2",26692711,26692733,23,19,108,150
"12803","chr2",26720259,26720281,23,40,2,65
"12804","chr2",26783444,26783463,20,7,75,102
"12805","chr2",26813948,26813965,18,69,100,187
"12806","chr2",26815628,26815657,30,22,102,154
"12807","chr2",26844008,26844048,41,73,74,188
"12808","chr2",26876962,26876983,22,7,102,131
"12809","chr2",26971013,26971044,32,5,17,54
"12810","chr2",27016382,27016402,21,8,86,115
"12811","chr2",27049093,27049114,22,49,115,186
"12812","chr2",27061231,27061254,24,45,29,98
"12813","chr2",27086722,27086752,31,87,5,123
"12814","chr2",27117706,27117726,21,76,2,99
"12815","chr2",27127554,27127582,29,79,74,182
"12816","chr2",27147566,27147590,25,55,8,88
"12817","chr2",27147588,27147615,28,80,122,230
"12818","chr2",27188377,27188396,20,106,124,250
"12819","chr2",27309372,27309400,29,6,6,41
"12820","chr2",27366038,27366059,22,14,147,183
"12821","chr2",27366095,27366116,22,71,90,183
"12822","chr2",27420626,27420653,28,11,7,46
"12823","chr2",27422753,27422781,29,147,68,244
"12824","chr2",27429040,27429059,20,38,72,130
"12825","chr2",27446681,27446710,30,69,75,174
"12826","chr2",27473370,27473388,19,68,74,161
"12827","chr2",27505126,27505147,22,46,6,74
"12828","chr2",27699801,27699853,53,145,4,202
"12829","chr2",27755877,27755898,22,132,73,227
"12830","chr2",27769565,27769585,21,29,143,193
"12831","chr2",27783909,27783939,31,14,4,49
"12832","chr2",27783971,27784001,31,8,10,49
"12833","chr2",27840328,27840395,68,68,2,138
"12834","chr2",28261746,28261800,55,52,37,144
"12835","chr2",28348626,28348664,39,75,19,133
"12836","chr2",28528942,28528965,24,8,118,150
"12837","chr2",28656392,28656417,26,5,145,176
"12838","chr2",28858795,28858824,30,146,74,250
"12839","chr2",28893963,28893996,34,6,32,72
"12840","chr2",28990973,28991040,68,87,104,259
"12841","chr2",29322834,29322863,30,87,6,123
"12842","chr2",30016041,30016060,20,48,74,142
"12843","chr2",30096025,30096054,30,74,113,217
"12844","chr2",30238886,30238907,22,76,76,174
"12845","chr2",30337673,30337691,19,73,18,110
"12846","chr2",30740083,30740112,30,8,121,159
"12847","chr2",31838876,31838904,29,76,4,109
"12848","chr2",31925476,31925499,24,142,74,240
"12849","chr2",31994638,31994659,22,6,26,54
"12850","chr2",32010291,32010308,18,17,27,62
"12851","chr2",32010390,32010413,24,15,144,183
"12852","chr2",32050327,32050354,28,143,74,245
"12853","chr2",32051015,32051043,29,29,116,174
"12854","chr2",32093311,32093333,23,146,6,175
"12855","chr2",32135119,32135148,30,127,22,179
"12856","chr2",32279395,32279415,21,8,2,31
"12857","chr2",32322604,32322622,19,113,7,139
"12858","chr2",32327736,32327754,19,10,126,155
"12859","chr2",32334944,32334977,34,67,112,213
"12860","chr2",32336503,32336524,22,10,6,38
"12861","chr2",32343479,32343500,22,145,74,241
"12862","chr2",32343786,32343804,19,10,71,100
"12863","chr2",32627077,32627130,54,20,18,92
"12864","chr2",32669884,32669906,23,19,8,50
"12865","chr2",32682848,32682870,23,75,131,229
"12866","chr2",32881774,32881791,18,36,124,178
"12867","chr2",32903806,32903825,20,32,25,77
"12868","chr2",32947622,32947642,21,92,59,172
"12869","chr2",33375519,33375540,22,3,77,102
"12870","chr2",33375695,33375723,29,37,143,209
"12871","chr2",33422926,33422943,18,77,27,122
"12872","chr2",33514506,33514527,22,69,34,125
"12873","chr2",33548361,33548383,23,6,119,148
"12874","chr2",33725304,33725321,18,43,48,109
"12875","chr2",33819792,33819823,32,138,6,176
"12876","chr2",33876566,33876605,40,29,75,144
"12877","chr2",33923256,33923275,20,76,131,227
"12878","chr2",33927109,33927136,28,8,38,74
"12879","chr2",34352684,34352790,107,76,5,188
"12880","chr2",34813856,34813907,52,15,146,213
"12881","chr2",34813909,34813930,22,38,93,153
"12882","chr2",36355604,36355628,25,15,34,74
"12883","chr2",36356042,36356064,23,57,3,83
"12884","chr2",36717183,36717200,18,80,137,235
"12885","chr2",36717335,36717395,61,15,86,162
"12886","chr2",36966899,36966928,30,41,16,87
"12887","chr2",37120509,37120535,27,54,39,120
"12888","chr2",37125006,37125029,24,75,30,129
"12889","chr2",37156911,37156939,29,73,66,168
"12890","chr2",37235640,37235669,30,5,89,124
"12891","chr2",37324616,37324633,18,51,35,104
"12892","chr2",37329538,37329565,28,75,5,108
"12893","chr2",37671682,37671718,37,61,43,141
"12894","chr2",38015564,38015587,24,26,75,125
"12895","chr2",38331438,38331460,23,145,72,240
"12896","chr2",38370151,38370171,21,17,9,47
"12897","chr2",38499402,38499426,25,70,77,172
"12898","chr2",38658082,38658102,21,76,92,189
"12899","chr2",38731228,38731246,19,76,5,100
"12900","chr2",38760491,38760520,30,37,127,194
"12901","chr2",38800186,38800205,20,78,7,105
"12902","chr2",38874402,38874427,26,8,115,149
"12903","chr2",38932431,38932453,23,80,141,244
"12904","chr2",38962850,38962874,25,77,36,138
"12905","chr2",39102205,39102230,26,136,124,286
"12906","chr2",39120971,39121004,34,54,15,103
"12907","chr2",39122448,39122482,35,143,80,258
"12908","chr2",39135064,39135115,52,54,5,111
"12909","chr2",39156785,39156806,22,34,12,68
"12910","chr2",39205778,39205798,21,11,56,88
"12911","chr2",39206045,39206071,27,76,43,146
"12912","chr2",39354446,39354467,22,26,4,52
"12913","chr2",39355360,39355383,24,28,75,127
"12914","chr2",39374369,39374396,28,9,74,111
"12915","chr2",39396479,39396498,20,15,5,40
"12916","chr2",39449485,39449513,29,39,6,74
"12917","chr2",39449689,39449707,19,69,86,174
"12918","chr2",40069077,40069121,45,43,42,130
"12919","chr2",40331573,40331609,37,74,38,149
"12920","chr2",40415860,40415912,53,77,94,224
"12921","chr2",40482955,40482977,23,29,78,130
"12922","chr2",42047933,42047978,46,1,5,52
"12923","chr2",42048145,42048162,18,31,63,112
"12924","chr2",42122936,42122969,34,75,84,193
"12925","chr2",42200154,42200175,22,77,23,122
"12926","chr2",42216231,42216260,30,76,139,245
"12927","chr2",42289914,42289938,25,146,112,283
"12928","chr2",42515029,42515072,44,72,107,223
"12929","chr2",42521752,42521772,21,36,5,62
"12930","chr2",42536859,42536877,19,97,6,122
"12931","chr2",42555456,42555477,22,146,5,173
"12932","chr2",42598064,42598081,18,112,126,256
"12933","chr2",42810107,42810136,30,5,17,52
"12934","chr2",42812172,42812205,34,15,15,64
"12935","chr2",42997746,42997770,25,5,46,76
"12936","chr2",43021088,43021106,19,8,2,29
"12937","chr2",43042837,43042872,36,82,5,123
"12938","chr2",43151632,43151695,64,84,114,262
"12939","chr2",43216705,43216722,18,27,6,51
"12940","chr2",43224601,43224626,26,11,3,40
"12941","chr2",43242841,43242859,19,43,65,127
"12942","chr2",43431643,43431682,40,8,133,181
"12943","chr2",43431842,43431874,33,8,133,174
"12944","chr2",43480825,43480848,24,144,67,235
"12945","chr2",43763587,43763605,19,67,143,229
"12946","chr2",43915233,43915278,46,23,94,163
"12947","chr2",44000500,44000524,25,70,34,129
"12948","chr2",44032157,44032177,21,6,12,39
"12949","chr2",44153878,44153963,86,138,73,297
"12950","chr2",44227902,44227939,38,44,63,145
"12951","chr2",44894758,44894778,21,142,32,195
"12952","chr2",44943467,44943492,26,57,112,195
"12953","chr2",45187668,45187685,18,89,1,108
"12954","chr2",45580677,45580703,27,76,131,234
"12955","chr2",46061825,46061875,51,3,14,68
"12956","chr2",46097520,46097537,18,76,6,100
"12957","chr2",46184425,46184462,38,52,16,106
"12958","chr2",46542196,46542214,19,76,20,115
"12959","chr2",46577566,46577589,24,30,144,198
"12960","chr2",46617235,46617252,18,44,86,148
"12961","chr2",46640713,46640742,30,81,6,117
"12962","chr2",46680635,46680672,38,19,74,131
"12963","chr2",46941357,46941385,29,43,4,76
"12964","chr2",47151908,47151936,29,29,143,201
"12965","chr2",47299644,47299669,26,16,69,111
"12966","chr2",47308593,47308617,25,76,52,153
"12967","chr2",47387360,47387396,37,21,143,201
"12968","chr2",47491066,47491106,41,8,25,74
"12969","chr2",47570251,47570269,19,28,41,88
"12970","chr2",47624464,47624484,21,126,138,285
"12971","chr2",47636580,47636620,41,16,124,181
"12972","chr2",47672745,47672774,30,86,74,190
"12973","chr2",47788885,47788902,18,35,132,185
"12974","chr2",47788908,47788947,40,80,109,229
"12975","chr2",47829233,47829255,23,5,107,135
"12976","chr2",47848123,47848160,38,85,7,130
"12977","chr2",47905403,47905429,27,128,59,214
"12978","chr2",47905522,47905631,110,57,58,225
"12979","chr2",47906067,47906089,23,25,14,62
"12980","chr2",48356137,48356158,22,12,62,96
"12981","chr2",48440813,48440840,28,116,96,240
"12982","chr2",48530119,48530170,52,6,143,201
"12983","chr2",48565046,48565068,23,6,140,169
"12984","chr2",48755620,48755651,32,21,54,107
"12985","chr2",48794035,48794072,38,80,29,147
"12986","chr2",50281149,50281168,20,78,27,125
"12987","chr2",50434044,50434074,31,5,136,172
"12988","chr2",51348456,51348475,20,29,143,192
"12989","chr2",51581649,51581676,28,53,11,92
"12990","chr2",52608811,52608832,22,76,20,118
"12991","chr2",53659975,53659996,22,58,26,106
"12992","chr2",53667697,53667720,24,142,79,245
"12993","chr2",53787126,53787163,38,20,14,72
"12994","chr2",53834545,53834567,23,80,29,132
"12995","chr2",53852465,53852495,31,87,5,123
"12996","chr2",53859612,53859629,18,10,41,69
"12997","chr2",53971071,53971088,18,24,14,56
"12998","chr2",54035250,54035280,31,73,125,229
"12999","chr2",54035254,54035283,30,76,121,227
"13000","chr2",54162800,54162826,27,133,1,161
"13001","chr2",54202406,54202423,18,74,13,105
"13002","chr2",54307829,54307860,32,79,145,256
"13003","chr2",54506124,54506163,40,18,74,132
"13004","chr2",55050164,55050207,44,14,2,60
"13005","chr2",55070740,55070793,54,75,92,221
"13006","chr2",55216113,55216136,24,145,33,202
"13007","chr2",55271463,55271510,48,51,5,104
"13008","chr2",55272822,55272875,54,59,34,147
"13009","chr2",55409739,55409760,22,123,75,220
"13010","chr2",55638000,55638017,18,76,6,100
"13011","chr2",55694981,55695011,31,147,19,197
"13012","chr2",55944100,55944123,24,8,117,149
"13013","chr2",56120983,56121001,19,8,20,47
"13014","chr2",56184633,56184670,38,102,39,179
"13015","chr2",57115604,57115633,30,69,137,236
"13016","chr2",57203113,57203132,20,49,6,75
"13017","chr2",57477130,57477173,44,75,101,220
"13018","chr2",58428659,58428688,30,20,23,73
"13019","chr2",59839203,59839241,39,30,67,136
"13020","chr2",60405033,60405050,18,35,18,71
"13021","chr2",60552422,60552444,23,47,82,152
"13022","chr2",60704019,60704036,18,72,54,144
"13023","chr2",60815767,60815789,23,76,66,165
"13024","chr2",61026333,61026362,30,121,113,264
"13025","chr2",61143963,61143989,27,80,109,216
"13026","chr2",61445535,61445552,18,129,74,221
"13027","chr2",61452319,61452342,24,77,144,245
"13028","chr2",61465977,61465999,23,4,6,33
"13029","chr2",61584539,61584606,68,78,75,221
"13030","chr2",61643472,61643492,21,76,98,195
"13031","chr2",61697128,61697147,20,137,45,202
"13032","chr2",61735137,61735176,40,75,122,237
"13033","chr2",61812723,61812763,41,123,5,169
"13034","chr2",61889203,61889226,24,79,63,166
"13035","chr2",62197093,62197120,28,72,30,130
"13036","chr2",62229970,62230003,34,69,136,239
"13037","chr2",62280062,62280099,38,76,32,146
"13038","chr2",62290569,62290609,41,91,55,187
"13039","chr2",62290609,62290633,25,115,15,155
"13040","chr2",63059974,63060005,32,146,38,216
"13041","chr2",63709058,63709083,26,63,40,129
"13042","chr2",63720418,63720450,33,56,123,212
"13043","chr2",63841994,63842019,26,9,51,86
"13044","chr2",63983445,63983462,18,10,136,164
"13045","chr2",64017022,64017044,23,82,32,137
"13046","chr2",64018748,64018765,18,115,52,185
"13047","chr2",64068511,64068528,18,4,77,99
"13048","chr2",64453200,64453224,25,79,69,173
"13049","chr2",64454248,64454271,24,1,50,75
"13050","chr2",64454459,64454476,18,92,84,194
"13051","chr2",64701806,64701836,31,7,97,135
"13052","chr2",64872594,64872612,19,105,107,231
"13053","chr2",64872733,64872763,31,99,75,205
"13054","chr2",64988911,64988955,45,3,47,95
"13055","chr2",65032934,65032956,23,122,82,227
"13056","chr2",65032964,65032982,19,148,52,219
"13057","chr2",65039343,65039361,19,129,54,202
"13058","chr2",65112082,65112111,30,22,7,59
"13059","chr2",65152738,65152759,22,81,74,177
"13060","chr2",65402279,65402305,27,74,74,175
"13061","chr2",65578309,65578326,18,42,74,134
"13062","chr2",65578343,65578360,18,76,40,134
"13063","chr2",66019161,66019186,26,95,94,215
"13064","chr2",66434185,66434205,21,41,64,126
"13065","chr2",66445797,66445822,26,28,105,159
"13066","chr2",68202793,68202820,28,8,77,113
"13067","chr2",68815444,68815468,25,8,127,160
"13068","chr2",68838587,68838604,18,29,75,122
"13069","chr2",69633033,69633059,27,67,6,100
"13070","chr2",69643086,69643109,24,90,50,164
"13071","chr2",69723023,69723042,20,146,21,187
"13072","chr2",69740631,69740701,71,10,132,213
"13073","chr2",69869250,69869268,19,77,73,169
"13074","chr2",69894071,69894094,24,47,13,84
"13075","chr2",69990180,69990198,19,5,107,131
"13076","chr2",69995018,69995039,22,83,103,208
"13077","chr2",70048108,70048131,24,11,75,110
"13078","chr2",70097087,70097104,18,67,6,91
"13079","chr2",70124611,70124641,31,99,25,155
"13080","chr2",70139818,70139861,44,25,5,74
"13081","chr2",70174307,70174344,38,83,7,128
"13082","chr2",70189407,70189433,27,145,5,177
"13083","chr2",70205692,70205766,75,36,20,131
"13084","chr2",70223917,70223935,19,8,104,131
"13085","chr2",70232541,70232574,34,135,5,174
"13086","chr2",70262478,70262497,20,126,137,283
"13087","chr2",70276099,70276122,24,11,7,42
"13088","chr2",70294279,70294307,29,144,117,290
"13089","chr2",70321021,70321039,19,74,73,166
"13090","chr2",70446228,70446254,27,118,74,219
"13091","chr2",70458996,70459015,20,137,46,203
"13092","chr2",70761608,70761625,18,12,6,36
"13093","chr2",70767507,70767534,28,63,28,119
"13094","chr2",70770620,70770712,93,147,102,342
"13095","chr2",70790700,70790723,24,2,73,99
"13096","chr2",70805729,70805746,18,36,22,76
"13097","chr2",70994826,70994851,26,52,105,183
"13098","chr2",71173821,71173859,39,84,5,128
"13099","chr2",71315935,71315967,33,96,8,137
"13100","chr2",71352478,71352510,33,106,6,145
"13101","chr2",71482346,71482367,22,41,114,177
"13102","chr2",72144521,72144550,30,37,119,186
"13103","chr2",72148640,72148680,41,61,92,194
"13104","chr2",72149076,72149122,47,86,93,226
"13105","chr2",72149253,72149295,43,20,18,81
"13106","chr2",72234084,72234104,21,75,56,152
"13107","chr2",72765675,72765697,23,6,72,101
"13108","chr2",72827023,72827042,20,77,75,172
"13109","chr2",72838648,72838667,20,77,81,178
"13110","chr2",72917442,72917462,21,38,104,163
"13111","chr2",72919181,72919218,38,129,16,183
"13112","chr2",73112975,73113006,32,79,17,128
"13113","chr2",73195305,73195322,18,8,51,77
"13114","chr2",73204099,73204119,21,68,6,95
"13115","chr2",73204871,73204899,29,77,76,182
"13116","chr2",73269452,73269481,30,60,40,130
"13117","chr2",73284383,73284425,43,1,145,189
"13118","chr2",73906452,73906492,41,39,73,153
"13119","chr2",73946055,73946072,18,148,80,246
"13120","chr2",73985062,73985104,43,4,87,134
"13121","chr2",74003173,74003206,34,130,1,165
"13122","chr2",74025224,74025241,18,11,6,35
"13123","chr2",74129317,74129347,31,144,73,248
"13124","chr2",74176084,74176124,41,75,33,149
"13125","chr2",74194443,74194467,25,114,75,214
"13126","chr2",74269370,74269409,40,32,146,218
"13127","chr2",74270672,74270696,25,96,75,196
"13128","chr2",74402986,74403016,31,101,71,203
"13129","chr2",74403182,74403204,23,67,34,124
"13130","chr2",74465376,74465400,25,41,73,139
"13131","chr2",74654558,74654580,23,69,4,96
"13132","chr2",74774201,74774230,30,130,2,162
"13133","chr2",74807564,74807586,23,80,6,109
"13134","chr2",74838538,74838556,19,8,52,79
"13135","chr2",74840712,74840729,18,77,27,122
"13136","chr2",74923259,74923283,25,75,101,201
"13137","chr2",75156435,75156453,19,145,52,216
"13138","chr2",75306778,75306803,26,66,69,161
"13139","chr2",76533709,76533727,19,143,77,239
"13140","chr2",77130825,77130852,28,8,131,167
"13141","chr2",77243411,77243444,34,69,5,108
"13142","chr2",77411371,77411454,84,60,138,282
"13143","chr2",77411452,77411470,19,8,57,84
"13144","chr2",77411619,77411643,25,29,76,130
"13145","chr2",77660398,77660415,18,145,90,253
"13146","chr2",78116606,78116623,18,28,75,121
"13147","chr2",78860315,78860340,26,75,80,181
"13148","chr2",78991330,78991361,32,75,78,185
"13149","chr2",79311409,79311430,22,16,7,45
"13150","chr2",79345860,79345878,19,34,143,196
"13151","chr2",80304611,80304639,29,107,70,206
"13152","chr2",81628975,81628999,25,56,72,153
"13153","chr2",83309625,83309646,22,7,112,141
"13154","chr2",83472957,83472983,27,95,141,263
"13155","chr2",83474051,83474071,21,77,111,209
"13156","chr2",84897310,84897327,18,97,114,229
"13157","chr2",84907957,84907979,23,8,61,92
"13158","chr2",84957559,84957580,22,29,143,194
"13159","chr2",84970831,84970855,25,18,4,47
"13160","chr2",84971031,84971066,36,23,78,137
"13161","chr2",84971261,84971303,43,36,39,118
"13162","chr2",84984826,84984848,23,19,68,110
"13163","chr2",85004826,85004850,25,73,52,150
"13164","chr2",85060428,85060467,40,74,25,139
"13165","chr2",85107236,85107280,45,78,52,175
"13166","chr2",85110074,85110103,30,76,14,120
"13167","chr2",85129276,85129297,22,8,116,146
"13168","chr2",85133613,85133640,28,29,21,78
"13169","chr2",85133696,85133744,49,133,69,251
"13170","chr2",85291549,85291595,47,41,94,182
"13171","chr2",85294027,85294054,28,8,31,67
"13172","chr2",85306644,85306676,33,69,6,108
"13173","chr2",85372890,85372909,20,84,74,178
"13174","chr2",85392390,85392407,18,75,6,99
"13175","chr2",85412517,85412541,25,80,2,107
"13176","chr2",85432386,85432417,32,7,104,143
"13177","chr2",85435012,85435041,30,30,74,134
"13178","chr2",85441491,85441512,22,77,44,143
"13179","chr2",85532792,85532811,20,66,30,116
"13180","chr2",85563491,85563512,22,14,6,42
"13181","chr2",85580660,85580684,25,8,97,130
"13182","chr2",85584389,85584406,18,44,41,103
"13183","chr2",85603568,85603609,42,7,56,105
"13184","chr2",85616281,85616307,27,75,54,156
"13185","chr2",85616672,85616695,24,75,31,130
"13186","chr2",85666420,85666446,27,115,106,248
"13187","chr2",85754393,85754419,27,102,44,173
"13188","chr2",85754557,85754575,19,13,6,38
"13189","chr2",85776754,85776773,20,71,5,96
"13190","chr2",85982355,85982374,20,77,13,110
"13191","chr2",86157789,86157817,29,66,118,213
"13192","chr2",86161098,86161115,18,13,74,105
"13193","chr2",86178318,86178343,26,12,74,112
"13194","chr2",86226076,86226140,65,68,103,236
"13195","chr2",86226139,86226166,28,94,40,162
"13196","chr2",86245765,86245782,18,8,95,121
"13197","chr2",86337684,86337701,18,16,2,36
"13198","chr2",86406602,86406629,28,69,67,164
"13199","chr2",86568086,86568130,45,17,124,186
"13200","chr2",86624800,86624852,53,99,3,155
"13201","chr2",86687837,86687862,26,76,142,244
"13202","chr2",86809133,86809162,30,138,22,190
"13203","chr2",86833622,86833642,21,10,2,33
"13204","chr2",86913996,86914017,22,38,137,197
"13205","chr2",86971202,86971221,20,25,75,120
"13206","chr2",87222488,87222883,396,76,69,541
"13207","chr2",87353667,87353693,27,75,12,114
"13208","chr2",87354781,87354826,46,72,78,196
"13209","chr2",87401538,87401559,22,21,40,83
"13210","chr2",87403653,87403676,24,24,72,120
"13211","chr2",87472965,87472984,20,142,46,208
"13212","chr2",87497594,87497613,20,59,111,190
"13213","chr2",87798700,87798718,19,77,23,119
"13214","chr2",87825494,87825545,52,79,54,185
"13215","chr2",88091866,88091889,24,10,4,38
"13216","chr2",88349295,88349321,27,103,75,205
"13217","chr2",88352070,88352087,18,8,11,37
"13218","chr2",88426829,88426853,25,63,76,164
"13219","chr2",88429501,88429531,31,76,145,252
"13220","chr2",88452165,88452198,34,69,142,245
"13221","chr2",88452315,88452339,25,35,73,133
"13222","chr2",88467600,88467617,18,77,40,135
"13223","chr2",88625285,88625337,53,121,6,180
"13224","chr2",88627212,88627236,25,133,33,191
"13225","chr2",89921583,89921600,18,46,14,78
"13226","chr2",90249887,90249913,27,75,12,114
"13227","chr2",90299095,90299119,25,130,104,259
"13228","chr2",90300781,90300799,19,75,130,224
"13229","chr2",90324090,90324108,19,50,92,161
"13230","chr2",90324634,90324657,24,75,109,208
"13231","chr2",90324695,90324722,28,2,48,78
"13232","chr2",90325308,90325487,180,24,109,313
"13233","chr2",91478101,91478123,23,84,30,137
"13234","chr2",91497934,91497960,27,106,128,261
"13235","chr2",91565686,91565731,46,80,70,196
"13236","chr2",91566819,91566845,27,14,73,114
"13237","chr2",91571415,91571481,67,2,8,77
"13238","chr2",91648125,91648147,23,83,142,248
"13239","chr2",91748931,91748948,18,58,70,146
"13240","chr2",91749050,91749083,34,30,18,82
"13241","chr2",91809909,91809942,34,134,51,219
"13242","chr2",91975129,91975155,27,119,6,152
"13243","chr2",92042830,92042863,34,53,132,219
"13244","chr2",94214136,94214168,33,59,101,193
"13245","chr2",94243569,94243591,23,27,44,94
"13246","chr2",95027700,95027730,31,77,143,251
"13247","chr2",95162263,95162280,18,127,74,219
"13248","chr2",95313916,95313998,83,52,5,140
"13249","chr2",95346592,95346615,24,7,1,32
"13250","chr2",95346727,95346744,18,31,7,56
"13251","chr2",96010713,96010730,18,65,57,140
"13252","chr2",96115227,96115255,29,59,72,160
"13253","chr2",96177322,96177346,25,129,74,228
"13254","chr2",96182836,96182854,19,134,73,226
"13255","chr2",96226423,96226441,19,73,107,199
"13256","chr2",96229680,96229710,31,83,146,260
"13257","chr2",96355623,96355659,37,76,99,212
"13258","chr2",96644480,96644502,23,33,76,132
"13259","chr2",96644492,96644516,25,47,64,136
"13260","chr2",96674222,96674241,20,77,61,158
"13261","chr2",96760849,96760871,23,15,111,149
"13262","chr2",96790004,96790026,23,10,96,129
"13263","chr2",96804227,96804247,21,76,117,214
"13264","chr2",96817011,96817034,24,59,67,150
"13265","chr2",96841599,96841625,27,25,6,58
"13266","chr2",96845134,96845153,20,51,128,199
"13267","chr2",96856469,96856487,19,63,11,93
"13268","chr2",96858453,96858476,24,10,34,68
"13269","chr2",96909143,96909179,37,22,6,65
"13270","chr2",96932942,96932963,22,15,4,41
"13271","chr2",96935163,96935195,33,73,54,160
"13272","chr2",96977195,96977217,23,59,74,156
"13273","chr2",96987179,96987228,50,148,2,200
"13274","chr2",96988834,96988852,19,121,6,146
"13275","chr2",97094703,97094720,18,59,63,140
"13276","chr2",97676434,97676466,33,137,74,244
"13277","chr2",97694416,97694433,18,29,143,190
"13278","chr2",97749005,97749027,23,8,45,76
"13279","chr2",98215440,98215471,32,12,75,119
"13280","chr2",98255183,98255211,29,35,141,205
"13281","chr2",98383885,98383902,18,6,29,53
"13282","chr2",98392564,98392611,48,140,71,259
"13283","chr2",98448047,98448069,23,143,6,172
"13284","chr2",98731097,98731164,68,93,2,163
"13285","chr2",98731172,98731211,40,7,59,106
"13286","chr2",98770701,98770746,46,141,33,220
"13287","chr2",98770900,98770918,19,115,6,140
"13288","chr2",99315063,99315080,18,8,75,101
"13289","chr2",99344405,99344436,32,27,92,151
"13290","chr2",99585726,99585747,22,77,125,224
"13291","chr2",99601537,99601571,35,80,122,237
"13292","chr2",100024232,100024256,25,111,6,142
"13293","chr2",100083100,100083126,27,13,54,94
"13294","chr2",100104799,100104824,26,114,7,147
"13295","chr2",100549789,100549806,18,77,74,169
"13296","chr2",100597782,100597817,36,74,138,248
"13297","chr2",100657163,100657186,24,130,73,227
"13298","chr2",100760688,100760709,22,28,75,125
"13299","chr2",100820028,100820106,79,25,48,152
"13300","chr2",100820247,100820269,23,19,35,77
"13301","chr2",100869901,100869922,22,76,56,154
"13302","chr2",100892708,100892735,28,8,114,150
"13303","chr2",100971299,100971318,20,11,124,155
"13304","chr2",101003312,101003331,20,60,18,98
"13305","chr2",101079681,101079703,23,76,4,103
"13306","chr2",101118697,101118714,18,49,74,141
"13307","chr2",101151444,101151487,44,47,4,95
"13308","chr2",101200161,101200178,18,8,129,155
"13309","chr2",101221474,101221513,40,7,145,192
"13310","chr2",101275432,101275459,28,8,130,166
"13311","chr2",101363852,101363896,45,8,4,57
"13312","chr2",101504656,101504674,19,1,50,70
"13313","chr2",101643880,101643907,28,76,4,108
"13314","chr2",101697656,101697675,20,17,29,66
"13315","chr2",102448961,102448984,24,145,75,244
"13316","chr2",103269679,103269701,23,125,74,222
"13317","chr2",103416288,103416311,24,5,33,62
"13318","chr2",104748720,104748753,34,83,5,122
"13319","chr2",104811976,104811995,20,129,34,183
"13320","chr2",104853225,104853271,47,25,98,170
"13321","chr2",104855201,104855228,28,7,35,70
"13322","chr2",104855294,104855487,194,74,96,364
"13323","chr2",104855598,104855660,63,1,94,158
"13324","chr2",104855819,104855856,38,38,31,107
"13325","chr2",104856078,104856121,44,42,41,127
"13326","chr2",104856230,104856249,20,120,60,200
"13327","chr2",104857037,104857132,96,130,24,250
"13328","chr2",105144024,105144060,37,19,6,62
"13329","chr2",105261767,105261791,25,8,59,92
"13330","chr2",105360302,105360319,18,21,5,44
"13331","chr2",105744866,105744901,36,30,45,111
"13332","chr2",105861904,105861936,33,40,56,129
"13333","chr2",106143409,106143438,30,10,74,114
"13334","chr2",106194302,106194324,23,31,93,147
"13335","chr2",106262429,106262484,56,76,27,159
"13336","chr2",106265618,106265654,37,100,77,214
"13337","chr2",106265830,106265852,23,9,25,57
"13338","chr2",106580544,106580577,34,21,24,79
"13339","chr2",106629066,106629092,27,69,53,149
"13340","chr2",107310222,107310268,47,59,6,112
"13341","chr2",107805599,107805618,20,8,133,161
"13342","chr2",108272029,108272054,26,131,134,291
"13343","chr2",108384205,108384244,40,4,3,47
"13344","chr2",108466465,108466487,23,73,21,117
"13345","chr2",108534653,108534695,43,46,15,104
"13346","chr2",108721046,108721068,23,145,9,177
"13347","chr2",108748375,108748394,20,25,25,70
"13348","chr2",108752618,108752643,26,145,26,197
"13349","chr2",108913950,108913967,18,136,6,160
"13350","chr2",108990438,108990458,21,135,67,223
"13351","chr2",108994795,108994829,35,58,35,128
"13352","chr2",109041686,109041711,26,26,146,198
"13353","chr2",109047497,109047523,27,144,115,286
"13354","chr2",109249832,109249866,35,38,135,208
"13355","chr2",109301276,109301306,31,18,114,163
"13356","chr2",109301336,109301373,38,85,54,177
"13357","chr2",109370191,109370238,48,57,77,182
"13358","chr2",109644121,109644149,29,100,6,135
"13359","chr2",109664605,109664627,23,127,18,168
"13360","chr2",109760672,109760700,29,65,2,96
"13361","chr2",109782105,109782130,26,56,10,92
"13362","chr2",109794585,109794629,45,79,141,265
"13363","chr2",110589360,110589385,26,12,54,92
"13364","chr2",110610786,110610823,38,4,63,105
"13365","chr2",110767924,110767980,57,75,33,165
"13366","chr2",110955934,110955956,23,11,65,99
"13367","chr2",111453223,111453245,23,111,57,191
"13368","chr2",111477237,111477256,20,48,140,208
"13369","chr2",111929754,111929772,19,80,106,205
"13370","chr2",111943537,111943557,21,128,4,153
"13371","chr2",112065644,112065666,23,74,57,154
"13372","chr2",112170243,112170265,23,33,73,129
"13373","chr2",112170268,112170295,28,63,48,139
"13374","chr2",112255261,112255301,41,76,49,166
"13375","chr2",112448395,112448417,23,77,74,174
"13376","chr2",112563049,112563072,24,8,125,157
"13377","chr2",112573838,112573864,27,76,101,204
"13378","chr2",112620624,112620641,18,77,140,235
"13379","chr2",112674287,112674308,22,84,2,108
"13380","chr2",112884457,112884483,27,41,135,203
"13381","chr2",113467064,113467090,27,149,74,250
"13382","chr2",113541267,113541296,30,135,33,198
"13383","chr2",113603743,113603802,60,44,84,188
"13384","chr2",113886111,113886128,18,145,27,190
"13385","chr2",114614125,114614148,24,75,120,219
"13386","chr2",114801263,114801287,25,44,6,75
"13387","chr2",114965965,114966003,39,46,7,92
"13388","chr2",116026435,116026463,29,76,131,236
"13389","chr2",116026463,116026487,25,100,103,228
"13390","chr2",116598086,116598117,32,8,107,147
"13391","chr2",117236097,117236121,25,38,5,68
"13392","chr2",118014107,118014133,27,71,18,116
"13393","chr2",118148677,118148710,34,14,74,122
"13394","chr2",118179335,118179356,22,20,73,115
"13395","chr2",118472225,118472244,20,76,75,171
"13396","chr2",118561553,118561586,34,50,33,117
"13397","chr2",118633489,118633522,34,52,62,148
"13398","chr2",118717445,118717464,20,78,86,184
"13399","chr2",118809311,118809343,33,128,9,170
"13400","chr2",118846524,118846575,52,43,50,145
"13401","chr2",118847038,118847055,18,6,133,157
"13402","chr2",118847727,118847757,31,20,143,194
"13403","chr2",118852613,118852636,24,8,74,106
"13404","chr2",119224346,119224384,39,8,5,52
"13405","chr2",119678514,119678543,30,5,36,71
"13406","chr2",119678566,119678585,20,47,93,160
"13407","chr2",119678608,119678631,24,93,51,168
"13408","chr2",119678652,119678672,21,134,7,162
"13409","chr2",119692970,119692997,28,66,9,103
"13410","chr2",119709825,119709851,27,25,6,58
"13411","chr2",120061217,120061240,24,8,66,98
"13412","chr2",120220735,120220780,46,43,68,157
"13413","chr2",120344155,120344177,23,103,100,226
"13414","chr2",120344730,120344754,25,25,19,69
"13415","chr2",120346068,120346102,35,8,17,60
"13416","chr2",120347075,120347113,39,37,5,81
"13417","chr2",120402473,120402528,56,14,40,110
"13418","chr2",120648880,120648903,24,145,35,204
"13419","chr2",120895053,120895071,19,145,89,253
"13420","chr2",121026175,121026199,25,8,4,37
"13421","chr2",121058074,121058093,20,26,14,60
"13422","chr2",121085280,121085305,26,76,136,238
"13423","chr2",121191138,121191167,30,83,2,115
"13424","chr2",121205307,121205325,19,67,22,108
"13425","chr2",121236714,121236732,19,77,146,242
"13426","chr2",121262467,121262495,29,47,4,80
"13427","chr2",121629394,121629427,34,47,70,151
"13428","chr2",121649464,121649493,30,75,47,152
"13429","chr2",121736955,121736977,23,103,25,151
"13430","chr2",121774955,121774979,25,53,72,150
"13431","chr2",121814719,121814743,25,76,35,136
"13432","chr2",121935065,121935086,22,8,67,97
"13433","chr2",122247371,122247405,35,77,86,198
"13434","chr2",122663904,122663983,80,105,103,288
"13435","chr2",123715939,123715965,27,7,143,177
"13436","chr2",124312543,124312586,44,6,64,114
"13437","chr2",124423653,124423682,30,8,138,176
"13438","chr2",124485613,124485634,22,95,74,191
"13439","chr2",124578157,124578180,24,145,24,193
"13440","chr2",125312949,125312991,43,63,6,112
"13441","chr2",125335182,125335211,30,125,76,231
"13442","chr2",125775931,125775955,25,73,38,136
"13443","chr2",125811384,125811406,23,45,44,112
"13444","chr2",125811416,125811438,23,77,12,112
"13445","chr2",125920929,125920953,25,36,74,135
"13446","chr2",126306007,126306029,23,111,13,147
"13447","chr2",126656201,126656227,27,131,50,208
"13448","chr2",126776695,126776753,59,28,5,92
"13449","chr2",127107110,127107141,32,38,2,72
"13450","chr2",127384049,127384067,19,28,67,114
"13451","chr2",127387399,127387422,24,121,114,259
"13452","chr2",127430466,127430495,30,76,141,247
"13453","chr2",127446305,127446340,36,6,63,105
"13454","chr2",127518515,127518536,22,11,123,156
"13455","chr2",127518563,127518582,20,57,75,152
"13456","chr2",127782000,127782022,23,45,72,140
"13457","chr2",127839670,127839688,19,75,9,103
"13458","chr2",127851217,127851261,45,137,73,255
"13459","chr2",127859467,127859487,21,148,67,236
"13460","chr2",127885989,127886016,28,67,95,190
"13461","chr2",127886621,127886641,21,25,7,53
"13462","chr2",127916491,127916509,19,5,3,27
"13463","chr2",127920686,127920712,27,72,35,134
"13464","chr2",127977336,127977353,18,111,26,155
"13465","chr2",128027623,128027646,24,29,29,82
"13466","chr2",128066488,128066507,20,13,6,39
"13467","chr2",128066790,128066812,23,65,5,93
"13468","chr2",128070726,128070744,19,75,49,143
"13469","chr2",128169049,128169091,43,14,71,128
"13470","chr2",128318870,128318920,51,70,18,139
"13471","chr2",128527696,128527736,41,3,66,110
"13472","chr2",128624491,128624595,105,88,29,222
"13473","chr2",128752268,128752293,26,44,52,122
"13474","chr2",128784545,128784576,32,131,76,239
"13475","chr2",129370135,129370160,26,139,19,184
"13476","chr2",129391935,129391960,26,9,40,75
"13477","chr2",129760610,129760627,18,136,74,228
"13478","chr2",129799374,129799420,47,49,16,112
"13479","chr2",129867246,129867281,36,6,136,178
"13480","chr2",129948494,129948511,18,15,21,54
"13481","chr2",129955530,129955559,30,8,7,45
"13482","chr2",130022769,130022801,33,100,8,141
"13483","chr2",130042662,130042706,45,73,74,192
"13484","chr2",130121114,130121147,34,46,78,158
"13485","chr2",130145451,130145491,41,13,10,64
"13486","chr2",130350022,130350052,31,75,29,135
"13487","chr2",130372356,130372380,25,91,32,148
"13488","chr2",130428031,130428080,50,6,42,98
"13489","chr2",130433466,130433507,42,73,74,189
"13490","chr2",130551614,130551641,28,101,71,200
"13491","chr2",130569103,130569130,28,73,99,200
"13492","chr2",130577316,130577342,27,45,6,78
"13493","chr2",130586129,130586150,22,8,17,47
"13494","chr2",130688007,130688048,42,76,71,189
"13495","chr2",130693435,130693469,35,44,4,83
"13496","chr2",130749371,130749393,23,77,40,140
"13497","chr2",130775935,130775958,24,27,74,125
"13498","chr2",130775985,130776007,23,8,24,55
"13499","chr2",130838625,130838676,52,49,55,156
"13500","chr2",131034875,131034897,23,13,57,93
"13501","chr2",131093558,131093577,20,120,40,180
"13502","chr2",131098618,131098640,23,122,44,189
"13503","chr2",131171102,131171124,23,4,93,120
"13504","chr2",131217971,131218012,42,1,38,81
"13505","chr2",131294696,131294737,42,76,71,189
"13506","chr2",131300122,131300157,36,48,4,88
"13507","chr2",131425328,131425353,26,2,97,125
"13508","chr2",131474406,131474427,22,76,2,100
"13509","chr2",131481436,131481453,18,76,143,237
"13510","chr2",131506764,131506782,19,89,4,112
"13511","chr2",131528813,131528830,18,16,72,106
"13512","chr2",131755772,131755812,41,78,38,157
"13513","chr2",132274042,132274060,19,25,70,114
"13514","chr2",132818515,132818538,24,77,32,133
"13515","chr2",133270913,133270937,25,8,12,45
"13516","chr2",133271087,133271104,18,28,75,121
"13517","chr2",133663273,133663292,20,147,67,234
"13518","chr2",133694434,133694462,29,49,5,83
"13519","chr2",134120720,134120737,18,1,126,145
"13520","chr2",134554423,134554448,26,127,9,162
"13521","chr2",134632910,134632931,22,114,75,211
"13522","chr2",134918482,134918522,41,129,124,294
"13523","chr2",134928275,134928293,19,5,131,155
"13524","chr2",134960361,134960407,47,37,119,203
"13525","chr2",134991303,134991339,37,149,4,190
"13526","chr2",135127330,135127360,31,44,25,100
"13527","chr2",135196373,135196403,31,5,30,66
"13528","chr2",135455582,135455609,28,121,51,200
"13529","chr2",135538923,135538948,26,36,1,63
"13530","chr2",135837614,135837635,22,35,35,92
"13531","chr2",135878319,135878345,27,30,140,197
"13532","chr2",135999277,135999294,18,75,90,183
"13533","chr2",136302565,136302587,23,10,50,83
"13534","chr2",136367051,136367071,21,87,102,210
"13535","chr2",136765482,136765542,61,123,29,213
"13536","chr2",136855592,136855640,49,24,144,217
"13537","chr2",137290106,137290130,25,31,90,146
"13538","chr2",137508544,137508570,27,56,75,158
"13539","chr2",137662230,137662257,28,30,143,201
"13540","chr2",138088205,138088225,21,53,48,122
"13541","chr2",138173945,138173964,20,145,39,204
"13542","chr2",138456325,138456348,24,73,99,196
"13543","chr2",138501746,138501765,20,5,16,41
"13544","chr2",138505595,138505622,28,114,120,262
"13545","chr2",138958580,138958601,22,34,143,199
"13546","chr2",139072908,139072943,36,148,138,322
"13547","chr2",139539840,139539861,22,48,74,144
"13548","chr2",140031644,140031661,18,37,72,127
"13549","chr2",140081044,140081064,21,77,35,133
"13550","chr2",140640379,140640413,35,8,56,99
"13551","chr2",140828609,140828631,23,68,6,97
"13552","chr2",141330748,141330770,23,9,73,105
"13553","chr2",141464585,141464607,23,80,70,173
"13554","chr2",141998314,141998332,19,18,5,42
"13555","chr2",142740028,142740045,18,55,45,118
"13556","chr2",143561497,143561527,31,70,36,137
"13557","chr2",144332363,144332381,19,39,27,85
"13558","chr2",144332438,144332458,21,33,74,128
"13559","chr2",144517172,144517190,19,22,10,51
"13560","chr2",145490456,145490488,33,8,24,65
"13561","chr2",146457829,146457854,26,115,6,147
"13562","chr2",147305452,147305480,29,102,61,192
"13563","chr2",147844401,147844440,40,42,125,207
"13564","chr2",147844582,147844659,78,63,46,187
"13565","chr2",148074485,148074518,34,74,119,227
"13566","chr2",148294502,148294521,20,77,33,130
"13567","chr2",148644643,148644680,38,2,41,81
"13568","chr2",148799641,148799659,19,8,100,127
"13569","chr2",148821786,148821808,23,74,138,235
"13570","chr2",149100417,149100441,25,147,24,196
"13571","chr2",150996531,150996549,19,6,20,45
"13572","chr2",151335274,151335303,30,13,75,118
"13573","chr2",152050768,152050785,18,69,67,154
"13574","chr2",152098746,152098793,48,83,89,220
"13575","chr2",152103262,152103281,20,37,6,63
"13576","chr2",152105156,152105181,26,124,74,224
"13577","chr2",152136089,152136108,20,95,75,190
"13578","chr2",152141139,152141169,31,62,6,99
"13579","chr2",152237126,152237153,28,77,77,182
"13580","chr2",152237638,152237663,26,76,79,181
"13581","chr2",152336089,152336123,35,54,7,96
"13582","chr2",152668148,152668165,18,26,144,188
"13583","chr2",152941240,152941330,91,15,83,189
"13584","chr2",153850006,153850029,24,108,27,159
"13585","chr2",154168674,154168693,20,77,32,129
"13586","chr2",154766524,154766556,33,59,77,169
"13587","chr2",155331601,155331649,49,78,75,202
"13588","chr2",156419050,156419076,27,7,87,121
"13589","chr2",156492445,156492468,24,24,19,67
"13590","chr2",157875869,157875902,34,19,41,94
"13591","chr2",157876344,157876370,27,1,46,74
"13592","chr2",158210788,158210809,22,145,27,194
"13593","chr2",158700217,158700243,27,125,15,167
"13594","chr2",158783488,158783508,21,76,1,98
"13595","chr2",158860773,158860796,24,103,7,134
"13596","chr2",158988326,158988349,24,70,5,99
"13597","chr2",159146537,159146557,21,75,61,157
"13598","chr2",159519671,159519690,20,76,4,100
"13599","chr2",159776013,159776030,18,33,116,167
"13600","chr2",159862292,159862309,18,145,74,237
"13601","chr2",160062036,160062062,27,133,98,258
"13602","chr2",160407537,160407578,42,54,62,158
"13603","chr2",160410222,160410247,26,29,6,61
"13604","chr2",160484497,160484515,19,29,4,52
"13605","chr2",160493522,160493593,72,16,73,161
"13606","chr2",160969947,160969970,24,129,67,220
"13607","chr2",161418726,161418748,23,14,101,138
"13608","chr2",161455042,161455108,67,34,71,172
"13609","chr2",161464658,161464698,41,6,46,93
"13610","chr2",161507922,161507947,26,8,52,86
"13611","chr2",162161977,162161997,21,7,42,70
"13612","chr2",162839063,162839118,56,17,70,143
"13613","chr2",163736336,163736362,27,84,98,209
"13614","chr2",164046456,164046501,46,3,40,89
"13615","chr2",164046657,164046687,31,32,142,205
"13616","chr2",164165081,164165105,25,29,75,129
"13617","chr2",164327705,164327726,22,8,79,109
"13618","chr2",164621492,164621534,43,1,49,93
"13619","chr2",164891059,164891076,18,72,66,156
"13620","chr2",165477467,165477520,54,78,23,155
"13621","chr2",167545024,167545054,31,10,123,164
"13622","chr2",168247062,168247089,28,39,33,100
"13623","chr2",168247287,168247314,28,86,41,155
"13624","chr2",168247545,168247571,27,89,71,187
"13625","chr2",168456299,168456349,51,119,122,292
"13626","chr2",169490188,169490210,23,7,104,134
"13627","chr2",169722210,169722235,26,6,130,162
"13628","chr2",169734139,169734191,53,16,30,99
"13629","chr2",169864907,169864929,23,70,124,217
"13630","chr2",169888078,169888095,18,15,143,176
"13631","chr2",169888110,169888156,47,76,111,234
"13632","chr2",170005224,170005241,18,146,6,170
"13633","chr2",170024354,170024375,22,115,74,211
"13634","chr2",170220259,170220285,27,84,73,184
"13635","chr2",170399243,170399266,24,19,5,48
"13636","chr2",170669634,170669668,35,5,15,55
"13637","chr2",170688726,170688749,24,111,74,209
"13638","chr2",170735602,170735624,23,8,1,32
"13639","chr2",170751844,170751867,24,105,50,179
"13640","chr2",170770830,170770875,46,63,55,164
"13641","chr2",170770969,170771007,39,27,31,97
"13642","chr2",170791691,170791736,46,95,5,146
"13643","chr2",170818222,170818246,25,63,35,123
"13644","chr2",170820167,170820184,18,57,26,101
"13645","chr2",170823640,170823670,31,55,29,115
"13646","chr2",170946769,170946788,20,75,34,129
"13647","chr2",171160967,171161003,37,7,10,54
"13648","chr2",171270889,171270958,70,18,88,176
"13649","chr2",171525948,171525972,25,135,23,183
"13650","chr2",171850338,171850363,26,8,88,122
"13651","chr2",171851493,171851510,18,92,8,118
"13652","chr2",171896763,171896780,18,147,70,235
"13653","chr2",171912573,171912604,32,73,127,232
"13654","chr2",172102401,172102419,19,137,69,225
"13655","chr2",172126907,172126924,18,8,26,52
"13656","chr2",172445653,172445677,25,101,2,128
"13657","chr2",173076183,173076211,29,8,67,104
"13658","chr2",173144148,173144178,31,10,87,128
"13659","chr2",173225594,173225618,25,145,74,244
"13660","chr2",173417337,173417360,24,147,5,176
"13661","chr2",173544450,173544468,19,7,56,82
"13662","chr2",173550881,173550901,21,16,74,111
"13663","chr2",173861219,173861237,19,64,26,109
"13664","chr2",173964014,173964039,26,30,128,184
"13665","chr2",173964279,173964304,26,71,18,115
"13666","chr2",173964474,173964502,29,4,55,88
"13667","chr2",173964754,173964790,37,8,45,90
"13668","chr2",174028553,174028576,24,10,137,171
"13669","chr2",174114173,174114193,21,78,27,126
"13670","chr2",174218989,174219006,18,123,143,284
"13671","chr2",174328202,174328237,36,91,65,192
"13672","chr2",174331237,174331270,34,107,45,186
"13673","chr2",174337447,174337494,48,100,132,280
"13674","chr2",174514675,174514693,19,19,5,43
"13675","chr2",174891141,174891178,38,36,6,80
"13676","chr2",175005264,175005282,19,7,7,33
"13677","chr2",175038532,175038569,38,76,55,169
"13678","chr2",175141487,175141510,24,8,43,75
"13679","chr2",175814285,175814326,42,131,42,215
"13680","chr2",176080253,176080301,49,43,37,129
"13681","chr2",176084663,176084756,94,5,91,190
"13682","chr2",176092853,176092891,39,2,36,77
"13683","chr2",176093058,176093099,42,1,39,82
"13684","chr2",176107677,176107714,38,2,107,147
"13685","chr2",176108660,176108698,39,11,64,114
"13686","chr2",176115132,176115174,43,138,63,244
"13687","chr2",176130408,176130436,29,1,84,114
"13688","chr2",176157699,176157721,23,43,13,79
"13689","chr2",176217771,176217791,21,14,73,108
"13690","chr2",176444686,176444718,33,91,45,169
"13691","chr2",176633405,176633433,29,8,57,94
"13692","chr2",176638188,176638216,29,57,49,135
"13693","chr2",176638988,176639014,27,37,73,137
"13694","chr2",176977864,176977900,37,23,72,132
"13695","chr2",177016714,177016740,27,19,99,145
"13696","chr2",177197949,177197983,35,99,6,140
"13697","chr2",177210521,177210544,24,8,2,34
"13698","chr2",177249218,177249249,32,134,36,202
"13699","chr2",177264663,177264698,36,1,37,74
"13700","chr2",177392858,177392887,30,101,14,145
"13701","chr2",177916928,177916949,22,29,74,125
"13702","chr2",178016132,178016155,24,28,75,127
"13703","chr2",179264835,179264853,19,99,2,120
"13704","chr2",179537304,179537348,45,38,12,95
"13705","chr2",179861243,179861285,43,19,53,115
"13706","chr2",179861434,179861452,19,113,19,151
"13707","chr2",180432400,180432419,20,8,53,81
"13708","chr2",180910272,180910293,22,77,27,126
"13709","chr2",180981013,180981050,38,65,95,198
"13710","chr2",181700528,181700561,34,8,44,86
"13711","chr2",181891920,181891942,23,20,18,61
"13712","chr2",181892207,181892240,34,91,16,141
"13713","chr2",182121657,182121675,19,29,73,121
"13714","chr2",182532946,182532973,28,41,74,143
"13715","chr2",182635948,182635973,26,8,145,179
"13716","chr2",182649608,182649626,19,7,33,59
"13717","chr2",182671616,182671638,23,9,17,49
"13718","chr2",182679351,182679372,22,28,75,125
"13719","chr2",182716097,182716117,21,1,89,111
"13720","chr2",183038418,183038442,25,62,47,134
"13721","chr2",183038584,183038602,19,4,13,36
"13722","chr2",183257950,183257986,37,70,5,112
"13723","chr2",183376887,183376923,37,7,8,52
"13724","chr2",183711934,183711961,28,6,103,137
"13725","chr2",184069601,184069631,31,146,35,212
"13726","chr2",184321653,184321670,18,145,27,190
"13727","chr2",184695466,184695492,27,17,1,45
"13728","chr2",185365702,185365733,32,46,70,148
"13729","chr2",185400019,185400048,30,146,75,251
"13730","chr2",186255902,186255925,24,93,7,124
"13731","chr2",186467668,186467694,27,8,111,146
"13732","chr2",186694303,186694322,20,22,36,78
"13733","chr2",186976915,186976935,21,50,43,114
"13734","chr2",187244696,187244735,40,54,3,97
"13735","chr2",187285425,187285442,18,148,70,236
"13736","chr2",188112597,188112618,22,24,5,51
"13737","chr2",188155870,188155888,19,76,40,135
"13738","chr2",188287607,188287625,19,73,30,122
"13739","chr2",189396672,189396691,20,137,8,165
"13740","chr2",189413784,189413809,26,8,2,36
"13741","chr2",189751445,189751462,18,126,50,194
"13742","chr2",189926586,189926604,19,14,145,178
"13743","chr2",190226596,190226623,28,40,5,73
"13744","chr2",190408322,190408348,27,50,16,93
"13745","chr2",190408695,190408715,21,9,33,63
"13746","chr2",190534906,190534936,31,33,39,103
"13747","chr2",190648517,190648538,22,19,51,92
"13748","chr2",190648852,190648869,18,98,20,136
"13749","chr2",190710588,190710610,23,73,65,161
"13750","chr2",190879579,190879598,20,121,38,179
"13751","chr2",190880873,190880920,48,31,129,208
"13752","chr2",191344830,191344851,22,84,6,112
"13753","chr2",191552369,191552391,23,114,48,185
"13754","chr2",191561169,191561187,19,74,33,126
"13755","chr2",191678404,191678435,32,43,88,163
"13756","chr2",191678790,191678815,26,50,22,98
"13757","chr2",191953884,191953907,24,10,36,70
"13758","chr2",192574586,192574687,102,46,39,187
"13759","chr2",192734723,192734747,25,113,27,165
"13760","chr2",192855268,192855324,57,39,77,173
"13761","chr2",192855333,192855361,29,76,12,117
"13762","chr2",193277237,193277307,71,23,82,176
"13763","chr2",194578622,194578646,25,44,104,173
"13764","chr2",195593503,195593592,90,61,46,197
"13765","chr2",195625266,195625292,27,7,25,59
"13766","chr2",196504296,196504314,19,110,74,203
"13767","chr2",196613062,196613083,22,40,143,205
"13768","chr2",196798524,196798551,28,104,74,206
"13769","chr2",196926620,196926649,30,37,9,76
"13770","chr2",196928466,196928484,19,76,77,172
"13771","chr2",196928632,196928656,25,8,77,110
"13772","chr2",197019965,197019996,32,36,74,142
"13773","chr2",197176921,197176941,21,49,23,93
"13774","chr2",197198800,197198824,25,9,67,101
"13775","chr2",197425156,197425178,23,7,74,104
"13776","chr2",197480412,197480441,30,44,125,199
"13777","chr2",197492698,197492721,24,139,80,243
"13778","chr2",197518730,197518771,42,74,143,259
"13779","chr2",197705241,197705268,28,24,67,119
"13780","chr2",197717362,197717410,49,15,70,134
"13781","chr2",197804943,197804977,35,11,79,125
"13782","chr2",197903650,197903676,27,29,76,132
"13783","chr2",198648753,198648779,27,117,4,148
"13784","chr2",198868769,198868796,28,76,110,214
"13785","chr2",199457727,199457745,19,53,146,218
"13786","chr2",199469533,199469555,23,2,28,53
"13787","chr2",199480117,199480141,25,118,6,149
"13788","chr2",200291940,200291977,38,145,27,210
"13789","chr2",200326902,200326926,25,35,143,203
"13790","chr2",200510181,200510206,26,95,11,132
"13791","chr2",200742972,200743013,42,69,47,158
"13792","chr2",200866441,200866459,19,46,7,72
"13793","chr2",200870093,200870112,20,76,2,98
"13794","chr2",200888055,200888074,20,65,8,93
"13795","chr2",201030086,201030103,18,147,26,191
"13796","chr2",201077102,201077124,23,80,4,107
"13797","chr2",201098449,201098467,19,70,7,96
"13798","chr2",201181249,201181268,20,78,128,226
"13799","chr2",201424585,201424621,37,77,7,121
"13800","chr2",201907102,201907131,30,35,109,174
"13801","chr2",202008282,202008320,39,8,59,106
"13802","chr2",202032453,202032482,30,27,93,150
"13803","chr2",202032482,202032506,25,51,64,140
"13804","chr2",202033744,202033791,48,68,114,230
"13805","chr2",202033874,202033904,31,21,3,55
"13806","chr2",202227207,202227226,20,76,7,103
"13807","chr2",202230758,202230780,23,140,28,191
"13808","chr2",202264928,202264963,36,147,47,230
"13809","chr2",202283218,202283247,30,76,1,107
"13810","chr2",202334713,202334960,248,18,74,340
"13811","chr2",202357851,202357880,30,8,11,49
"13812","chr2",202374711,202374751,41,28,7,76
"13813","chr2",202376172,202376200,29,53,46,128
"13814","chr2",202376252,202376286,35,14,28,77
"13815","chr2",202376512,202376547,36,10,14,60
"13816","chr2",202388397,202388420,24,65,74,163
"13817","chr2",202403163,202403210,48,69,41,158
"13818","chr2",202448447,202448482,36,84,10,130
"13819","chr2",202458284,202458308,25,58,71,154
"13820","chr2",202536871,202536890,20,96,75,191
"13821","chr2",202546904,202546954,51,70,107,228
"13822","chr2",202547782,202547801,20,11,75,106
"13823","chr2",202634995,202635017,23,60,29,112
"13824","chr2",202637232,202637272,41,5,110,156
"13825","chr2",202837277,202837303,27,78,10,115
"13826","chr2",202895690,202895709,20,35,75,130
"13827","chr2",202917211,202917236,26,45,6,77
"13828","chr2",202992944,202992964,21,29,6,56
"13829","chr2",203004048,203004070,23,145,44,212
"13830","chr2",203238231,203238270,40,44,53,137
"13831","chr2",203238421,203238448,28,3,76,107
"13832","chr2",203256352,203256371,20,70,62,152
"13833","chr2",203300892,203300913,22,12,3,37
"13834","chr2",203312775,203312793,19,52,76,147
"13835","chr2",203328488,203328507,20,95,98,213
"13836","chr2",203344541,203344569,29,58,135,222
"13837","chr2",203535259,203535300,42,35,32,109
"13838","chr2",203545553,203545575,23,77,22,122
"13839","chr2",203784578,203784596,19,97,74,190
"13840","chr2",204477153,204477175,23,145,27,195
"13841","chr2",204545554,204545572,19,27,23,69
"13842","chr2",204545612,204545655,44,40,9,93
"13843","chr2",204545701,204545732,32,4,34,70
"13844","chr2",205421132,205421159,28,12,83,123
"13845","chr2",205641608,205641628,21,8,50,79
"13846","chr2",205682655,205682679,25,31,27,83
"13847","chr2",206050492,206050524,33,38,74,145
"13848","chr2",206058419,206058442,24,137,6,167
"13849","chr2",206085249,206085267,19,6,21,46
"13850","chr2",206179375,206179396,22,78,84,184
"13851","chr2",206203330,206203354,25,138,4,167
"13852","chr2",206250790,206250835,46,11,26,83
"13853","chr2",206405857,206405886,30,37,143,210
"13854","chr2",207011346,207011365,20,9,18,47
"13855","chr2",207319196,207319213,18,130,74,222
"13856","chr2",207530383,207530416,34,2,107,143
"13857","chr2",207673007,207673026,20,12,7,39
"13858","chr2",207699650,207699688,39,76,75,190
"13859","chr2",207779505,207779549,45,4,145,194
"13860","chr2",207797746,207797765,20,65,74,159
"13861","chr2",207805838,207805870,33,39,118,190
"13862","chr2",207837600,207837617,18,17,34,69
"13863","chr2",207837633,207837651,19,51,1,71
"13864","chr2",207837762,207837788,27,8,139,174
"13865","chr2",207844470,207844487,18,37,75,130
"13866","chr2",207878824,207878857,34,137,54,225
"13867","chr2",207948538,207948561,24,8,60,92
"13868","chr2",207985988,207986005,18,82,6,106
"13869","chr2",208145689,208145711,23,88,74,185
"13870","chr2",208237765,208237783,19,145,27,191
"13871","chr2",208246698,208246717,20,1,114,135
"13872","chr2",208530240,208530273,34,24,56,114
"13873","chr2",209354376,209354406,31,77,50,158
"13874","chr2",209424083,209424106,24,46,94,164
"13875","chr2",209660702,209660749,48,5,1,54
"13876","chr2",209808525,209808543,19,31,112,162
"13877","chr2",210058837,210058855,19,33,6,58
"13878","chr2",210171296,210171342,47,64,47,158
"13879","chr2",210173482,210173499,18,29,75,122
"13880","chr2",210249410,210249454,45,9,78,132
"13881","chr2",211701757,211701784,28,55,7,90
"13882","chr2",211716363,211716394,32,13,73,118
"13883","chr2",211810663,211810683,21,69,2,92
"13884","chr2",212798881,212799028,148,79,69,296
"13885","chr2",213151716,213151758,43,1,48,92
"13886","chr2",214664249,214664268,20,38,7,65
"13887","chr2",214680662,214680682,21,77,67,165
"13888","chr2",215178527,215178546,20,7,82,109
"13889","chr2",215267232,215267268,37,6,7,50
"13890","chr2",215296919,215296956,38,145,74,257
"13891","chr2",215436183,215436200,18,111,26,155
"13892","chr2",215441165,215441191,27,77,35,139
"13893","chr2",215747750,215747776,27,55,18,100
"13894","chr2",215763282,215763305,24,7,69,100
"13895","chr2",215778241,215778265,25,32,75,132
"13896","chr2",216068226,216068248,23,149,75,247
"13897","chr2",216247556,216247573,18,88,75,181
"13898","chr2",216296346,216296363,18,118,74,210
"13899","chr2",216633549,216633590,42,14,1,57
"13900","chr2",216636906,216636928,23,99,1,123
"13901","chr2",216913599,216913619,21,68,6,95
"13902","chr2",217858943,217858985,43,85,111,239
"13903","chr2",217959673,217959690,18,58,65,141
"13904","chr2",218217206,218217223,18,1,98,117
"13905","chr2",218281105,218281151,47,6,17,70
"13906","chr2",218321935,218321952,18,146,134,298
"13907","chr2",218325199,218325222,24,73,145,242
"13908","chr2",218331452,218331489,38,12,29,79
"13909","chr2",218338792,218338810,19,76,2,97
"13910","chr2",218357260,218357290,31,80,18,129
"13911","chr2",218374479,218374518,40,86,74,200
"13912","chr2",218380528,218380552,25,14,75,114
"13913","chr2",218388370,218388396,27,32,72,131
"13914","chr2",218463855,218463874,20,45,125,190
"13915","chr2",218497374,218497408,35,73,7,115
"13916","chr2",218601402,218601420,19,138,18,175
"13917","chr2",218640062,218640089,28,7,68,103
"13918","chr2",218684415,218684438,24,76,7,107
"13919","chr2",218778349,218778395,47,99,4,150
"13920","chr2",218783258,218783291,34,19,5,58
"13921","chr2",218843742,218843771,30,12,73,115
"13922","chr2",218860067,218860084,18,30,8,56
"13923","chr2",218862345,218862364,20,76,5,101
"13924","chr2",218864249,218864276,28,35,7,70
"13925","chr2",218892584,218892604,21,99,101,221
"13926","chr2",218946352,218946371,20,60,5,85
"13927","chr2",219001567,219001584,18,11,9,38
"13928","chr2",219045260,219045282,23,29,143,195
"13929","chr2",219059128,219059145,18,111,88,217
"13930","chr2",219060753,219060782,30,22,15,67
"13931","chr2",219070182,219070204,23,76,112,211
"13932","chr2",219152775,219152824,50,12,137,199
"13933","chr2",219176949,219176966,18,50,17,85
"13934","chr2",219229573,219229601,29,131,96,256
"13935","chr2",219244003,219244041,39,125,110,274
"13936","chr2",219259121,219259171,51,146,32,229
"13937","chr2",219429974,219429993,20,40,6,66
"13938","chr2",219441859,219441895,37,12,39,88
"13939","chr2",219441968,219442007,40,19,89,148
"13940","chr2",219571417,219571434,18,145,37,200
"13941","chr2",219627528,219627560,33,56,102,191
"13942","chr2",219851170,219851197,28,47,8,83
"13943","chr2",220283175,220283210,36,110,72,218
"13944","chr2",220904659,220904681,23,145,27,195
"13945","chr2",220904833,220904853,21,129,4,154
"13946","chr2",221526853,221526896,44,64,68,176
"13947","chr2",221570710,221570945,236,1,71,308
"13948","chr2",221704429,221704452,24,58,97,179
"13949","chr2",221852267,221852301,35,8,145,188
"13950","chr2",221861077,221861124,48,64,5,117
"13951","chr2",222156618,222156644,27,27,78,132
"13952","chr2",222319462,222319516,55,147,103,305
"13953","chr2",222319761,222319790,30,20,89,139
"13954","chr2",222332773,222332862,90,11,85,186
"13955","chr2",222866821,222866852,32,76,111,219
"13956","chr2",223857256,223857279,24,8,72,104
"13957","chr2",223886342,223886365,24,70,3,97
"13958","chr2",224002659,224002680,22,88,76,186
"13959","chr2",224428306,224428334,29,43,111,183
"13960","chr2",224534818,224534854,37,80,36,153
"13961","chr2",224551206,224551223,18,8,144,170
"13962","chr2",224585163,224585200,38,77,14,129
"13963","chr2",224585359,224585385,27,38,65,130
"13964","chr2",224625801,224625818,18,7,69,94
"13965","chr2",224639653,224639672,20,77,105,202
"13966","chr2",224641505,224641523,19,8,42,69
"13967","chr2",224839256,224839274,19,29,133,181
"13968","chr2",225054741,225054763,23,148,1,172
"13969","chr2",225432145,225432167,23,27,22,72
"13970","chr2",226237135,226237159,25,56,6,87
"13971","chr2",226796092,226796112,21,94,61,176
"13972","chr2",226799651,226799680,30,8,2,40
"13973","chr2",227104582,227104607,26,25,6,57
"13974","chr2",227404394,227404414,21,144,4,169
"13975","chr2",227618832,227618854,23,76,57,156
"13976","chr2",227664656,227664685,30,146,75,251
"13977","chr2",227936753,227936781,29,8,40,77
"13978","chr2",228132995,228133021,27,9,83,119
"13979","chr2",228186366,228186398,33,108,119,260
"13980","chr2",229341415,229341435,21,53,6,80
"13981","chr2",229714596,229714634,39,139,2,180
"13982","chr2",229804892,229804923,32,76,3,111
"13983","chr2",229938217,229938238,22,7,61,90
"13984","chr2",229939038,229939073,36,10,45,91
"13985","chr2",229963438,229963461,24,7,71,102
"13986","chr2",230027076,230027103,28,8,75,111
"13987","chr2",230502033,230502050,18,29,78,125
"13988","chr2",230702399,230702417,19,22,78,119
"13989","chr2",230926683,230926707,25,76,5,106
"13990","chr2",230929009,230929026,18,29,119,166
"13991","chr2",230987475,230987513,39,86,43,168
"13992","chr2",230992545,230992567,23,75,96,194
"13993","chr2",231037817,231037862,46,34,74,154
"13994","chr2",231189783,231189806,24,144,92,260
"13995","chr2",231232026,231232044,19,9,108,136
"13996","chr2",231315239,231315256,18,119,6,143
"13997","chr2",231337464,231337487,24,8,143,175
"13998","chr2",231359083,231359103,21,7,86,114
"13999","chr2",231440984,231441001,18,4,6,28
"14000","chr2",231445178,231445210,33,10,117,160
"14001","chr2",231498645,231498671,27,11,135,173
"14002","chr2",231525912,231525983,72,135,122,329
"14003","chr2",231545070,231545091,22,35,138,195
"14004","chr2",231560734,231560769,36,135,2,173
"14005","chr2",231574851,231574882,32,94,4,130
"14006","chr2",231597289,231597314,26,108,16,150
"14007","chr2",231618897,231618941,45,141,76,262
"14008","chr2",231641687,231641737,51,18,144,213
"14009","chr2",231651403,231651452,50,75,7,132
"14010","chr2",231657304,231657324,21,71,75,167
"14011","chr2",231692696,231692718,23,83,4,110
"14012","chr2",231876119,231876156,38,73,6,117
"14013","chr2",231877292,231877314,23,7,78,108
"14014","chr2",232068811,232068832,22,74,46,142
"14015","chr2",232088391,232088413,23,146,27,196
"14016","chr2",232221102,232221121,20,75,7,102
"14017","chr2",232300653,232300672,20,76,55,151
"14018","chr2",232378814,232378841,28,6,37,71
"14019","chr2",232414742,232414767,26,16,74,116
"14020","chr2",232451014,232451042,29,6,86,121
"14021","chr2",232485727,232485744,18,70,16,104
"14022","chr2",232487582,232487616,35,27,68,130
"14023","chr2",232601707,232601725,19,75,65,159
"14024","chr2",232605916,232605935,20,8,74,102
"14025","chr2",232606720,232606740,21,77,39,137
"14026","chr2",232633807,232633829,23,22,84,129
"14027","chr2",232644795,232644814,20,97,25,142
"14028","chr2",232667526,232667543,18,49,29,96
"14029","chr2",232667541,232667568,28,6,14,48
"14030","chr2",232723728,232723749,22,75,145,242
"14031","chr2",232843563,232843581,19,50,74,143
"14032","chr2",232920434,232920467,34,133,52,219
"14033","chr2",232972745,232972774,30,8,88,126
"14034","chr2",233049757,233049788,32,8,99,139
"14035","chr2",233080431,233080455,25,59,147,231
"14036","chr2",233080464,233080482,19,86,114,219
"14037","chr2",233098937,233098967,31,44,1,76
"14038","chr2",233121510,233121542,33,17,54,104
"14039","chr2",233174792,233174810,19,13,74,106
"14040","chr2",233296609,233296648,40,3,52,95
"14041","chr2",233296646,233296692,47,47,15,109
"14042","chr2",233354422,233354493,72,27,34,133
"14043","chr2",233354760,233354786,27,15,7,49
"14044","chr2",233880498,233880526,29,27,73,129
"14045","chr2",234495921,234495959,39,110,28,177
"14046","chr2",234496974,234497004,31,5,85,121
"14047","chr2",234497117,234497166,50,19,36,105
"14048","chr2",234726764,234726797,34,109,44,187
"14049","chr2",234816703,234816724,22,22,143,187
"14050","chr2",234858508,234858536,29,59,78,166
"14051","chr2",234951938,234951977,40,24,11,75
"14052","chr2",234952059,234952076,18,7,13,38
"14053","chr2",234972115,234972149,35,8,145,188
"14054","chr2",235284256,235284302,47,91,48,186
"14055","chr2",235356387,235356405,19,106,95,220
"14056","chr2",235435685,235435702,18,5,13,36
"14057","chr2",235474490,235474554,65,66,67,198
"14058","chr2",235493983,235494015,33,93,1,127
"14059","chr2",235517933,235517958,26,115,78,219
"14060","chr2",235536143,235536179,37,43,128,208
"14061","chr2",235536255,235536277,23,43,16,82
"14062","chr2",235536353,235536375,23,141,84,248
"14063","chr2",235536407,235536437,31,32,30,93
"14064","chr2",235536469,235536495,27,90,66,183
"14065","chr2",235594884,235594906,23,35,135,193
"14066","chr2",235669488,235669520,33,7,108,148
"14067","chr2",235704963,235704996,34,76,83,193
"14068","chr2",235759165,235759186,22,8,74,104
"14069","chr2",235783964,235783994,31,84,7,122
"14070","chr2",235819883,235819920,38,43,25,106
"14071","chr2",236024022,236024049,28,77,34,139
"14072","chr2",236078156,236078193,38,125,145,308
"14073","chr2",236102418,236102437,20,76,5,101
"14074","chr2",236122681,236122700,20,76,125,221
"14075","chr2",236167784,236167807,24,95,10,129
"14076","chr2",236168287,236168315,29,33,40,102
"14077","chr2",236237338,236237446,109,21,57,187
"14078","chr2",236268196,236268219,24,78,89,191
"14079","chr2",236664436,236664458,23,97,46,166
"14080","chr2",236777051,236777077,27,49,122,198
"14081","chr2",236784521,236784562,42,83,7,132
"14082","chr2",236847145,236847163,19,21,124,164
"14083","chr2",236905548,236905721,174,146,5,325
"14084","chr2",237503121,237503146,26,107,72,205
"14085","chr2",237510901,237510925,25,5,2,32
"14086","chr2",237627398,237627420,23,49,14,86
"14087","chr2",237627564,237627591,28,52,51,131
"14088","chr2",237681679,237681697,19,8,133,160
"14089","chr2",237771303,237771320,18,15,15,48
"14090","chr2",237859561,237859587,27,56,27,110
"14091","chr2",237956646,237956671,26,128,89,243
"14092","chr2",238049434,238049451,18,32,6,56
"14093","chr2",238148292,238148318,27,81,4,112
"14094","chr2",238320562,238320591,30,121,102,253
"14095","chr2",238501022,238501056,35,76,6,117
"14096","chr2",238507673,238507713,41,25,125,191
"14097","chr2",238526334,238526353,20,76,101,197
"14098","chr2",238846365,238846384,20,39,125,184
"14099","chr2",238860939,238860961,23,5,5,33
"14100","chr2",238916247,238916285,39,58,8,105
"14101","chr2",238984068,238984086,19,74,111,204
"14102","chr2",239028703,239028725,23,76,142,241
"14103","chr2",239295307,239295333,27,46,74,147
"14104","chr2",239298864,239298888,25,78,121,224
"14105","chr2",239400868,239400907,40,2,10,52
"14106","chr2",239505204,239505227,24,10,21,55
"14107","chr2",239832749,239832766,18,124,100,242
"14108","chr2",240025946,240025986,41,9,41,91
"14109","chr2",240092000,240092041,42,85,41,168
"14110","chr2",240371619,240371654,36,119,54,209
"14111","chr2",240435520,240435564,45,45,41,131
"14112","chr2",240566561,240566584,24,20,129,173
"14113","chr2",240568376,240568400,25,7,3,35
"14114","chr2",240584148,240584171,24,76,26,126
"14115","chr2",240660063,240660101,39,74,86,199
"14116","chr2",240680865,240680965,101,7,16,124
"14117","chr2",240749446,240749474,29,60,98,187
"14118","chr2",240975720,240975746,27,7,7,41
"14119","chr2",241196839,241196884,46,110,15,171
"14120","chr2",241215024,241215041,18,131,107,256
"14121","chr2",241217901,241217963,63,137,54,254
"14122","chr2",241258347,241258374,28,61,74,163
"14123","chr2",241272691,241272730,40,29,5,74
"14124","chr2",241315882,241315908,27,37,51,115
"14125","chr2",241510469,241510491,23,7,35,65
"14126","chr2",241542162,241542184,23,72,44,139
"14127","chr2",241550227,241550248,22,95,6,123
"14128","chr2",241604237,241604264,28,3,144,175
"14129","chr2",241628926,241628948,23,25,20,68
"14130","chr2",241637183,241637207,25,46,18,89
"14131","chr2",241647623,241647648,26,140,71,237
"14132","chr2",241673458,241673475,18,92,7,117
"14133","chr2",241697435,241697453,19,125,74,218
"14134","chr2",241700151,241700174,24,76,142,242
"14135","chr2",241758770,241758812,43,99,13,155
"14136","chr2",241824527,241824544,18,69,8,95
"14137","chr2",241844541,241844559,19,80,40,139
"14138","chr2",241852386,241852413,28,96,64,188
"14139","chr2",241898545,241898572,28,61,13,102
"14140","chr2",241953223,241953279,57,44,45,146
"14141","chr2",242088459,242088492,34,19,19,72
"14142","chr20",326558,326575,18,13,61,92
"14143","chr20",350478,350498,21,145,35,201
"14144","chr20",355358,355396,39,73,75,187
"14145","chr20",374702,374724,23,77,33,133
"14146","chr20",407943,408045,103,21,39,163
"14147","chr20",453154,453188,35,9,1,45
"14148","chr20",595644,595663,20,55,3,78
"14149","chr20",610040,610076,37,37,39,113
"14150","chr20",653539,653557,19,2,12,33
"14151","chr20",664215,664241,27,22,69,118
"14152","chr20",727787,727804,18,28,74,120
"14153","chr20",819292,819409,118,61,67,246
"14154","chr20",833007,833046,40,70,6,116
"14155","chr20",919099,919122,24,24,65,113
"14156","chr20",919120,919165,46,67,44,157
"14157","chr20",964138,964159,22,143,27,192
"14158","chr20",1126878,1126897,20,81,7,108
"14159","chr20",1225640,1225659,20,104,15,139
"14160","chr20",1401001,1401045,45,76,82,203
"14161","chr20",1803360,1803396,37,9,64,110
"14162","chr20",1826918,1826966,49,20,4,73
"14163","chr20",2173212,2173250,39,115,143,297
"14164","chr20",2209496,2209516,21,9,49,79
"14165","chr20",2220708,2220738,31,75,52,158
"14166","chr20",2260782,2260811,30,40,121,191
"14167","chr20",2534422,2534445,24,8,6,38
"14168","chr20",2652733,2652775,43,99,32,174
"14169","chr20",2675160,2675216,57,125,133,315
"14170","chr20",2686981,2686998,18,108,73,199
"14171","chr20",2692805,2692832,28,4,21,53
"14172","chr20",2692865,2692897,33,14,5,52
"14173","chr20",2692929,2692946,18,41,21,80
"14174","chr20",2693174,2693194,21,4,10,35
"14175","chr20",2705786,2705838,53,10,35,98
"14176","chr20",2770522,2770567,46,87,6,139
"14177","chr20",2979699,2979716,18,28,102,148
"14178","chr20",3008729,3008759,31,74,36,141
"14179","chr20",3142604,3142623,20,145,74,239
"14180","chr20",3168348,3168366,19,1,29,49
"14181","chr20",3171663,3171681,19,136,8,163
"14182","chr20",3206388,3206411,24,10,74,108
"14183","chr20",3236582,3236616,35,100,13,148
"14184","chr20",3242049,3242067,19,126,74,219
"14185","chr20",3246286,3246311,26,7,145,178
"14186","chr20",3293293,3293319,27,20,6,53
"14187","chr20",3345018,3345035,18,7,128,153
"14188","chr20",3407695,3407716,22,40,98,160
"14189","chr20",3471287,3471339,53,17,92,162
"14190","chr20",3471357,3471375,19,53,22,94
"14191","chr20",3680866,3680888,23,142,40,205
"14192","chr20",3681940,3681967,28,35,7,70
"14193","chr20",3704985,3705007,23,70,84,177
"14194","chr20",3782371,3782408,38,30,76,144
"14195","chr20",3841884,3841908,25,142,7,174
"14196","chr20",3850275,3850299,25,49,76,150
"14197","chr20",3850886,3850905,20,135,6,161
"14198","chr20",3856354,3856373,20,12,11,43
"14199","chr20",3909088,3909106,19,16,20,55
"14200","chr20",4016079,4016096,18,65,6,89
"14201","chr20",4085894,4085912,19,8,17,44
"14202","chr20",4215748,4215773,26,13,74,113
"14203","chr20",4221819,4221841,23,24,3,50
"14204","chr20",4242859,4242885,27,19,17,63
"14205","chr20",4573104,4573160,57,42,143,242
"14206","chr20",5015656,5015685,30,5,10,45
"14207","chr20",5037519,5037541,23,143,41,207
"14208","chr20",5066671,5066689,19,44,75,138
"14209","chr20",5168418,5168451,34,119,71,224
"14210","chr20",5455654,5455673,20,145,34,199
"14211","chr20",5455822,5455840,19,111,7,137
"14212","chr20",5554135,5554155,21,27,144,192
"14213","chr20",5610705,5610722,18,28,123,169
"14214","chr20",5646534,5646564,31,45,67,143
"14215","chr20",5651059,5651086,28,73,21,122
"14216","chr20",5684733,5684782,50,81,39,170
"14217","chr20",5795602,5795624,23,72,71,166
"14218","chr20",5849966,5849989,24,96,67,187
"14219","chr20",6107200,6107221,22,50,70,142
"14220","chr20",6186760,6186784,25,76,45,146
"14221","chr20",6767283,6767303,21,23,90,134
"14222","chr20",6767685,6767710,26,37,1,64
"14223","chr20",6769141,6769163,23,27,47,97
"14224","chr20",7826693,7826713,21,79,74,174
"14225","chr20",8139254,8139275,22,35,75,132
"14226","chr20",8147873,8147890,18,76,13,107
"14227","chr20",8495389,8495415,27,8,117,152
"14228","chr20",9069086,9069118,33,89,55,177
"14229","chr20",10034876,10034957,82,12,119,213
"14230","chr20",10626191,10626215,25,38,134,197
"14231","chr20",11360325,11360356,32,8,147,187
"14232","chr20",11393819,11393841,23,19,7,49
"14233","chr20",11693226,11693255,30,9,66,105
"14234","chr20",11984139,11984306,168,116,53,337
"14235","chr20",13221213,13221286,74,5,9,88
"14236","chr20",13221553,13221581,29,2,19,50
"14237","chr20",13221797,13221826,30,49,38,117
"14238","chr20",13394308,13394328,21,11,19,51
"14239","chr20",13683058,13683078,21,4,123,148
"14240","chr20",13683080,13683099,20,25,101,146
"14241","chr20",13687246,13687269,24,72,145,241
"14242","chr20",13848200,13848619,420,132,64,616
"14243","chr20",14389422,14389441,20,121,74,215
"14244","chr20",15095491,15095533,43,74,29,146
"14245","chr20",16194269,16194290,22,16,2,40
"14246","chr20",16589694,16589725,32,24,98,154
"14247","chr20",16637197,16637221,25,7,81,113
"14248","chr20",16801237,16801287,51,32,74,157
"14249","chr20",17226521,17226555,35,108,53,196
"14250","chr20",17226798,17226825,28,93,121,242
"14251","chr20",17226843,17226864,22,132,76,230
"14252","chr20",17547027,17547047,21,74,3,98
"14253","chr20",17681636,17681655,20,37,40,97
"14254","chr20",17719105,17719122,18,56,71,145
"14255","chr20",17723997,17724015,19,114,4,137
"14256","chr20",17735105,17735141,37,21,93,151
"14257","chr20",17910865,17910887,23,53,7,83
"14258","chr20",17985037,17985062,26,68,6,100
"14259","chr20",18059395,18059430,36,86,10,132
"14260","chr20",18095454,18095473,20,43,6,69
"14261","chr20",18379773,18379791,19,10,99,128
"14262","chr20",18612034,18612052,19,8,131,158
"14263","chr20",19212481,19212512,32,84,28,144
"14264","chr20",19212606,19212633,28,2,23,53
"14265","chr20",19212876,19212898,23,7,104,134
"14266","chr20",19299178,19299223,46,132,31,209
"14267","chr20",19758148,19758198,51,49,8,108
"14268","chr20",19758154,19758242,89,11,2,102
"14269","chr20",19810684,19810709,26,6,37,69
"14270","chr20",20090689,20090712,24,114,75,213
"14271","chr20",20259246,20259272,27,76,103,206
"14272","chr20",20387354,20387375,22,71,72,165
"14273","chr20",20712582,20712630,49,43,65,157
"14274","chr20",21275633,21275654,22,138,2,162
"14275","chr20",21365800,21365955,156,126,11,293
"14276","chr20",21366009,21366241,233,123,121,477
"14277","chr20",21397131,21397174,44,34,16,94
"14278","chr20",21478791,21478864,74,118,73,265
"14279","chr20",21511250,21511277,28,102,43,173
"14280","chr20",21511809,21511836,28,111,111,250
"14281","chr20",22582037,22582062,26,7,59,92
"14282","chr20",22584630,22584716,87,6,69,162
"14283","chr20",23086152,23086174,23,18,136,177
"14284","chr20",23391311,23391330,20,135,7,162
"14285","chr20",23988046,23988068,23,47,9,79
"14286","chr20",24057952,24057991,40,75,7,122
"14287","chr20",25253624,25253659,36,28,34,98
"14288","chr20",25362579,25362639,61,23,62,146
"14289","chr20",29035026,29035062,37,8,8,53
"14290","chr20",29306182,29306210,29,82,135,246
"14291","chr20",29310541,29310596,56,53,100,209
"14292","chr20",29447884,29447936,53,34,22,109
"14293","chr20",29753639,29753659,21,122,18,161
"14294","chr20",29754241,29755070,830,11,88,929
"14295","chr20",29763027,29763098,72,79,11,162
"14296","chr20",29764216,29764265,50,54,52,156
"14297","chr20",30290609,30290644,36,142,123,301
"14298","chr20",30499545,30499567,23,82,120,225
"14299","chr20",30514243,30514270,28,81,127,236
"14300","chr20",30892389,30892468,80,17,126,223
"14301","chr20",30892453,30892479,27,28,62,117
"14302","chr20",30906297,30906314,18,32,128,178
"14303","chr20",30906314,30906349,36,15,111,162
"14304","chr20",30913188,30913218,31,115,94,240
"14305","chr20",31447781,31447804,24,76,146,246
"14306","chr20",31455009,31455039,31,28,72,131
"14307","chr20",31512493,31512529,37,3,72,112
"14308","chr20",31513622,31513650,29,7,11,47
"14309","chr20",31564853,31564880,28,9,29,66
"14310","chr20",31577927,31577965,39,90,37,166
"14311","chr20",31586836,31586857,22,3,78,103
"14312","chr20",31600978,31601001,24,145,73,242
"14313","chr20",31603559,31603578,20,10,135,165
"14314","chr20",31610261,31610285,25,76,144,245
"14315","chr20",31613592,31613646,55,69,101,225
"14316","chr20",31613609,31613653,45,8,84,137
"14317","chr20",31618663,31618711,49,144,4,197
"14318","chr20",31618831,31618849,19,13,37,69
"14319","chr20",31627202,31627224,23,69,21,113
"14320","chr20",31630837,31630863,27,9,76,112
"14321","chr20",31661753,31661777,25,2,44,71
"14322","chr20",31687677,31687701,25,133,6,164
"14323","chr20",31827883,31827903,21,6,81,108
"14324","chr20",31835009,31835032,24,71,61,156
"14325","chr20",31880262,31880292,31,91,38,160
"14326","chr20",31895814,31895857,44,8,33,85
"14327","chr20",32019220,32019254,35,74,49,158
"14328","chr20",32054476,32054524,49,13,73,135
"14329","chr20",32277699,32277744,46,19,49,114
"14330","chr20",32305571,32305593,23,9,5,37
"14331","chr20",32361634,32361663,30,27,10,67
"14332","chr20",32382121,32382153,33,34,77,144
"14333","chr20",32457236,32457256,21,61,1,83
"14334","chr20",32461417,32461440,24,76,41,141
"14335","chr20",32462904,32462923,20,88,75,183
"14336","chr20",32483444,32483463,20,3,19,42
"14337","chr20",32583328,32583346,19,7,77,103
"14338","chr20",32584134,32584170,37,7,5,49
"14339","chr20",32584952,32584970,19,70,6,95
"14340","chr20",32585088,32585117,30,40,3,73
"14341","chr20",32585360,32585383,24,34,18,76
"14342","chr20",32671841,32671864,24,49,4,77
"14343","chr20",32702410,32702427,18,45,74,137
"14344","chr20",32748702,32748726,25,116,5,146
"14345","chr20",32755058,32755079,22,76,73,171
"14346","chr20",32760018,32760045,28,8,28,64
"14347","chr20",32765744,32765773,30,21,40,91
"14348","chr20",32826520,32826544,25,76,145,246
"14349","chr20",32892832,32892856,25,74,63,162
"14350","chr20",32899230,32899256,27,146,27,200
"14351","chr20",32901675,32901707,33,10,24,67
"14352","chr20",33163790,33163807,18,102,106,226
"14353","chr20",33368460,33368488,29,45,30,104
"14354","chr20",33382866,33382898,33,98,74,205
"14355","chr20",33460388,33460406,19,134,4,157
"14356","chr20",33468810,33468835,26,147,6,179
"14357","chr20",33481105,33481130,26,9,117,152
"14358","chr20",33490045,33490080,36,48,15,99
"14359","chr20",33490089,33490114,26,82,49,157
"14360","chr20",33527369,33527390,22,76,51,149
"14361","chr20",33637967,33637992,26,8,145,179
"14362","chr20",33674282,33674305,24,12,27,63
"14363","chr20",33674467,33674489,23,56,127,206
"14364","chr20",33722959,33722976,18,76,7,101
"14365","chr20",33725394,33725423,30,95,123,248
"14366","chr20",33733219,33733236,18,76,138,232
"14367","chr20",33764021,33764040,20,6,34,60
"14368","chr20",33800261,33800281,21,138,66,225
"14369","chr20",33811326,33811349,24,51,6,81
"14370","chr20",33811396,33811431,36,69,32,137
"14371","chr20",33942758,33942783,26,15,41,82
"14372","chr20",33974265,33974288,24,75,16,115
"14373","chr20",34029460,34029512,53,25,51,129
"14374","chr20",34077063,34077122,60,144,146,350
"14375","chr20",34113150,34113173,24,42,16,82
"14376","chr20",34185122,34185140,19,106,6,131
"14377","chr20",34196174,34196197,24,76,65,165
"14378","chr20",34269947,34269989,43,13,71,127
"14379","chr20",34289473,34289492,20,5,11,36
"14380","chr20",34297282,34297304,23,64,96,183
"14381","chr20",34310221,34310241,21,38,25,84
"14382","chr20",34364725,34364743,19,79,23,121
"14383","chr20",34364891,34364911,21,6,74,101
"14384","chr20",34384280,34384299,20,76,11,107
"14385","chr20",34503854,34503899,46,126,67,239
"14386","chr20",34665193,34665221,29,8,75,112
"14387","chr20",34666688,34666714,27,76,84,187
"14388","chr20",34688029,34688069,41,77,41,159
"14389","chr20",34695603,34695631,29,145,19,193
"14390","chr20",34701127,34701148,22,75,13,110
"14391","chr20",34704187,34704215,29,112,11,152
"14392","chr20",34709161,34709185,25,75,84,184
"14393","chr20",34825668,34825702,35,90,79,204
"14394","chr20",34900167,34900188,22,9,8,39
"14395","chr20",34903340,34903357,18,39,76,133
"14396","chr20",34910020,34910039,20,76,7,103
"14397","chr20",34959460,34959495,36,76,44,156
"14398","chr20",35034152,35034178,27,6,67,100
"14399","chr20",35221794,35221816,23,104,24,151
"14400","chr20",35221946,35221976,31,10,67,108
"14401","chr20",35226646,35226702,57,56,112,225
"14402","chr20",35226774,35226798,25,27,5,57
"14403","chr20",35226840,35226859,20,5,26,51
"14404","chr20",35226891,35226910,20,1,10,31
"14405","chr20",35226928,35226948,21,33,19,73
"14406","chr20",35256715,35256740,26,100,78,204
"14407","chr20",35261796,35261818,23,45,49,117
"14408","chr20",35277856,35277880,25,37,120,182
"14409","chr20",35281171,35281188,18,29,81,128
"14410","chr20",35284937,35284959,23,25,29,77
"14411","chr20",35285865,35285934,70,132,63,265
"14412","chr20",35397201,35397230,30,144,3,177
"14413","chr20",35402577,35402615,39,49,7,95
"14414","chr20",35427259,35427280,22,8,133,163
"14415","chr20",35530220,35530264,45,73,132,250
"14416","chr20",35537095,35537137,43,15,125,183
"14417","chr20",35539174,35539667,494,43,122,659
"14418","chr20",35565873,35565891,19,47,74,140
"14419","chr20",35565889,35565911,23,67,58,148
"14420","chr20",35577760,35577785,26,13,77,116
"14421","chr20",35608278,35608302,25,5,75,105
"14422","chr20",35615103,35615131,29,104,73,206
"14423","chr20",35615425,35615491,67,69,61,197
"14424","chr20",35665595,35665619,25,58,6,89
"14425","chr20",35678529,35678548,20,135,73,228
"14426","chr20",35683080,35683117,38,63,23,124
"14427","chr20",35689769,35689788,20,77,75,172
"14428","chr20",35697116,35697135,20,65,64,149
"14429","chr20",35727351,35727374,24,133,73,230
"14430","chr20",35780531,35780564,34,8,5,47
"14431","chr20",35784434,35784454,21,76,63,160
"14432","chr20",35788085,35788111,27,5,3,35
"14433","chr20",35811752,35811770,19,58,133,210
"14434","chr20",35814888,35814913,26,12,59,97
"14435","chr20",35827785,35827802,18,134,72,224
"14436","chr20",35870304,35870331,28,145,6,179
"14437","chr20",35967545,35967564,20,6,15,41
"14438","chr20",35994047,35994082,36,7,143,186
"14439","chr20",36022185,36022217,33,37,121,191
"14440","chr20",36063334,36063352,19,7,115,141
"14441","chr20",36068191,36068211,21,74,71,166
"14442","chr20",36093673,36093691,19,48,66,133
"14443","chr20",36124258,36124281,24,48,3,75
"14444","chr20",36276993,36277016,24,2,2,28
"14445","chr20",36306392,36306420,29,10,73,112
"14446","chr20",36312369,36312401,33,136,38,207
"14447","chr20",36453935,36453986,52,145,96,293
"14448","chr20",36461519,36461545,27,20,5,52
"14449","chr20",36461656,36461703,48,15,56,119
"14450","chr20",36461702,36461724,23,36,10,69
"14451","chr20",36461725,36461751,27,63,19,109
"14452","chr20",36461749,36461772,24,84,3,111
"14453","chr20",36476688,36476724,37,21,25,83
"14454","chr20",36512048,36512068,21,76,60,157
"14455","chr20",36535758,36535792,35,25,6,66
"14456","chr20",36574476,36574504,29,31,13,73
"14457","chr20",36604880,36604900,21,74,109,204
"14458","chr20",36617534,36617557,24,129,74,227
"14459","chr20",36699694,36699714,21,23,108,152
"14460","chr20",36708648,36708680,33,76,10,119
"14461","chr20",36727520,36727560,41,9,10,60
"14462","chr20",36746080,36746121,42,28,94,164
"14463","chr20",36762275,36762292,18,37,74,129
"14464","chr20",36763403,36763433,31,84,36,151
"14465","chr20",36765847,36765870,24,107,25,156
"14466","chr20",36790429,36790450,22,74,7,103
"14467","chr20",36801969,36801998,30,7,1,38
"14468","chr20",36803957,36803980,24,74,74,172
"14469","chr20",36821528,36821550,23,127,6,156
"14470","chr20",36944078,36944097,20,45,6,71
"14471","chr20",36948866,36948907,42,72,75,189
"14472","chr20",36955963,36955985,23,124,70,217
"14473","chr20",36957534,36957566,33,42,2,77
"14474","chr20",36973596,36973618,23,5,7,35
"14475","chr20",37036617,37036643,27,8,94,129
"14476","chr20",37052331,37052348,18,7,96,121
"14477","chr20",37105200,37105229,30,72,100,202
"14478","chr20",37326479,37326506,28,146,8,182
"14479","chr20",37334365,37334392,28,141,25,194
"14480","chr20",37339882,37339904,23,76,34,133
"14481","chr20",37346083,37346102,20,5,24,49
"14482","chr20",37407282,37407299,18,80,143,241
"14483","chr20",37418288,37418343,56,2,143,201
"14484","chr20",37424104,37424267,164,14,92,270
"14485","chr20",37439151,37439297,147,39,42,228
"14486","chr20",37519405,37519440,36,7,71,114
"14487","chr20",37571391,37571409,19,78,104,201
"14488","chr20",37885252,37885272,21,4,18,43
"14489","chr20",37903027,37903081,55,15,32,102
"14490","chr20",37914138,37914522,385,50,15,450
"14491","chr20",37943428,37943448,21,4,21,46
"14492","chr20",38161374,38161398,25,22,22,69
"14493","chr20",38187913,38187952,40,10,24,74
"14494","chr20",38217831,38217853,23,44,50,117
"14495","chr20",38363710,38363738,29,36,5,70
"14496","chr20",38430322,38430343,22,143,73,238
"14497","chr20",38430625,38430646,22,83,71,176
"14498","chr20",38464878,38464900,23,78,5,106
"14499","chr20",38724419,38724449,31,56,35,122
"14500","chr20",38796605,38796628,24,102,6,132
"14501","chr20",38955459,38955485,27,46,6,79
"14502","chr20",38981944,38981963,20,138,6,164
"14503","chr20",38989266,38989287,22,30,142,194
"14504","chr20",39052406,39052427,22,52,16,90
"14505","chr20",39655890,39655927,38,121,24,183
"14506","chr20",39667289,39667313,25,78,35,138
"14507","chr20",40686943,40686966,24,17,145,186
"14508","chr20",41137550,41137576,27,44,45,116
"14509","chr20",41266845,41266870,26,84,145,255
"14510","chr20",41270375,41270393,19,147,11,177
"14511","chr20",41315347,41315374,28,122,78,228
"14512","chr20",41631522,41631542,21,141,73,235
"14513","chr20",41755170,41755309,140,6,92,238
"14514","chr20",41787547,41787573,27,8,147,182
"14515","chr20",42087395,42087420,26,57,78,161
"14516","chr20",42859574,42859601,28,8,47,83
"14517","chr20",43189970,43190006,37,47,42,126
"14518","chr20",43306580,43306601,22,148,73,243
"14519","chr20",43321235,43321261,27,7,111,145
"14520","chr20",43356413,43356438,26,138,8,172
"14521","chr20",43385825,43385868,44,135,74,253
"14522","chr20",43417326,43417363,38,74,30,142
"14523","chr20",43428126,43428156,31,9,71,111
"14524","chr20",43445702,43445720,19,75,76,170
"14525","chr20",43456173,43456193,21,94,61,176
"14526","chr20",43522781,43522800,20,127,136,283
"14527","chr20",43588947,43588975,29,35,141,205
"14528","chr20",43641793,43641812,20,127,11,158
"14529","chr20",43666455,43666474,20,145,7,172
"14530","chr20",43666984,43667003,20,47,29,96
"14531","chr20",43671464,43671487,24,5,137,166
"14532","chr20",43713382,43713404,23,7,6,36
"14533","chr20",43718741,43718760,20,8,71,99
"14534","chr20",43727156,43727182,27,5,10,42
"14535","chr20",43914742,43914766,25,129,37,191
"14536","chr20",43914865,43914884,20,6,9,35
"14537","chr20",44119874,44119895,22,27,6,55
"14538","chr20",44190646,44190688,43,147,2,192
"14539","chr20",44230757,44230774,18,140,105,263
"14540","chr20",44297655,44297674,20,27,144,191
"14541","chr20",44370025,44370043,19,6,33,58
"14542","chr20",44379731,44379751,21,8,131,160
"14543","chr20",44506282,44506300,19,3,25,47
"14544","chr20",44531533,44531563,31,4,25,60
"14545","chr20",44810295,44810326,32,39,135,206
"14546","chr20",44810493,44810535,43,1,47,91
"14547","chr20",44885755,44885772,18,4,76,98
"14548","chr20",45062844,45062863,20,29,76,125
"14549","chr20",45313259,45313465,207,135,64,406
"14550","chr20",45348468,45348496,29,15,112,156
"14551","chr20",45364466,45364489,24,8,5,37
"14552","chr20",45488243,45488271,29,10,15,54
"14553","chr20",45825600,45825632,33,2,137,172
"14554","chr20",45862455,45862508,54,75,75,204
"14555","chr20",45891599,45891624,26,36,21,83
"14556","chr20",45913162,45913186,25,126,94,245
"14557","chr20",45932076,45932096,21,19,5,45
"14558","chr20",45935194,45935211,18,18,42,78
"14559","chr20",45936342,45936362,21,29,142,192
"14560","chr20",45942767,45942793,27,118,90,235
"14561","chr20",46002429,46002450,22,12,124,158
"14562","chr20",46002735,46002757,23,110,4,137
"14563","chr20",46007468,46007489,22,74,71,167
"14564","chr20",46029859,46029941,83,117,48,248
"14565","chr20",46087746,46087771,26,79,19,124
"14566","chr20",46131343,46131392,50,53,2,105
"14567","chr20",46156317,46156342,26,84,92,202
"14568","chr20",46251216,46251234,19,122,57,198
"14569","chr20",46308427,46308483,57,9,44,110
"14570","chr20",46652548,46652567,20,28,88,136
"14571","chr20",46728605,46728628,24,70,4,98
"14572","chr20",46741957,46741978,22,20,5,47
"14573","chr20",46894938,46894960,23,54,14,91
"14574","chr20",47117645,47117666,22,148,36,206
"14575","chr20",47125048,47125071,24,8,34,66
"14576","chr20",47233206,47233226,21,26,10,57
"14577","chr20",47268291,47268310,20,8,40,68
"14578","chr20",47307462,47307484,23,143,2,168
"14579","chr20",47324202,47324220,19,133,74,226
"14580","chr20",47337348,47337378,31,141,10,182
"14581","chr20",47345507,47345525,19,121,51,191
"14582","chr20",47363964,47363981,18,8,146,172
"14583","chr20",47365026,47365045,20,35,73,128
"14584","chr20",47365944,47365991,48,88,4,140
"14585","chr20",47375122,47375150,29,42,64,135
"14586","chr20",47390326,47390354,29,69,147,245
"14587","chr20",47401910,47401932,23,7,33,63
"14588","chr20",47414184,47414210,27,8,22,57
"14589","chr20",47444097,47444124,28,83,29,140
"14590","chr20",47445776,47445794,19,146,31,196
"14591","chr20",47593335,47593362,28,11,43,82
"14592","chr20",47640718,47640738,21,77,35,133
"14593","chr20",47700638,47700663,26,76,122,224
"14594","chr20",47720253,47720274,22,9,6,37
"14595","chr20",47785436,47785477,42,22,72,136
"14596","chr20",47785879,47785908,30,35,20,85
"14597","chr20",47796324,47796374,51,132,61,244
"14598","chr20",48872746,48872774,29,79,6,114
"14599","chr20",48873555,48873574,20,148,25,193
"14600","chr20",48887621,48887650,30,133,73,236
"14601","chr20",48970615,48970645,31,93,1,125
"14602","chr20",49005738,49005763,26,8,6,40
"14603","chr20",49050386,49050412,27,68,75,170
"14604","chr20",49061487,49061520,34,8,130,172
"14605","chr20",49071968,49071985,18,94,6,118
"14606","chr20",49178752,49178770,19,126,73,218
"14607","chr20",49178910,49178928,19,74,35,128
"14608","chr20",49188090,49188108,19,113,25,157
"14609","chr20",49189202,49189240,39,7,5,51
"14610","chr20",49196459,49196492,34,20,33,87
"14611","chr20",49202231,49202260,30,127,63,220
"14612","chr20",49206415,49206439,25,86,24,135
"14613","chr20",49227839,49227858,20,8,27,55
"14614","chr20",49232764,49232790,27,77,6,110
"14615","chr20",49416330,49416355,26,127,34,187
"14616","chr20",49483055,49483103,49,33,41,123
"14617","chr20",49483060,49483114,55,44,36,135
"14618","chr20",49484170,49484198,29,44,6,79
"14619","chr20",49484200,49484219,20,65,3,88
"14620","chr20",49704719,49704748,30,117,6,153
"14621","chr20",49722540,49722575,36,6,43,85
"14622","chr20",49781396,49781419,24,67,71,162
"14623","chr20",49927831,49927871,41,120,6,167
"14624","chr20",49996398,49996418,21,76,81,178
"14625","chr20",50010101,50010135,35,53,9,97
"14626","chr20",50051802,50051832,31,52,4,87
"14627","chr20",50058352,50058371,20,95,122,237
"14628","chr20",50059925,50059943,19,115,53,187
"14629","chr20",50071189,50071206,18,15,45,78
"14630","chr20",50071204,50071226,23,35,30,88
"14631","chr20",50075112,50075140,29,12,4,45
"14632","chr20",50084892,50084913,22,13,15,50
"14633","chr20",50167093,50167112,20,5,79,104
"14634","chr20",50181999,50182017,19,76,143,238
"14635","chr20",50191335,50191359,25,15,10,50
"14636","chr20",50191520,50191547,28,87,64,179
"14637","chr20",50192122,50192151,30,140,87,257
"14638","chr20",50209122,50209142,21,125,137,283
"14639","chr20",50235572,50235591,20,100,132,252
"14640","chr20",50433991,50434008,18,105,92,215
"14641","chr20",50444844,50444862,19,140,82,241
"14642","chr20",50475421,50475441,21,109,85,215
"14643","chr20",50487442,50487475,34,108,6,148
"14644","chr20",50594276,50594296,21,68,74,163
"14645","chr20",50670159,50670180,22,72,4,98
"14646","chr20",50694742,50694798,57,32,4,93
"14647","chr20",50707586,50707603,18,117,8,143
"14648","chr20",50725664,50725692,29,74,36,139
"14649","chr20",50810579,50810605,27,5,90,122
"14650","chr20",50872264,50872284,21,143,74,238
"14651","chr20",50875603,50875631,29,117,33,179
"14652","chr20",50888200,50888219,20,117,55,192
"14653","chr20",50922579,50922596,18,75,23,116
"14654","chr20",50930878,50930927,50,77,5,132
"14655","chr20",51143284,51143342,59,41,52,152
"14656","chr20",51317635,51317661,27,141,79,247
"14657","chr20",51525221,51525255,35,101,118,254
"14658","chr20",51714377,51714395,19,72,48,139
"14659","chr20",51766840,51766868,29,98,74,201
"14660","chr20",51768599,51768635,37,55,5,97
"14661","chr20",51772945,51772968,24,8,64,96
"14662","chr20",51787096,51787134,39,5,5,49
"14663","chr20",51809749,51809774,26,46,72,144
"14664","chr20",51817593,51817622,30,75,10,115
"14665","chr20",51840151,51840168,18,76,116,210
"14666","chr20",51855428,51855449,22,76,144,242
"14667","chr20",51909017,51909038,22,75,2,99
"14668","chr20",51965112,51965129,18,68,74,160
"14669","chr20",51999979,51999996,18,48,87,153
"14670","chr20",52016790,52016834,45,84,5,134
"14671","chr20",52111198,52111223,26,65,89,180
"14672","chr20",52171358,52171448,91,17,114,222
"14673","chr20",52456948,52457005,58,13,11,82
"14674","chr20",52972696,52972768,73,18,123,214
"14675","chr20",52973030,52973047,18,7,21,46
"14676","chr20",52994330,52994472,143,57,64,264
"14677","chr20",53196367,53196392,26,28,126,180
"14678","chr20",53325775,53325797,23,124,134,281
"14679","chr20",53563127,53563152,26,8,34,68
"14680","chr20",53605935,53605959,25,103,16,144
"14681","chr20",53630560,53630587,28,76,143,247
"14682","chr20",53632830,53632847,18,137,29,184
"14683","chr20",53672270,53672288,19,20,1,40
"14684","chr20",53697599,53697639,41,22,4,67
"14685","chr20",53713168,53713191,24,42,93,159
"14686","chr20",53724768,53724793,26,9,116,151
"14687","chr20",53759461,53759482,22,9,8,39
"14688","chr20",53759806,53759828,23,35,101,159
"14689","chr20",53838079,53838107,29,67,129,225
"14690","chr20",53927294,53927320,27,71,85,183
"14691","chr20",54208234,54208253,20,3,81,104
"14692","chr20",54309377,54309394,18,22,105,145
"14693","chr20",54637738,54637762,25,69,35,129
"14694","chr20",54652629,54652647,19,6,119,144
"14695","chr20",54740231,54740264,34,67,110,211
"14696","chr20",55185037,55185080,44,7,2,53
"14697","chr20",55432883,55432913,31,43,31,105
"14698","chr20",56039002,56039047,46,80,8,134
"14699","chr20",56189143,56189169,27,145,6,178
"14700","chr20",56468560,56468578,19,82,100,201
"14701","chr20",56561663,56561707,45,72,144,261
"14702","chr20",56587008,56587030,23,87,4,114
"14703","chr20",56596939,56596956,18,145,75,238
"14704","chr20",56624542,56624567,26,6,45,77
"14705","chr20",56687159,56687192,34,103,88,225
"14706","chr20",56750760,56750783,24,127,101,252
"14707","chr20",56783333,56783351,19,18,5,42
"14708","chr20",56884340,56884381,42,11,132,185
"14709","chr20",57098037,57098054,18,76,93,187
"14710","chr20",57255800,57255838,39,64,6,109
"14711","chr20",57265032,57265081,50,63,73,186
"14712","chr20",57266663,57266683,21,124,43,188
"14713","chr20",57316415,57316452,38,6,11,55
"14714","chr20",57389066,57389084,19,41,17,77
"14715","chr20",57392013,57392047,35,29,9,73
"14716","chr20",57490442,57490468,27,128,6,161
"14717","chr20",57500440,57500457,18,84,55,157
"14718","chr20",57665508,57665525,18,142,41,201
"14719","chr20",57709537,57709554,18,52,5,75
"14720","chr20",57709912,57709939,28,32,24,84
"14721","chr20",57829112,57829143,32,108,105,245
"14722","chr20",57897513,57897544,32,89,48,169
"14723","chr20",57979782,57979807,26,22,15,63
"14724","chr20",58181099,58181136,38,6,26,70
"14725","chr20",58214819,58214844,26,76,8,110
"14726","chr20",58291827,58291851,25,8,44,77
"14727","chr20",58307603,58307625,23,16,76,115
"14728","chr20",58324866,58324888,23,136,74,233
"14729","chr20",58389208,58389234,27,32,34,93
"14730","chr20",58405453,58405479,27,75,77,179
"14731","chr20",58535733,58535759,27,72,72,171
"14732","chr20",58564999,58565048,50,76,136,262
"14733","chr20",58692793,58692882,90,75,16,181
"14734","chr20",58701243,58701271,29,72,130,231
"14735","chr20",58701307,58701337,31,138,66,235
"14736","chr20",58840433,58840500,68,105,7,180
"14737","chr20",58890155,58890216,62,31,60,153
"14738","chr20",58891241,58891263,23,33,17,73
"14739","chr20",58891272,58891292,21,62,4,87
"14740","chr20",58891398,58891420,23,112,133,268
"14741","chr20",58891680,58891726,47,39,93,179
"14742","chr20",58892124,58892151,28,13,39,80
"14743","chr20",58892219,58892236,18,98,37,153
"14744","chr20",58945629,58945650,22,38,6,66
"14745","chr20",58983436,58983453,18,18,11,47
"14746","chr20",59000829,59000847,19,76,145,240
"14747","chr20",59128762,59128779,18,76,99,193
"14748","chr20",59300368,59300395,28,26,45,99
"14749","chr20",59577317,59577334,18,4,69,91
"14750","chr20",59604878,59604899,22,42,57,121
"14751","chr20",59819537,59819563,27,64,123,214
"14752","chr20",60875605,60875672,68,71,54,193
"14753","chr20",61127993,61128034,42,5,34,81
"14754","chr20",61185510,61185560,51,7,109,167
"14755","chr20",61252403,61252467,65,9,31,105
"14756","chr20",61765574,61765593,20,38,94,152
"14757","chr20",61811683,61811700,18,19,99,136
"14758","chr20",61843457,61843478,22,42,119,183
"14759","chr20",62020169,62020187,19,62,138,219
"14760","chr20",62023748,62023770,23,109,74,206
"14761","chr20",62023768,62023786,19,125,54,198
"14762","chr20",62065254,62065302,49,59,4,112
"14763","chr20",62092673,62092694,22,12,72,106
"14764","chr20",62220118,62220136,19,33,26,78
"14765","chr20",62220336,62220374,39,48,1,88
"14766","chr20",62238736,62238756,21,13,45,79
"14767","chr20",62268050,62268070,21,29,143,193
"14768","chr20",62277256,62277274,19,20,1,40
"14769","chr20",62290723,62290755,33,8,7,48
"14770","chr20",62294934,62294969,36,75,33,144
"14771","chr20",62334754,62334783,30,21,11,62
"14772","chr20",62378992,62379024,33,8,15,56
"14773","chr20",62460405,62460424,20,115,59,194
"14774","chr20",62471164,62471181,18,104,137,259
"14775","chr20",62476871,62476974,104,140,37,281
"14776","chr20",62477016,62477167,152,140,119,411
"14777","chr20",62477306,62477340,35,9,22,66
"14778","chr20",62533661,62533678,18,127,132,277
"14779","chr20",62550498,62550525,28,7,68,103
"14780","chr20",62564703,62564740,38,2,112,152
"14781","chr20",62578966,62579948,983,35,42,1060
"14782","chr20",62582375,62582404,30,129,67,226
"14783","chr20",62608530,62608553,24,74,7,105
"14784","chr20",62653448,62653466,19,37,89,145
"14785","chr20",62691234,62691262,29,8,26,63
"14786","chr20",62692626,62692669,44,126,36,206
"14787","chr20",62794304,62794351,48,41,26,115
"14788","chr20",62796718,62796735,18,2,5,25
"14789","chr20",62805393,62805429,37,40,3,80
"14790","chr20",62816974,62816994,21,12,18,51
"14791","chr20",62817005,62817035,31,29,9,69
"14792","chr20",62817091,62817112,22,41,1,64
"14793","chr20",62860956,62860982,27,5,32,64
"14794","chr20",62861163,62861181,19,119,28,166
"14795","chr20",62926247,62926275,29,9,105,143
"14796","chr20",62936557,62936583,27,147,4,178
"14797","chr20",62938093,62938129,37,5,32,74
"14798","chr20",62980991,62981013,23,25,103,151
"14799","chr20",63002719,63002751,33,144,147,324
"14800","chr20",63003624,63003645,22,35,67,124
"14801","chr20",63006809,63006828,20,139,97,256
"14802","chr20",63007122,63007148,27,86,37,150
"14803","chr20",63063313,63063356,44,22,129,195
"14804","chr20",63074174,63074192,19,58,23,100
"14805","chr20",63177602,63177625,24,63,70,157
"14806","chr20",63216114,63216152,39,93,19,151
"14807","chr20",63228078,63228097,20,10,141,171
"14808","chr20",63292597,63292628,32,59,49,140
"14809","chr20",63351079,63351239,161,74,20,255
"14810","chr20",63359870,63359929,60,116,28,204
"14811","chr20",63361393,63361443,51,3,36,90
"14812","chr20",63373595,63373620,26,60,141,227
"14813","chr20",63427224,63427249,26,37,4,67
"14814","chr20",63472747,63473039,293,51,74,418
"14815","chr20",63481211,63481236,26,19,4,49
"14816","chr20",63488215,63488236,22,42,137,201
"14817","chr20",63626986,63627043,58,50,107,215
"14818","chr20",63630100,63630128,29,133,118,280
"14819","chr20",63634398,63634419,22,58,7,87
"14820","chr20",63641889,63641949,61,9,69,139
"14821","chr20",63685046,63685064,19,68,142,229
"14822","chr20",63739711,63739774,64,17,3,84
"14823","chr20",63739828,63739854,27,10,33,70
"14824","chr20",63740224,63740250,27,66,49,142
"14825","chr20",63774690,63774721,32,8,91,131
"14826","chr20",63785225,63785269,45,3,13,61
"14827","chr20",63808977,63809018,42,94,7,143
"14828","chr20",63830953,63830976,24,43,47,114
"14829","chr20",63831226,63831252,27,17,8,52
"14830","chr20",63849689,63849733,45,42,6,93
"14831","chr20",63853352,63853390,39,89,6,134
"14832","chr20",63855478,63855506,29,3,10,42
"14833","chr20",63895148,63895181,34,42,60,136
"14834","chr20",63895195,63895215,21,76,13,110
"14835","chr20",63895291,63895321,31,1,32,64
"14836","chr20",63895542,63895562,21,45,31,97
"14837","chr20",63909506,63909528,23,141,3,167
"14838","chr20",63945505,63945522,18,36,72,126
"14839","chr20",63953381,63953404,24,132,4,160
"14840","chr20",63969836,63969862,27,124,24,175
"14841","chr20",63970012,63970051,40,79,27,146
"14842","chr20",64026507,64026524,18,135,5,158
"14843","chr20",64061097,64061119,23,9,3,35
"14844","chr20",64080032,64080060,29,45,23,97
"14845","chr20",64083738,64083758,21,15,16,52
"14846","chr20",64105505,64105737,233,27,119,379
"14847","chr20",64139625,64139648,24,110,44,178
"14848","chr20",64153406,64153914,509,97,113,719
"14849","chr20",64255724,64255749,26,44,7,77
"14850","chr20",64255876,64255896,21,67,130,218
"14851","chr20",64318679,64318702,24,25,35,84
"14852","chr21",5022469,5022493,25,1,45,71
"14853","chr21",5103299,5103327,29,139,30,198
"14854","chr21",5129000,5129018,19,125,22,166
"14855","chr21",5613671,5613716,46,70,27,143
"14856","chr21",6056315,6056338,24,7,106,137
"14857","chr21",6111063,6111098,36,10,55,101
"14858","chr21",6111257,6111291,35,98,18,151
"14859","chr21",6123116,6123138,23,115,101,239
"14860","chr21",6154677,6154694,18,75,15,108
"14861","chr21",6430997,6431015,19,22,23,64
"14862","chr21",6554853,6554874,22,77,34,133
"14863","chr21",6815589,6815611,23,117,104,244
"14864","chr21",6858862,6858884,23,21,22,66
"14865","chr21",7108897,7108942,46,70,27,143
"14866","chr21",7490675,7490720,46,70,27,143
"14867","chr21",7647685,7647730,46,29,68,143
"14868","chr21",8209497,8209540,44,96,44,184
"14869","chr21",8211687,8211712,26,88,103,217
"14870","chr21",8211690,8211716,27,92,100,219
"14871","chr21",8212229,8212250,22,60,8,90
"14872","chr21",8213132,8213158,27,9,23,59
"14873","chr21",8213570,8213588,19,5,19,43
"14874","chr21",8214651,8214672,22,17,14,53
"14875","chr21",8214735,8214772,38,50,15,103
"14876","chr21",8216067,8216127,61,77,39,177
"14877","chr21",8217266,8217300,35,26,14,75
"14878","chr21",8217358,8217386,29,77,116,222
"14879","chr21",8237002,8237075,74,136,77,287
"14880","chr21",8244315,8244369,55,6,39,100
"14881","chr21",8244709,8244732,24,50,89,163
"14882","chr21",8246058,8246145,88,18,3,109
"14883","chr21",8253712,8253751,40,96,43,179
"14884","chr21",8255893,8255918,26,88,103,217
"14885","chr21",8255896,8255922,27,92,100,219
"14886","chr21",8256437,8256458,22,60,8,90
"14887","chr21",8257342,8257371,30,9,22,61
"14888","chr21",8257784,8257802,19,13,17,49
"14889","chr21",8258874,8258895,22,11,14,47
"14890","chr21",8258958,8259001,44,50,15,109
"14891","chr21",8260296,8260356,61,77,39,177
"14892","chr21",8392532,8392575,44,96,43,183
"14893","chr21",8394722,8394747,26,88,103,217
"14894","chr21",8394725,8394751,27,92,100,219
"14895","chr21",8395264,8395285,22,60,8,90
"14896","chr21",8396167,8396193,27,10,23,60
"14897","chr21",8396602,8396620,19,13,17,49
"14898","chr21",8397688,8397709,22,20,15,57
"14899","chr21",8397769,8397806,38,50,19,107
"14900","chr21",8399101,8399161,61,77,39,177
"14901","chr21",8400301,8400335,35,23,14,72
"14902","chr21",8400393,8400424,32,77,116,225
"14903","chr21",8402454,8402502,49,37,5,91
"14904","chr21",8419405,8419478,74,136,77,287
"14905","chr21",8427339,8427393,55,6,39,100
"14906","chr21",8427733,8427756,24,50,89,163
"14907","chr21",8429082,8429169,88,18,3,109
"14908","chr21",8436746,8436785,40,96,43,179
"14909","chr21",8438935,8438960,26,88,103,217
"14910","chr21",8438938,8438964,27,92,100,219
"14911","chr21",8439479,8439500,22,60,8,90
"14912","chr21",8440383,8440412,30,9,23,62
"14913","chr21",8440821,8440839,19,13,17,49
"14914","chr21",8441909,8441930,22,11,14,47
"14915","chr21",8441993,8442036,44,50,15,109
"14916","chr21",8443297,8443319,23,1,72,96
"14917","chr21",8444536,8444570,35,26,14,75
"14918","chr21",8444628,8444656,29,77,116,222
"14919","chr21",8453336,8453358,23,1,14,38
"14920","chr21",8463967,8464040,74,136,77,287
"14921","chr21",8471900,8471954,55,6,39,100
"14922","chr21",8828774,8828796,23,9,34,66
"14923","chr21",8988039,8988082,44,96,43,183
"14924","chr21",9041504,9041527,24,50,47,121
"14925","chr21",9324658,9324697,40,3,74,117
"14926","chr21",9536189,9536215,27,77,28,132
"14927","chr21",9824912,9824935,24,93,49,166
"14928","chr21",9826317,9826344,28,93,49,170
"14929","chr21",9827726,9827763,38,93,49,180
"14930","chr21",9829141,9829160,20,93,49,162
"14931","chr21",9830542,9830569,28,92,49,169
"14932","chr21",9831952,9831979,28,93,49,170
"14933","chr21",9833357,9833382,26,93,49,168
"14934","chr21",9834762,9834791,30,93,49,172
"14935","chr21",9836169,9836192,24,93,49,166
"14936","chr21",9837570,9837593,24,93,49,166
"14937","chr21",10118947,10118986,40,4,63,107
"14938","chr21",10122556,10122579,24,81,35,140
"14939","chr21",10372357,10372377,21,78,27,126
"14940","chr21",10405054,10405108,55,113,3,171
"14941","chr21",10411696,10411723,28,114,71,213
"14942","chr21",10431007,10431029,23,75,143,241
"14943","chr21",10447391,10447427,37,9,73,119
"14944","chr21",10622951,10622973,23,142,80,245
"14945","chr21",13680622,13680644,23,117,104,244
"14946","chr21",13723880,13723902,23,21,22,66
"14947","chr21",13809599,13809631,33,27,44,104
"14948","chr21",13980341,13980358,18,10,5,33
"14949","chr21",13987158,13987242,85,91,44,220
"14950","chr21",14056452,14056476,25,14,67,106
"14951","chr21",14058277,14058355,79,107,5,191
"14952","chr21",15730357,15730386,30,21,30,81
"14953","chr21",15783794,15783811,18,117,35,170
"14954","chr21",16575534,16575570,37,68,72,177
"14955","chr21",17450859,17450883,25,134,68,227
"14956","chr21",17454010,17454034,25,87,74,186
"14957","chr21",17464192,17464223,32,77,45,154
"14958","chr21",17469208,17469229,22,10,5,37
"14959","chr21",17506599,17506625,27,73,6,106
"14960","chr21",17510413,17510431,19,46,66,131
"14961","chr21",17528069,17528091,23,121,13,157
"14962","chr21",17744946,17744968,23,90,2,115
"14963","chr21",19021449,19021523,75,57,101,233
"14964","chr21",19021522,19021542,21,8,28,57
"14965","chr21",20133811,20133828,18,30,75,123
"14966","chr21",20588087,20588104,18,74,128,220
"14967","chr21",20997933,20998011,79,3,120,202
"14968","chr21",20998315,20998374,60,37,38,135
"14969","chr21",21742583,21742603,21,29,143,193
"14970","chr21",21931300,21931322,23,137,31,191
"14971","chr21",22770117,22770202,86,64,71,221
"14972","chr21",23424170,23424209,40,139,6,185
"14973","chr21",23456923,23456947,25,132,6,163
"14974","chr21",23515888,23515920,33,77,35,145
"14975","chr21",23610549,23610577,29,70,86,185
"14976","chr21",23673696,23673726,31,98,4,133
"14977","chr21",23861759,23861784,26,61,73,160
"14978","chr21",23904931,23904948,18,29,78,125
"14979","chr21",24646191,24646212,22,12,56,90
"14980","chr21",24905907,24905925,19,145,26,190
"14981","chr21",25061130,25061170,41,75,12,128
"14982","chr21",25559376,25559403,28,11,99,138
"14983","chr21",25787826,25787844,19,7,74,100
"14984","chr21",25866707,25866744,38,33,76,147
"14985","chr21",25875445,25875478,34,110,5,149
"14986","chr21",25900563,25900581,19,9,71,99
"14987","chr21",26017199,26017218,20,33,6,59
"14988","chr21",26286780,26286813,34,37,106,177
"14989","chr21",26334945,26334988,44,9,121,174
"14990","chr21",27348109,27348131,23,77,35,135
"14991","chr21",28058283,28058309,27,91,127,245
"14992","chr21",28134252,28134269,18,29,146,193
"14993","chr21",28988142,28988169,28,136,74,238
"14994","chr21",29009393,29009411,19,7,5,31
"14995","chr21",29229794,29229830,37,144,67,248
"14996","chr21",30017215,30017234,20,77,81,178
"14997","chr21",30060508,30060542,35,10,40,85
"14998","chr21",30226492,30226527,36,145,31,212
"14999","chr21",30394202,30394225,24,77,77,178
"15000","chr21",30570604,30570643,40,35,78,153
"15001","chr21",30755189,30755224,36,39,137,212
"15002","chr21",31184103,31184121,19,73,88,180
"15003","chr21",31309463,31309490,28,43,1,72
"15004","chr21",31336489,31336509,21,69,6,96
"15005","chr21",31337501,31337547,47,7,119,173
"15006","chr21",31516108,31516125,18,8,119,145
"15007","chr21",31585776,31585795,20,145,25,190
"15008","chr21",31641109,31641147,39,9,113,161
"15009","chr21",31647336,31647364,29,147,73,249
"15010","chr21",31719291,31719322,32,53,5,90
"15011","chr21",31732281,31732307,27,6,6,39
"15012","chr21",31914409,31914437,29,146,4,179
"15013","chr21",32151245,32151268,24,145,27,196
"15014","chr21",32273108,32273130,23,65,81,169
"15015","chr21",32437159,32437182,24,84,7,115
"15016","chr21",32592638,32592665,28,7,9,44
"15017","chr21",32611319,32611426,108,23,59,190
"15018","chr21",32614237,32614271,35,9,9,53
"15019","chr21",32810422,32810442,21,37,76,134
"15020","chr21",33025855,33025878,24,59,39,122
"15021","chr21",33070371,33070423,53,41,67,161
"15022","chr21",33109001,33109028,28,75,137,240
"15023","chr21",33166153,33166208,56,68,132,256
"15024","chr21",33403342,33403378,37,22,34,93
"15025","chr21",33498111,33498148,38,14,74,126
"15026","chr21",33503184,33503220,37,76,7,120
"15027","chr21",33580889,33580922,34,70,116,220
"15028","chr21",33604356,33604379,24,77,74,175
"15029","chr21",33610728,33610751,24,10,29,63
"15030","chr21",33682519,33682540,22,70,7,99
"15031","chr21",33704924,33704947,24,81,36,141
"15032","chr21",33874157,33874178,22,75,73,170
"15033","chr21",33881407,33881428,22,108,6,136
"15034","chr21",33984663,33984689,27,27,60,114
"15035","chr21",34029558,34029597,40,30,73,143
"15036","chr21",34366975,34367015,41,62,10,113
"15037","chr21",35160646,35160698,53,100,42,195
"15038","chr21",36041160,36041190,31,127,74,232
"15039","chr21",36058718,36058741,24,32,73,129
"15040","chr21",36063447,36063488,42,10,3,55
"15041","chr21",36114246,36114265,20,77,51,148
"15042","chr21",36130023,36130042,20,7,130,157
"15043","chr21",36130323,36130346,24,146,13,183
"15044","chr21",36130428,36130445,18,69,15,102
"15045","chr21",36138104,36138146,43,57,41,141
"15046","chr21",36159141,36159165,25,9,65,99
"15047","chr21",36258973,36258993,21,18,63,102
"15048","chr21",36262901,36262945,45,140,64,249
"15049","chr21",36272650,36272667,18,112,71,201
"15050","chr21",36308874,36308908,35,5,89,129
"15051","chr21",36353756,36353777,22,88,135,245
"15052","chr21",36404416,36404450,35,43,128,206
"15053","chr21",36492441,36492468,28,66,67,161
"15054","chr21",36523760,36523843,84,74,62,220
"15055","chr21",36707943,36707968,26,31,27,84
"15056","chr21",36709809,36709844,36,74,99,209
"15057","chr21",36827798,36827831,34,76,27,137
"15058","chr21",36911749,36911772,24,133,6,163
"15059","chr21",36933552,36933572,21,18,5,44
"15060","chr21",36956732,36956761,30,3,4,37
"15061","chr21",36958066,36958094,29,146,33,208
"15062","chr21",36973992,36974010,19,35,5,59
"15063","chr21",37007401,37007426,26,8,102,136
"15064","chr21",37008757,37008780,24,9,75,108
"15065","chr21",37030999,37031113,115,24,44,183
"15066","chr21",37073297,37073317,21,35,143,199
"15067","chr21",37175264,37175286,23,128,74,225
"15068","chr21",37324137,37324197,61,7,145,213
"15069","chr21",37366402,37366426,25,44,25,94
"15070","chr21",37367002,37367028,27,114,51,192
"15071","chr21",37367637,37367663,27,12,12,51
"15072","chr21",37367944,37367978,35,4,1,40
"15073","chr21",37368104,37368122,19,9,80,108
"15074","chr21",37493934,37493954,21,148,83,252
"15075","chr21",37781870,37781888,19,9,99,127
"15076","chr21",38507527,38507562,36,148,67,251
"15077","chr21",38744521,38744546,26,8,21,55
"15078","chr21",38972679,38972704,26,132,67,225
"15079","chr21",39095165,39095182,18,29,16,63
"15080","chr21",39313590,39313614,25,20,22,67
"15081","chr21",39332562,39332594,33,74,63,170
"15082","chr21",39844867,39844886,20,63,3,86
"15083","chr21",39909787,39909812,26,75,3,104
"15084","chr21",40383333,40383364,32,69,1,102
"15085","chr21",40536401,40536419,19,76,140,235
"15086","chr21",40792138,40792158,21,128,123,272
"15087","chr21",40818103,40818128,26,11,67,104
"15088","chr21",40846761,40846798,38,4,66,108
"15089","chr21",40883661,40883695,35,68,74,177
"15090","chr21",41156397,41156419,23,92,9,124
"15091","chr21",41204184,41204218,35,33,75,143
"15092","chr21",41303855,41303885,31,128,92,251
"15093","chr21",41383362,41383380,19,53,4,76
"15094","chr21",41496830,41496857,28,7,33,68
"15095","chr21",41508116,41508138,23,126,20,169
"15096","chr21",41508253,41508270,18,19,60,97
"15097","chr21",41565996,41566018,23,67,50,140
"15098","chr21",41726444,41726543,100,33,100,233
"15099","chr21",41954023,41954043,21,2,103,126
"15100","chr21",42161052,42161128,77,135,5,217
"15101","chr21",42217680,42217709,30,125,70,225
"15102","chr21",42219223,42219254,32,75,1,108
"15103","chr21",42243815,42243836,22,8,43,73
"15104","chr21",42342753,42342803,51,74,85,210
"15105","chr21",42513726,42513750,25,13,40,78
"15106","chr21",42653523,42653556,34,2,5,41
"15107","chr21",42653598,42653624,27,102,121,250
"15108","chr21",42792838,42792861,24,33,77,134
"15109","chr21",42912892,42912914,23,77,6,106
"15110","chr21",42930946,42930978,33,73,24,130
"15111","chr21",42935842,42935861,20,26,74,120
"15112","chr21",42956379,42956397,19,138,72,229
"15113","chr21",42974739,42974771,33,19,146,198
"15114","chr21",42981528,42981577,50,86,3,139
"15115","chr21",42988049,42988072,24,77,14,115
"15116","chr21",42994032,42994053,22,71,11,104
"15117","chr21",43039328,43039346,19,22,23,64
"15118","chr21",43163175,43163192,18,77,34,129
"15119","chr21",43173710,43173791,82,22,38,142
"15120","chr21",43383576,43383593,18,17,73,108
"15121","chr21",43415123,43415145,23,103,113,239
"15122","chr21",43426971,43427005,35,20,96,151
"15123","chr21",43427164,43427199,36,57,8,101
"15124","chr21",43482225,43482248,24,108,5,137
"15125","chr21",43718883,43718910,28,28,47,103
"15126","chr21",43719206,43719238,33,31,9,73
"15127","chr21",43749088,43749120,33,6,64,103
"15128","chr21",43751555,43751580,26,61,28,115
"15129","chr21",43787843,43787863,21,50,127,198
"15130","chr21",43823565,43823582,18,42,6,66
"15131","chr21",43830423,43830445,23,58,1,82
"15132","chr21",43856394,43856425,32,47,51,130
"15133","chr21",43856425,43856456,32,78,20,130
"15134","chr21",43909293,43909313,21,8,1,30
"15135","chr21",43978280,43978318,39,42,22,103
"15136","chr21",44095560,44095578,19,42,123,184
"15137","chr21",44133034,44133052,19,24,123,166
"15138","chr21",44158590,44158623,34,32,61,127
"15139","chr21",44210766,44211441,676,1,123,800
"15140","chr21",44264588,44264616,29,76,2,107
"15141","chr21",44265562,44265608,47,77,49,173
"15142","chr21",44293942,44294336,395,143,101,639
"15143","chr21",44303434,44303455,22,145,50,217
"15144","chr21",44338763,44338782,20,12,26,58
"15145","chr21",44351137,44351161,25,19,140,184
"15146","chr21",44408655,44408675,21,76,12,109
"15147","chr21",44505076,44505095,20,7,54,81
"15148","chr21",44722424,44722448,25,25,75,125
"15149","chr21",44932120,44932166,47,116,99,262
"15150","chr21",45018905,45018929,25,51,23,99
"15151","chr21",45074599,45074631,33,58,38,129
"15152","chr21",45287191,45287221,31,121,25,177
"15153","chr21",45311875,45311929,55,71,120,246
"15154","chr21",45343991,45344029,39,12,72,123
"15155","chr21",45472219,45472241,23,76,124,223
"15156","chr21",45555639,45555659,21,20,130,171
"15157","chr21",45590979,45591007,29,45,16,90
"15158","chr21",45683924,45683949,26,16,9,51
"15159","chr21",45973636,45973660,25,29,5,59
"15160","chr21",46099456,46099482,27,137,6,170
"15161","chr21",46210064,46210084,21,76,79,176
"15162","chr21",46278990,46279007,18,101,127,246
"15163","chr21",46304021,46304044,24,8,41,73
"15164","chr21",46375156,46375173,18,95,55,168
"15165","chr21",46426070,46426096,27,119,1,147
"15166","chr21",46459198,46459215,18,26,41,85
"15167","chr22",10673620,10673644,25,8,61,94
"15168","chr22",10850521,10850552,32,45,21,98
"15169","chr22",10852059,10852093,35,67,41,143
"15170","chr22",11057803,11057847,45,110,3,158
"15171","chr22",11264212,11264252,41,96,120,257
"15172","chr22",11266079,11266804,726,11,6,743
"15173","chr22",11268895,11268966,72,52,104,228
"15174","chr22",11271446,11271481,36,111,13,160
"15175","chr22",11278066,11278149,84,7,1,92
"15176","chr22",11284863,11284920,58,86,13,157
"15177","chr22",11598611,11598675,65,37,39,141
"15178","chr22",11612371,11612390,20,30,128,178
"15179","chr22",11612390,11612427,38,15,109,162
"15180","chr22",11720378,11720401,24,9,34,67
"15181","chr22",12168764,12168813,50,49,50,149
"15182","chr22",15238130,15238150,21,84,73,178
"15183","chr22",15879943,15879979,37,45,21,103
"15184","chr22",15881481,15881515,35,67,41,143
"15185","chr22",16107033,16107057,25,69,41,135
"15186","chr22",16561858,16561876,19,24,72,115
"15187","chr22",16562081,16562100,20,24,72,116
"15188","chr22",16588459,16588481,23,77,3,103
"15189","chr22",16596000,16596043,44,10,38,92
"15190","chr22",16596862,16596884,23,32,71,126
"15191","chr22",16598390,16598409,20,8,12,40
"15192","chr22",16601255,16601278,24,134,33,191
"15193","chr22",16601845,16601870,26,53,42,121
"15194","chr22",16601989,16602013,25,32,30,87
"15195","chr22",16919678,16919696,19,69,23,111
"15196","chr22",17062966,17062996,31,45,1,77
"15197","chr22",17078855,17078874,20,143,118,281
"15198","chr22",17120744,17120775,32,95,47,174
"15199","chr22",17120969,17120990,22,22,12,56
"15200","chr22",17121371,17121394,24,138,37,199
"15201","chr22",17226828,17226864,37,91,73,201
"15202","chr22",17238334,17238356,23,144,2,169
"15203","chr22",17276056,17276084,29,22,74,125
"15204","chr22",17292167,17292184,18,76,38,132
"15205","chr22",17322516,17322553,38,9,5,52
"15206","chr22",17351648,17351667,20,8,9,37
"15207","chr22",17356019,17356067,49,18,6,73
"15208","chr22",17369346,17369371,26,51,102,179
"15209","chr22",17369555,17369574,20,113,33,166
"15210","chr22",17404369,17404391,23,8,9,40
"15211","chr22",17421615,17421643,29,77,74,180
"15212","chr22",17482116,17482141,26,12,6,44
"15213","chr22",17524388,17524410,23,8,140,171
"15214","chr22",17543108,17543147,40,5,7,52
"15215","chr22",17605206,17605243,38,60,73,171
"15216","chr22",17609092,17609137,46,35,69,150
"15217","chr22",17609465,17609486,22,8,53,83
"15218","chr22",17616031,17616065,35,147,125,307
"15219","chr22",17630581,17630608,28,76,142,246
"15220","chr22",17757403,17757426,24,12,74,110
"15221","chr22",17760134,17760152,19,136,6,161
"15222","chr22",17768873,17768892,20,145,6,171
"15223","chr22",17784787,17784819,33,87,5,125
"15224","chr22",17801908,17801927,20,105,60,185
"15225","chr22",17959011,17959033,23,8,139,170
"15226","chr22",18127693,18127713,21,6,145,172
"15227","chr22",18137628,18137659,32,23,6,61
"15228","chr22",18149920,18149942,23,54,43,120
"15229","chr22",18163645,18163684,40,88,72,200
"15230","chr22",18219881,18219898,18,20,53,91
"15231","chr22",18350375,18350403,29,97,80,206
"15232","chr22",18404732,18404749,18,55,18,91
"15233","chr22",18511997,18512025,29,82,95,206
"15234","chr22",18604665,18604684,20,136,74,230
"15235","chr22",18622006,18622035,30,76,75,181
"15236","chr22",18715134,18715151,18,20,53,91
"15237","chr22",18769318,18769346,29,82,95,206
"15238","chr22",18845803,18845823,21,46,6,73
"15239","chr22",18936336,18936370,35,48,30,113
"15240","chr22",19487293,19487311,19,52,24,95
"15241","chr22",19586737,19586773,37,84,2,123
"15242","chr22",19596348,19596365,18,76,136,230
"15243","chr22",19714470,19714488,19,1,83,103
"15244","chr22",19714758,19714777,20,38,117,175
"15245","chr22",19717641,19717666,26,83,79,188
"15246","chr22",19717871,19717897,27,20,13,60
"15247","chr22",19745035,19745061,27,73,61,161
"15248","chr22",19759417,19759436,20,102,141,263
"15249","chr22",19760609,19760641,33,41,62,136
"15250","chr22",19760692,19760711,20,1,8,29
"15251","chr22",19761029,19761077,49,34,74,157
"15252","chr22",19766763,19766807,45,33,22,100
"15253","chr22",19768954,19768978,25,8,133,166
"15254","chr22",19898511,19898532,22,8,11,41
"15255","chr22",19951359,19951377,19,59,6,84
"15256","chr22",20016681,20016707,27,1,23,51
"15257","chr22",20041313,20041330,18,76,76,170
"15258","chr22",20044528,20044551,24,59,72,155
"15259","chr22",20131821,20131845,25,34,13,72
"15260","chr22",20164815,20164846,32,58,74,164
"15261","chr22",20417250,20417268,19,49,72,140
"15262","chr22",20418268,20418286,19,38,66,123
"15263","chr22",20437654,20437674,21,11,12,44
"15264","chr22",20437757,20437797,41,1,34,76
"15265","chr22",20474387,20474405,19,4,62,85
"15266","chr22",20505877,20505898,22,92,75,189
"15267","chr22",20598516,20598538,23,34,84,141
"15268","chr22",20688898,20688923,26,47,4,77
"15269","chr22",20693361,20693384,24,71,71,166
"15270","chr22",20731930,20731951,22,4,73,99
"15271","chr22",20858673,20858704,32,44,136,212
"15272","chr22",20860358,20860386,29,9,7,45
"15273","chr22",20916551,20916596,46,10,70,126
"15274","chr22",20916612,20916686,75,100,9,184
"15275","chr22",20918950,20918976,27,109,85,221
"15276","chr22",20961164,20961186,23,9,5,37
"15277","chr22",21004775,21004795,21,72,81,174
"15278","chr22",21006252,21006278,27,74,140,241
"15279","chr22",21006430,21006447,18,79,75,172
"15280","chr22",21050981,21051006,26,36,124,186
"15281","chr22",21128745,21128767,23,8,44,75
"15282","chr22",21130213,21130233,21,8,37,66
"15283","chr22",21151665,21151682,18,55,18,91
"15284","chr22",21203565,21203593,29,82,95,206
"15285","chr22",21280294,21280314,21,39,6,66
"15286","chr22",21340915,21340932,18,20,53,91
"15287","chr22",21373251,21373279,29,77,74,180
"15288","chr22",21390608,21390629,22,76,135,233
"15289","chr22",21411954,21411972,19,12,71,102
"15290","chr22",21454292,21454314,23,8,128,159
"15291","chr22",21458133,21458160,28,95,11,134
"15292","chr22",21522914,21522931,18,73,10,101
"15293","chr22",21544205,21544227,23,137,74,234
"15294","chr22",21557946,21557971,26,121,20,167
"15295","chr22",21562362,21562389,28,76,75,179
"15296","chr22",21565755,21565784,30,40,72,142
"15297","chr22",21575632,21575659,28,6,31,65
"15298","chr22",21600316,21600343,28,77,3,108
"15299","chr22",21612627,21612671,45,86,9,140
"15300","chr22",21644775,21644797,23,8,135,166
"15301","chr22",21715509,21715531,23,8,59,90
"15302","chr22",21715745,21715780,36,75,79,190
"15303","chr22",21783182,21783201,20,76,63,159
"15304","chr22",21814846,21814911,66,125,59,250
"15305","chr22",21851644,21851665,22,26,8,56
"15306","chr22",21867419,21867438,20,26,10,56
"15307","chr22",21867648,21867670,23,56,43,122
"15308","chr22",21869884,21869901,18,145,17,180
"15309","chr22",21870030,21870049,20,77,27,124
"15310","chr22",21874488,21874508,21,8,37,66
"15311","chr22",21931503,21931530,28,76,17,121
"15312","chr22",22320093,22320112,20,9,74,103
"15313","chr22",22476112,22476135,24,6,18,48
"15314","chr22",22530199,22530222,24,61,8,93
"15315","chr22",22532760,22532820,61,73,46,180
"15316","chr22",22652228,22652250,23,97,80,200
"15317","chr22",23070357,23070396,40,15,22,77
"15318","chr22",23070507,23070532,26,51,52,129
"15319","chr22",23180833,23180850,18,30,77,125
"15320","chr22",23402667,23402694,28,73,21,122
"15321","chr22",23449522,23449539,18,64,74,156
"15322","chr22",23457116,23457134,19,10,50,79
"15323","chr22",23506800,23506822,23,81,1,105
"15324","chr22",23522559,23522599,41,15,6,62
"15325","chr22",23525563,23525588,26,58,121,205
"15326","chr22",23527786,23527833,48,43,85,176
"15327","chr22",23537525,23537548,24,17,108,149
"15328","chr22",23593795,23593826,32,75,46,153
"15329","chr22",23631416,23631453,38,69,9,116
"15330","chr22",23657001,23657023,23,74,100,197
"15331","chr22",23661405,23661423,19,121,136,276
"15332","chr22",23722053,23722070,18,145,74,237
"15333","chr22",23734008,23734028,21,78,21,120
"15334","chr22",23749349,23749381,33,148,42,223
"15335","chr22",23761021,23761060,40,104,6,150
"15336","chr22",23777567,23777585,19,78,6,103
"15337","chr22",23807962,23807979,18,14,143,175
"15338","chr22",23850025,23850061,37,7,77,121
"15339","chr22",23916792,23916840,49,134,14,197
"15340","chr22",24011077,24011134,58,7,124,189
"15341","chr22",24015271,24015294,24,8,1,33
"15342","chr22",24042819,24042877,59,55,121,235
"15343","chr22",24156091,24156139,49,1,8,58
"15344","chr22",24167086,24167106,21,102,57,180
"15345","chr22",24197215,24197237,23,51,73,147
"15346","chr22",24250869,24250887,19,37,6,62
"15347","chr22",24270220,24270378,159,112,40,311
"15348","chr22",24424362,24424390,29,10,60,99
"15349","chr22",24521478,24521506,29,25,11,65
"15350","chr22",24593787,24593814,28,16,6,50
"15351","chr22",24659876,24659897,22,8,40,70
"15352","chr22",24661337,24661360,24,76,40,140
"15353","chr22",24702447,24702465,19,9,120,148
"15354","chr22",24740052,24740069,18,145,5,168
"15355","chr22",24774837,24774859,23,85,44,152
"15356","chr22",24784979,24785015,37,8,11,56
"15357","chr22",24795137,24795179,43,71,36,150
"15358","chr22",24795640,24795665,26,93,6,125
"15359","chr22",24799341,24799358,18,122,123,263
"15360","chr22",24801194,24801241,48,3,75,126
"15361","chr22",24881193,24881212,20,75,6,101
"15362","chr22",24892885,24892903,19,69,35,123
"15363","chr22",24973390,24973416,27,13,16,56
"15364","chr22",24979329,24979361,33,115,132,280
"15365","chr22",24981063,24981089,27,43,129,199
"15366","chr22",25031024,25031060,37,92,68,197
"15367","chr22",25033575,25033598,24,10,90,124
"15368","chr22",25052715,25052733,19,75,58,152
"15369","chr22",25111761,25111787,27,113,34,174
"15370","chr22",25282866,25282889,24,2,50,76
"15371","chr22",25316411,25316435,25,15,77,117
"15372","chr22",25400263,25400281,19,7,141,167
"15373","chr22",25405326,25405348,23,5,3,31
"15374","chr22",25408569,25408587,19,99,6,124
"15375","chr22",25420849,25420904,56,135,33,224
"15376","chr22",25446449,25446475,27,80,6,113
"15377","chr22",25647021,25647058,38,38,74,150
"15378","chr22",25670882,25670904,23,77,44,144
"15379","chr22",25673009,25673029,21,26,145,192
"15380","chr22",25695836,25695855,20,80,143,243
"15381","chr22",25708082,25708099,18,146,23,187
"15382","chr22",26023469,26023535,67,58,37,162
"15383","chr22",26327214,26327713,500,44,96,640
"15384","chr22",26360884,26360917,34,92,20,146
"15385","chr22",26429330,26429358,29,8,9,46
"15386","chr22",26429604,26429629,26,67,5,98
"15387","chr22",26462127,26462144,18,102,5,125
"15388","chr22",26517143,26517191,49,127,9,185
"15389","chr22",26546077,26546102,26,113,34,173
"15390","chr22",26566552,26566594,43,24,43,110
"15391","chr22",26590191,26590210,20,79,56,155
"15392","chr22",26760238,26760269,32,87,37,156
"15393","chr22",27484917,27484943,27,85,49,161
"15394","chr22",27490683,27490731,49,24,6,79
"15395","chr22",27556253,27556280,28,145,59,232
"15396","chr22",27734887,27734915,29,77,13,119
"15397","chr22",27786843,27786865,23,42,128,193
"15398","chr22",27798893,27798974,82,67,19,168
"15399","chr22",27923007,27923043,37,6,8,51
"15400","chr22",27942940,27942964,25,10,6,41
"15401","chr22",27994451,27994468,18,131,114,263
"15402","chr22",28536199,28536220,22,25,74,121
"15403","chr22",28660495,28660540,46,7,141,194
"15404","chr22",28702538,28702556,19,68,145,232
"15405","chr22",28707831,28707852,22,6,78,106
"15406","chr22",28720093,28720110,18,10,29,57
"15407","chr22",28770859,28770895,37,5,68,110
"15408","chr22",28773063,28773092,30,10,10,50
"15409","chr22",28800229,28800252,24,22,43,89
"15410","chr22",28842105,28842126,22,132,15,169
"15411","chr22",28877287,28877305,19,7,3,29
"15412","chr22",28883651,28883669,19,2,62,83
"15413","chr22",28883804,28883881,78,2,57,137
"15414","chr22",28896117,28896151,35,75,144,254
"15415","chr22",28927393,28927411,19,130,34,183
"15416","chr22",28941959,28941989,31,8,26,65
"15417","chr22",29027226,29027263,38,73,109,220
"15418","chr22",29057961,29057978,18,29,143,190
"15419","chr22",29068251,29068273,23,39,73,135
"15420","chr22",29165175,29165195,21,50,4,75
"15421","chr22",29177493,29177533,41,76,8,125
"15422","chr22",29310243,29310281,39,90,5,134
"15423","chr22",29389686,29389715,30,25,6,61
"15424","chr22",29406116,29406156,41,71,67,179
"15425","chr22",29418497,29418517,21,8,14,43
"15426","chr22",29450221,29450249,29,59,4,92
"15427","chr22",29460928,29460948,21,147,125,293
"15428","chr22",29508958,29508985,28,49,80,157
"15429","chr22",29639882,29639907,26,140,6,172
"15430","chr22",29720009,29720026,18,22,23,63
"15431","chr22",29736720,29736742,23,10,6,39
"15432","chr22",29838204,29838228,25,23,78,126
"15433","chr22",29906246,29906289,44,19,27,90
"15434","chr22",29965686,29965708,23,19,73,115
"15435","chr22",30039365,30039385,21,115,6,142
"15436","chr22",30201413,30201434,22,7,104,133
"15437","chr22",30246390,30246443,54,52,40,146
"15438","chr22",30277394,30277436,43,13,19,75
"15439","chr22",30357669,30357687,19,26,143,188
"15440","chr22",30385422,30385441,20,136,6,162
"15441","chr22",30387147,30387164,18,119,62,199
"15442","chr22",30387258,30387282,25,1,55,81
"15443","chr22",30397500,30397522,23,47,92,162
"15444","chr22",30399514,30399537,24,17,75,116
"15445","chr22",30401487,30401528,42,5,32,79
"15446","chr22",30574600,30574636,37,35,6,78
"15447","chr22",30574608,30574644,37,43,50,130
"15448","chr22",30635796,30635835,40,6,113,159
"15449","chr22",30695055,30695077,23,50,114,187
"15450","chr22",30765195,30765227,33,76,138,247
"15451","chr22",30781143,30781161,19,35,75,129
"15452","chr22",30802860,30802882,23,29,7,59
"15453","chr22",30858117,30858158,42,70,37,149
"15454","chr22",30968842,30968901,60,34,10,104
"15455","chr22",31067554,31067573,20,77,129,226
"15456","chr22",31159712,31159729,18,10,122,150
"15457","chr22",31276727,31276745,19,78,23,120
"15458","chr22",31336806,31336828,23,148,6,177
"15459","chr22",31346129,31346146,18,23,74,115
"15460","chr22",31346203,31346252,50,91,45,186
"15461","chr22",31368869,31368894,26,76,2,104
"15462","chr22",31371978,31372033,56,3,81,140
"15463","chr22",31379149,31379174,26,31,82,139
"15464","chr22",31383419,31383438,20,68,58,146
"15465","chr22",31410457,31410479,23,45,72,140
"15466","chr22",31431036,31431053,18,77,127,222
"15467","chr22",31463652,31463673,22,49,36,107
"15468","chr22",31514141,31514163,23,87,124,234
"15469","chr22",31535186,31535203,18,72,98,188
"15470","chr22",31568532,31568556,25,32,3,60
"15471","chr22",31612379,31612399,21,112,125,258
"15472","chr22",31612399,31612427,29,140,105,274
"15473","chr22",31640881,31640904,24,7,145,176
"15474","chr22",31642795,31642821,27,148,34,209
"15475","chr22",31677578,31677605,28,114,6,148
"15476","chr22",31689734,31689760,27,72,146,245
"15477","chr22",31711473,31711499,27,10,72,109
"15478","chr22",31718251,31718273,23,76,122,221
"15479","chr22",31770787,31770809,23,17,50,90
"15480","chr22",31796100,31796118,19,8,75,102
"15481","chr22",31877437,31877467,31,95,6,132
"15482","chr22",31877750,31877774,25,16,74,115
"15483","chr22",31965458,31965496,39,77,39,155
"15484","chr22",32145494,32146794,1301,115,73,1489
"15485","chr22",32147866,32147903,38,54,31,123
"15486","chr22",32285696,32285751,56,5,39,100
"15487","chr22",32605008,32605026,19,33,4,56
"15488","chr22",32676515,32676557,43,11,54,108
"15489","chr22",32744752,32744771,20,20,84,124
"15490","chr22",32962130,32962154,25,9,10,44
"15491","chr22",33181828,33181849,22,17,11,50
"15492","chr22",33395227,33395247,21,52,8,81
"15493","chr22",33416907,33416925,19,77,6,102
"15494","chr22",33664863,33664888,26,24,120,170
"15495","chr22",33731000,33731020,21,76,3,100
"15496","chr22",34333270,34333302,33,91,142,266
"15497","chr22",34339954,34339988,35,9,136,180
"15498","chr22",34701844,34701884,41,135,35,211
"15499","chr22",35161154,35161171,18,77,114,209
"15500","chr22",35366658,35366685,28,76,142,246
"15501","chr22",35371317,35371336,20,147,10,177
"15502","chr22",35400781,35400814,34,53,92,179
"15503","chr22",35406011,35406037,27,132,74,233
"15504","chr22",35573806,35573848,43,73,1,117
"15505","chr22",35677624,35677648,25,65,142,232
"15506","chr22",35825982,35826003,22,91,74,187
"15507","chr22",35881959,35882022,64,116,6,186
"15508","chr22",35951242,35951264,23,9,144,176
"15509","chr22",36028538,36028556,19,70,60,149
"15510","chr22",36028953,36028970,18,23,21,62
"15511","chr22",36034592,36034609,18,65,73,156
"15512","chr22",36098823,36098846,24,99,7,130
"15513","chr22",36115606,36115624,19,66,70,155
"15514","chr22",36122838,36122891,54,50,3,107
"15515","chr22",36227316,36227341,26,124,6,156
"15516","chr22",36404093,36404123,31,61,19,111
"15517","chr22",36414028,36414048,21,14,8,43
"15518","chr22",36420197,36420215,19,22,74,115
"15519","chr22",36425808,36425827,20,21,23,64
"15520","chr22",36425826,36425844,19,38,5,62
"15521","chr22",36464485,36464507,23,5,70,98
"15522","chr22",36481703,36481728,26,77,115,218
"15523","chr22",36484470,36484489,20,127,74,221
"15524","chr22",36488092,36488119,28,88,74,190
"15525","chr22",36494939,36494957,19,64,143,226
"15526","chr22",36577651,36577670,20,121,72,213
"15527","chr22",36581351,36581375,25,33,45,103
"15528","chr22",36703239,36703317,79,32,144,255
"15529","chr22",36742634,36742681,48,75,2,125
"15530","chr22",36979083,36979111,29,53,116,198
"15531","chr22",37036298,37036315,18,77,144,239
"15532","chr22",37060857,37060883,27,21,30,78
"15533","chr22",37206724,37206759,36,141,112,289
"15534","chr22",37267490,37267526,37,9,145,191
"15535","chr22",37285710,37285739,30,33,7,70
"15536","chr22",37373456,37373482,27,51,103,181
"15537","chr22",37425860,37425898,39,93,18,150
"15538","chr22",37427363,37427393,31,4,11,46
"15539","chr22",37444826,37444844,19,49,64,132
"15540","chr22",37445034,37445051,18,145,62,225
"15541","chr22",37446824,37446851,28,76,49,153
"15542","chr22",37485184,37485205,22,4,75,101
"15543","chr22",37515564,37515583,20,111,41,172
"15544","chr22",37584680,37584724,45,75,32,152
"15545","chr22",37615452,37615483,32,147,3,182
"15546","chr22",37640324,37640344,21,37,49,107
"15547","chr22",37652826,37652848,23,142,72,237
"15548","chr22",37663920,37663945,26,73,29,128
"15549","chr22",37682475,37682496,22,77,6,105
"15550","chr22",37707942,37707964,23,147,74,244
"15551","chr22",37708248,37708268,21,12,72,105
"15552","chr22",37720001,37720026,26,7,22,55
"15553","chr22",37721025,37721042,18,29,75,122
"15554","chr22",37737661,37737680,20,107,6,133
"15555","chr22",37746291,37746335,45,31,116,192
"15556","chr22",37749784,37749805,22,117,34,173
"15557","chr22",37780745,37780795,51,7,120,178
"15558","chr22",37781085,37781110,26,6,4,36
"15559","chr22",37794668,37794713,46,72,142,260
"15560","chr22",37794888,37794919,32,76,54,162
"15561","chr22",37802609,37802643,35,52,65,152
"15562","chr22",37805259,37805291,33,4,34,71
"15563","chr22",37820010,37820034,25,79,130,234
"15564","chr22",37826511,37826532,22,5,21,48
"15565","chr22",37841083,37841101,19,111,73,203
"15566","chr22",37841849,37841904,56,135,80,271
"15567","chr22",37848392,37848414,23,9,14,46
"15568","chr22",37883297,37883318,22,32,42,96
"15569","chr22",37912036,37912064,29,104,124,257
"15570","chr22",37914214,37914243,30,7,107,144
"15571","chr22",37919636,37919655,20,97,6,123
"15572","chr22",37922578,37922602,25,51,30,106
"15573","chr22",37922602,37922626,25,75,6,106
"15574","chr22",37983795,37983812,18,124,2,144
"15575","chr22",37994513,37994534,22,74,77,173
"15576","chr22",38020191,38020235,45,29,29,103
"15577","chr22",38020432,38020450,19,36,75,130
"15578","chr22",38023840,38023859,20,8,75,103
"15579","chr22",38101853,38101889,37,60,75,172
"15580","chr22",38110025,38110169,145,125,114,384
"15581","chr22",38144633,38144658,26,108,6,140
"15582","chr22",38144808,38144887,80,65,6,151
"15583","chr22",38186455,38186484,30,83,75,188
"15584","chr22",38195517,38195537,21,46,34,101
"15585","chr22",38277727,38277747,21,71,9,101
"15586","chr22",38317283,38317308,26,8,32,66
"15587","chr22",38317348,38317375,28,14,27,69
"15588","chr22",38323610,38323629,20,102,26,148
"15589","chr22",38336248,38336296,49,55,42,146
"15590","chr22",38344991,38345012,22,8,19,49
"15591","chr22",38398921,38398946,26,89,73,188
"15592","chr22",38403751,38403769,19,129,6,154
"15593","chr22",38445065,38445087,23,47,109,179
"15594","chr22",38448247,38448266,20,127,5,152
"15595","chr22",38469812,38469838,27,9,112,148
"15596","chr22",38472480,38472498,19,99,3,121
"15597","chr22",38493344,38493363,20,114,106,240
"15598","chr22",38500818,38500846,29,39,5,73
"15599","chr22",38514935,38514964,30,87,20,137
"15600","chr22",38551857,38551879,23,9,123,155
"15601","chr22",38577459,38577476,18,8,12,38
"15602","chr22",38672306,38672339,34,69,30,133
"15603","chr22",38678131,38678158,28,74,117,219
"15604","chr22",38681326,38681346,21,53,84,158
"15605","chr22",38753211,38753233,23,14,1,38
"15606","chr22",38755336,38755353,18,32,46,96
"15607","chr22",38764430,38764455,26,32,27,85
"15608","chr22",38782484,38782503,20,23,121,164
"15609","chr22",38803144,38803235,92,31,90,213
"15610","chr22",38838574,38838599,26,76,40,142
"15611","chr22",38843958,38843998,41,20,84,145
"15612","chr22",38872066,38872084,19,128,119,266
"15613","chr22",38982239,38982262,24,135,141,300
"15614","chr22",38993761,38993783,23,77,66,166
"15615","chr22",39016367,39016398,32,37,75,144
"15616","chr22",39023092,39023132,41,7,35,83
"15617","chr22",39048807,39048825,19,67,6,92
"15618","chr22",39073473,39073501,29,11,6,46
"15619","chr22",39085887,39085915,29,40,74,143
"15620","chr22",39124041,39124063,23,142,3,168
"15621","chr22",39136092,39136112,21,26,4,51
"15622","chr22",39145272,39145295,24,98,31,153
"15623","chr22",39145719,39145740,22,68,33,123
"15624","chr22",39152470,39152487,18,82,43,143
"15625","chr22",39208737,39208759,23,62,28,113
"15626","chr22",39234013,39234032,20,35,116,171
"15627","chr22",39243211,39243296,86,39,85,210
"15628","chr22",39292467,39292486,20,16,26,62
"15629","chr22",39302943,39302976,34,59,98,191
"15630","chr22",39302973,39302991,19,74,68,161
"15631","chr22",39326212,39326233,22,116,74,212
"15632","chr22",39338978,39338999,22,69,102,193
"15633","chr22",39350182,39350201,20,16,11,47
"15634","chr22",39388082,39388101,20,138,4,162
"15635","chr22",39388256,39388280,25,50,8,83
"15636","chr22",39399587,39399621,35,65,28,128
"15637","chr22",39451855,39451872,18,17,5,40
"15638","chr22",39453443,39453463,21,9,48,78
"15639","chr22",39523994,39524020,27,78,145,250
"15640","chr22",39537235,39537276,42,16,63,121
"15641","chr22",39569549,39569566,18,75,142,235
"15642","chr22",39588386,39588403,18,8,48,74
"15643","chr22",39591549,39591575,27,75,14,116
"15644","chr22",39595289,39595334,46,4,6,56
"15645","chr22",39598272,39598297,26,135,147,308
"15646","chr22",39598942,39598965,24,75,122,221
"15647","chr22",39599619,39599648,30,60,6,96
"15648","chr22",39649753,39649772,20,60,14,94
"15649","chr22",39982738,39982786,49,145,7,201
"15650","chr22",39994904,39994931,28,48,18,94
"15651","chr22",39995303,39995321,19,30,74,123
"15652","chr22",40176123,40176141,19,75,14,108
"15653","chr22",40343874,40343895,22,61,36,119
"15654","chr22",40344068,40344086,19,9,67,95
"15655","chr22",40344372,40344399,28,145,6,179
"15656","chr22",40389601,40389624,24,146,4,174
"15657","chr22",40418728,40418748,21,1,12,34
"15658","chr22",40461629,40461649,21,77,28,126
"15659","chr22",40470950,40470980,31,28,73,132
"15660","chr22",40495758,40495776,19,5,74,98
"15661","chr22",40584731,40584749,19,53,11,83
"15662","chr22",40591135,40591159,25,64,6,95
"15663","chr22",40592267,40592285,19,95,77,191
"15664","chr22",40598998,40599016,19,104,67,190
"15665","chr22",40647250,40647274,25,24,74,123
"15666","chr22",40680573,40680603,31,101,36,168
"15667","chr22",40712596,40712626,31,80,11,122
"15668","chr22",40818707,40818726,20,14,5,39
"15669","chr22",40856967,40856984,18,38,142,198
"15670","chr22",40951150,40951179,30,6,76,112
"15671","chr22",40962496,40962513,18,76,33,127
"15672","chr22",40981977,40982032,56,77,24,157
"15673","chr22",40985920,40985976,57,8,20,85
"15674","chr22",41033326,41033389,64,72,91,227
"15675","chr22",41033996,41034017,22,36,146,204
"15676","chr22",41062980,41063002,23,13,73,109
"15677","chr22",41083923,41083945,23,56,1,80
"15678","chr22",41105199,41105221,23,80,4,107
"15679","chr22",41111877,41111905,29,76,107,212
"15680","chr22",41163435,41163455,21,135,6,162
"15681","chr22",41196523,41196543,21,22,118,161
"15682","chr22",41203872,41203892,21,102,12,135
"15683","chr22",41211857,41211881,25,8,10,43
"15684","chr22",41273767,41273793,27,10,124,161
"15685","chr22",41284249,41284277,29,5,4,38
"15686","chr22",41291597,41291614,18,8,124,150
"15687","chr22",41293761,41293786,26,7,92,125
"15688","chr22",41314143,41314170,28,72,61,161
"15689","chr22",41394990,41395023,34,8,67,109
"15690","chr22",41400755,41400781,27,80,78,185
"15691","chr22",41406232,41406250,19,29,75,123
"15692","chr22",41413592,41413631,40,20,111,171
"15693","chr22",41443622,41443640,19,7,8,34
"15694","chr22",41449990,41450018,29,5,141,175
"15695","chr22",41451520,41451545,26,51,5,82
"15696","chr22",41454773,41454791,19,40,104,163
"15697","chr22",41485435,41485458,24,8,143,175
"15698","chr22",41486470,41486488,19,8,134,161
"15699","chr22",41544351,41544389,39,41,49,129
"15700","chr22",41551189,41551213,25,130,69,224
"15701","chr22",41557430,41557447,18,103,103,224
"15702","chr22",41565450,41565470,21,58,74,153
"15703","chr22",41671455,41671482,28,23,77,128
"15704","chr22",41707029,41707053,25,77,33,135
"15705","chr22",41712230,41712253,24,9,119,152
"15706","chr22",41718980,41719000,21,76,135,232
"15707","chr22",41736235,41736266,32,75,35,142
"15708","chr22",41759633,41759663,31,129,71,231
"15709","chr22",41760310,41760345,36,63,6,105
"15710","chr22",41785866,41785928,63,8,8,79
"15711","chr22",41802917,41802958,42,139,3,184
"15712","chr22",41837557,41837576,20,13,7,40
"15713","chr22",41870629,41870651,23,82,71,176
"15714","chr22",41895432,41895452,21,75,18,114
"15715","chr22",41915070,41915109,40,33,5,78
"15716","chr22",41939779,41939907,129,93,86,308
"15717","chr22",41953741,41953768,28,77,27,132
"15718","chr22",41974663,41974686,24,58,6,88
"15719","chr22",41976795,41976818,24,43,55,122
"15720","chr22",42008084,42008171,88,22,42,152
"15721","chr22",42008175,42008207,33,58,11,102
"15722","chr22",42023496,42023518,23,17,7,47
"15723","chr22",42088107,42088125,19,13,7,39
"15724","chr22",42102244,42102268,25,76,106,207
"15725","chr22",42245088,42245106,19,9,132,160
"15726","chr22",42270423,42270441,19,56,2,77
"15727","chr22",42270728,42270778,51,105,115,271
"15728","chr22",42343869,42343895,27,39,10,76
"15729","chr22",42361046,42361065,20,9,6,35
"15730","chr22",42369300,42369337,38,119,78,235
"15731","chr22",42370456,42370482,27,137,74,238
"15732","chr22",42376539,42376562,24,32,45,101
"15733","chr22",42402832,42402853,22,9,132,163
"15734","chr22",42437127,42437158,32,6,3,41
"15735","chr22",42439496,42439514,19,71,19,109
"15736","chr22",42446957,42446983,27,37,7,71
"15737","chr22",42497119,42497142,24,146,4,174
"15738","chr22",42509965,42509982,18,8,7,33
"15739","chr22",42535646,42535664,19,75,38,132
"15740","chr22",42544423,42544446,24,77,35,136
"15741","chr22",42573244,42573261,18,8,29,55
"15742","chr22",42626312,42626330,19,90,3,112
"15743","chr22",42634621,42634645,25,10,136,171
"15744","chr22",42640351,42640396,46,76,127,249
"15745","chr22",42649343,42649362,20,32,3,55
"15746","chr22",42649419,42649455,37,125,5,167
"15747","chr22",42649679,42649705,27,24,85,136
"15748","chr22",42650045,42650065,21,15,57,93
"15749","chr22",42651527,42651544,18,83,70,171
"15750","chr22",42669000,42669043,44,66,47,157
"15751","chr22",42681357,42681415,59,26,43,128
"15752","chr22",42702339,42702356,18,73,52,143
"15753","chr22",42706355,42706377,23,12,74,109
"15754","chr22",42741488,42741507,20,43,10,73
"15755","chr22",42748154,42748171,18,96,42,156
"15756","chr22",42768940,42768961,22,28,94,144
"15757","chr22",42842012,42842032,21,18,145,184
"15758","chr22",42844590,42844614,25,69,69,163
"15759","chr22",42856945,42856972,28,59,28,115
"15760","chr22",42857684,42857702,19,14,126,159
"15761","chr22",42863011,42863029,19,148,6,173
"15762","chr22",43014322,43014365,44,12,85,141
"15763","chr22",43019860,43019881,22,76,39,137
"15764","chr22",43022324,43022343,20,38,74,132
"15765","chr22",43034707,43034727,21,146,7,174
"15766","chr22",43073326,43073371,46,41,145,232
"15767","chr22",43095664,43095889,226,6,6,238
"15768","chr22",43109535,43109564,30,122,5,157
"15769","chr22",43125728,43125749,22,86,66,174
"15770","chr22",43125732,43125766,35,103,62,200
"15771","chr22",43129229,43129274,46,114,91,251
"15772","chr22",43142775,43142807,33,119,17,169
"15773","chr22",43147618,43147640,23,36,76,135
"15774","chr22",43151471,43151494,24,61,7,92
"15775","chr22",43185248,43185300,53,111,54,218
"15776","chr22",43187140,43187293,154,18,17,189
"15777","chr22",43246922,43246939,18,16,49,83
"15778","chr22",43392780,43392819,40,126,73,239
"15779","chr22",43623740,43623759,20,145,23,188
"15780","chr22",43690344,43690366,23,145,22,190
"15781","chr22",43862025,43862053,29,70,65,164
"15782","chr22",43862383,43862412,30,80,24,134
"15783","chr22",43862432,43862462,31,41,65,137
"15784","chr22",43896995,43897017,23,70,74,167
"15785","chr22",44023513,44023606,94,13,4,111
"15786","chr22",44035369,44035388,20,8,58,86
"15787","chr22",44101408,44101458,51,138,7,196
"15788","chr22",44150156,44150199,44,53,75,172
"15789","chr22",44163480,44163514,35,66,4,105
"15790","chr22",44289467,44289495,29,39,67,135
"15791","chr22",44297978,44297997,20,104,126,250
"15792","chr22",44331718,44331752,35,2,53,90
"15793","chr22",44331888,44331958,71,93,9,173
"15794","chr22",44414396,44414429,34,36,146,216
"15795","chr22",44422301,44422342,42,73,18,133
"15796","chr22",44498233,44498263,31,4,78,113
"15797","chr22",44668678,44668712,35,13,32,80
"15798","chr22",44752228,44752279,52,70,5,127
"15799","chr22",44790677,44790699,23,25,73,121
"15800","chr22",44797218,44797235,18,8,23,49
"15801","chr22",44810237,44810259,23,8,97,128
"15802","chr22",44921360,44921382,23,74,139,236
"15803","chr22",44967218,44967238,21,76,123,220
"15804","chr22",44983234,44983252,19,142,6,167
"15805","chr22",44999485,44999502,18,24,93,135
"15806","chr22",45008902,45008922,21,2,15,38
"15807","chr22",45009463,45009489,27,44,62,133
"15808","chr22",45009876,45009893,18,21,5,44
"15809","chr22",45010056,45010088,33,7,31,71
"15810","chr22",45055162,45055196,35,81,6,122
"15811","chr22",45097936,45097986,51,25,141,217
"15812","chr22",45103790,45103813,24,9,76,109
"15813","chr22",45168899,45168919,21,76,132,229
"15814","chr22",45230581,45230599,19,8,40,67
"15815","chr22",45238876,45238902,27,54,104,185
"15816","chr22",45240929,45241012,84,128,2,214
"15817","chr22",45245493,45245534,42,9,41,92
"15818","chr22",45269255,45269305,51,10,44,105
"15819","chr22",45270783,45270820,38,22,4,64
"15820","chr22",45299990,45300010,21,76,73,170
"15821","chr22",45303747,45303775,29,97,6,132
"15822","chr22",45309805,45309823,19,24,83,126
"15823","chr22",45412181,45412217,37,35,144,216
"15824","chr22",45439415,45439447,33,5,3,41
"15825","chr22",45440361,45440387,27,51,2,80
"15826","chr22",45447545,45447582,38,46,74,158
"15827","chr22",45449282,45449299,18,24,141,183
"15828","chr22",45501628,45501649,22,36,75,133
"15829","chr22",45518128,45518157,30,32,10,72
"15830","chr22",45920638,45920753,116,20,62,198
"15831","chr22",46014445,46014470,26,9,59,94
"15832","chr22",46016531,46016558,28,26,75,129
"15833","chr22",46016579,46016598,20,66,27,113
"15834","chr22",46037675,46037699,25,12,135,172
"15835","chr22",46098650,46098674,25,61,131,217
"15836","chr22",46150661,46150683,23,10,3,36
"15837","chr22",46213576,46213607,32,9,74,115
"15838","chr22",46375540,46375561,22,76,15,113
"15839","chr22",46385675,46385695,21,8,15,44
"15840","chr22",46422587,46422615,29,143,18,190
"15841","chr22",46498612,46498638,27,142,6,175
"15842","chr22",46501200,46501224,25,10,76,111
"15843","chr22",46505262,46505282,21,78,74,173
"15844","chr22",46528929,46528968,40,132,6,178
"15845","chr22",46603202,46603225,24,8,69,101
"15846","chr22",46603516,46603534,19,76,2,97
"15847","chr22",46623384,46623405,22,76,81,179
"15848","chr22",46644698,46644734,37,105,40,182
"15849","chr22",46671657,46671695,39,82,73,194
"15850","chr22",46700394,46700428,35,132,73,240
"15851","chr22",46722557,46722576,20,75,123,218
"15852","chr22",46737292,46737340,49,67,7,123
"15853","chr22",46765958,46766006,49,67,72,188
"15854","chr22",46846809,46846829,21,34,52,107
"15855","chr22",47062088,47062108,21,76,43,140
"15856","chr22",47127395,47127412,18,71,75,164
"15857","chr22",47219270,47219288,19,35,26,80
"15858","chr22",47432145,47432173,29,77,72,178
"15859","chr22",47546956,47546975,20,30,74,124
"15860","chr22",47607183,47607219,37,45,13,95
"15861","chr22",47609596,47609623,28,67,60,155
"15862","chr22",47632203,47632222,20,149,90,259
"15863","chr22",47706586,47706610,25,74,72,171
"15864","chr22",47711969,47711997,29,3,10,42
"15865","chr22",47827846,47827873,28,14,70,112
"15866","chr22",47936367,47936395,29,27,36,92
"15867","chr22",48118863,48118891,29,14,19,62
"15868","chr22",48235019,48235066,48,102,32,182
"15869","chr22",48298739,48298764,26,41,3,70
"15870","chr22",48326245,48326267,23,23,74,120
"15871","chr22",48393696,48393716,21,29,143,193
"15872","chr22",48482133,48482153,21,60,121,202
"15873","chr22",48489404,48489452,49,58,13,120
"15874","chr22",48489470,48489488,19,19,7,45
"15875","chr22",48560564,48560611,48,61,39,148
"15876","chr22",48575599,48575629,31,26,44,101
"15877","chr22",48575870,48575900,31,15,10,56
"15878","chr22",48589987,48590012,26,13,99,138
"15879","chr22",48683178,48683200,23,11,84,118
"15880","chr22",48696381,48696425,45,37,52,134
"15881","chr22",48750155,48750173,19,144,38,201
"15882","chr22",48785808,48785826,19,143,4,166
"15883","chr22",48818012,48818048,37,4,4,45
"15884","chr22",48840842,48840872,31,71,3,105
"15885","chr22",48846782,48846803,22,15,61,98
"15886","chr22",48855002,48855413,412,84,106,602
"15887","chr22",48918462,48918487,26,145,33,204
"15888","chr22",49007449,49007469,21,55,146,222
"15889","chr22",49020723,49020747,25,60,32,117
"15890","chr22",49322400,49322418,19,3,63,85
"15891","chr22",49377731,49377758,28,70,33,131
"15892","chr22",49473741,49473760,20,8,54,82
"15893","chr22",49556474,49556494,21,108,57,186
"15894","chr22",49793963,49793989,27,90,74,191
"15895","chr22",49793967,49793993,27,94,70,191
"15896","chr22",49827361,49827384,24,11,14,49
"15897","chr22",49827760,49827815,56,77,49,182
"15898","chr22",49835722,49835749,28,145,134,307
"15899","chr22",49879144,49879170,27,104,7,138
"15900","chr22",49929463,49929491,29,29,128,186
"15901","chr22",49961049,49961083,35,144,29,208
"15902","chr22",49962326,49962356,31,16,3,50
"15903","chr22",50009640,50009661,22,45,127,194
"15904","chr22",50027534,50027551,18,31,74,123
"15905","chr22",50048116,50048145,30,61,24,115
"15906","chr22",50055656,50055673,18,35,4,57
"15907","chr22",50068708,50068746,39,78,31,148
"15908","chr22",50090672,50090694,23,8,109,140
"15909","chr22",50109671,50109692,22,123,6,151
"15910","chr22",50131064,50131082,19,30,143,192
"15911","chr22",50148651,50148679,29,6,53,88
"15912","chr22",50172896,50172914,19,8,75,102
"15913","chr22",50178188,50178226,39,47,146,232
"15914","chr22",50185744,50185766,23,1,140,164
"15915","chr22",50185883,50185901,19,9,1,29
"15916","chr22",50201378,50201397,20,11,3,34
"15917","chr22",50241984,50242009,26,138,25,189
"15918","chr22",50261342,50261376,35,9,82,126
"15919","chr22",50261996,50262013,18,42,6,66
"15920","chr22",50270313,50270349,37,17,33,87
"15921","chr22",50270334,50270368,35,36,12,83
"15922","chr22",50270347,50270373,27,41,9,77
"15923","chr22",50270378,50270412,35,12,36,83
"15924","chr22",50275484,50275514,31,83,142,256
"15925","chr22",50306682,50306734,53,40,127,220
"15926","chr22",50307735,50307893,159,139,76,374
"15927","chr22",50323021,50323048,28,37,140,205
"15928","chr22",50326783,50326807,25,62,39,126
"15929","chr22",50394914,50394933,20,130,74,224
"15930","chr22",50396196,50396215,20,148,42,210
"15931","chr22",50446980,50447003,24,30,60,114
"15932","chr22",50451167,50451193,27,145,34,206
"15933","chr22",50474966,50474994,29,110,103,242
"15934","chr22",50490619,50490645,27,68,5,100
"15935","chr22",50530398,50530415,18,10,54,82
"15936","chr22",50537217,50537245,29,19,72,120
"15937","chr22",50604544,50604573,30,49,12,91
"15938","chr22",50612858,50612908,51,118,144,313
"15939","chr22",50628181,50628232,52,30,5,87
"15940","chr22",50651199,50651218,20,128,75,223
"15941","chr22",50674425,50674453,29,15,24,68
"15942","chr22",50674487,50674516,30,14,44,88
"15943","chr3",276891,276916,26,124,17,167
"15944","chr3",2472220,2472239,20,57,1,78
"15945","chr3",2634688,2634705,18,76,14,108
"15946","chr3",2729544,2729563,20,50,7,77
"15947","chr3",2747407,2747442,36,66,8,110
"15948","chr3",2805885,2805917,33,74,19,126
"15949","chr3",3050764,3050783,20,85,73,178
"15950","chr3",3090542,3090584,43,8,113,164
"15951","chr3",3126229,3126247,19,13,4,36
"15952","chr3",3799810,3799843,34,61,72,167
"15953","chr3",4493401,4493440,40,9,62,111
"15954","chr3",4759926,4759945,20,34,134,188
"15955","chr3",4869503,4869549,47,7,94,148
"15956","chr3",4985772,4985789,18,9,94,121
"15957","chr3",4997578,4997595,18,36,75,129
"15958","chr3",5003778,5003804,27,133,7,167
"15959","chr3",5027598,5027616,19,6,7,32
"15960","chr3",5029219,5029264,46,49,93,188
"15961","chr3",5093356,5093375,20,53,74,147
"15962","chr3",5150783,5150808,26,115,74,215
"15963","chr3",5237550,5237568,19,8,134,161
"15964","chr3",6068107,6068133,27,77,108,212
"15965","chr3",6131266,6131289,24,34,93,151
"15966","chr3",6340710,6340727,18,22,6,46
"15967","chr3",7435680,7435705,26,76,75,177
"15968","chr3",7547195,7547224,30,76,106,212
"15969","chr3",8656863,8656895,33,5,66,104
"15970","chr3",8870591,8870618,28,74,45,147
"15971","chr3",9045505,9045547,43,98,10,151
"15972","chr3",9058715,9058737,23,76,24,123
"15973","chr3",9136411,9136429,19,133,19,171
"15974","chr3",9299052,9299075,24,93,6,123
"15975","chr3",9397652,9397691,40,71,72,183
"15976","chr3",9502315,9502345,31,73,108,212
"15977","chr3",9571214,9571235,22,76,65,163
"15978","chr3",9635136,9635168,33,105,6,144
"15979","chr3",9635888,9635916,29,9,25,63
"15980","chr3",9649460,9649482,23,44,58,125
"15981","chr3",9706253,9706278,26,49,79,154
"15982","chr3",9706276,9706307,32,78,56,166
"15983","chr3",9769950,9769967,18,88,23,129
"15984","chr3",9857472,9857505,34,10,7,51
"15985","chr3",9882846,9882878,33,74,12,119
"15986","chr3",9883169,9883203,35,15,139,189
"15987","chr3",9990326,9990350,25,74,9,108
"15988","chr3",10001406,10001428,23,145,27,195
"15989","chr3",10020345,10020370,26,133,7,166
"15990","chr3",10027905,10027924,20,136,6,162
"15991","chr3",10055859,10055896,38,8,27,73
"15992","chr3",10118253,10118270,18,107,73,198
"15993","chr3",10142342,10142361,20,6,5,31
"15994","chr3",10165722,10165748,27,8,113,148
"15995","chr3",10188511,10188541,31,5,66,102
"15996","chr3",10221249,10221271,23,8,15,46
"15997","chr3",10233037,10233067,31,8,145,184
"15998","chr3",10408329,10408355,27,41,6,74
"15999","chr3",10472081,10472101,21,32,6,59
"16000","chr3",10491225,10491242,18,7,88,113
"16001","chr3",10505725,10505747,23,138,54,215
"16002","chr3",10707939,10707972,34,131,10,175
"16003","chr3",10802186,10802212,27,50,38,115
"16004","chr3",10802211,10802238,28,8,13,49
"16005","chr3",10861184,10861218,35,132,17,184
"16006","chr3",11037525,11037543,19,28,61,108
"16007","chr3",11242481,11242509,29,70,6,105
"16008","chr3",11250209,11250232,24,29,143,196
"16009","chr3",11303918,11303941,24,145,28,197
"16010","chr3",11440675,11440700,26,75,9,110
"16011","chr3",11561892,11561916,25,75,85,185
"16012","chr3",11719571,11719590,20,76,29,125
"16013","chr3",11734879,11734899,21,77,28,126
"16014","chr3",11751090,11751108,19,75,106,200
"16015","chr3",11823661,11823679,19,4,41,64
"16016","chr3",11842696,11842718,23,74,72,169
"16017","chr3",12004650,12004667,18,94,73,185
"16018","chr3",12187455,12187486,32,136,120,288
"16019","chr3",12219439,12219459,21,76,134,231
"16020","chr3",12268815,12268832,18,76,82,176
"16021","chr3",12286611,12286641,31,69,70,170
"16022","chr3",12287785,12287845,61,7,79,147
"16023","chr3",12287851,12287873,23,35,13,71
"16024","chr3",12418919,12418953,35,67,34,136
"16025","chr3",12620137,12620160,24,44,19,87
"16026","chr3",12635319,12635354,36,12,74,122
"16027","chr3",12691310,12691332,23,101,5,129
"16028","chr3",12697253,12697280,28,8,20,56
"16029","chr3",12718276,12718307,32,8,38,78
"16030","chr3",12768885,12768956,72,25,12,109
"16031","chr3",12794681,12794701,21,9,95,125
"16032","chr3",12812222,12812240,19,7,132,158
"16033","chr3",12812391,12812415,25,69,143,237
"16034","chr3",12994184,12994207,24,135,9,168
"16035","chr3",13009668,13009688,21,62,11,94
"16036","chr3",13020251,13020276,26,94,142,262
"16037","chr3",13117570,13117599,30,9,22,61
"16038","chr3",13199875,13200281,407,86,30,523
"16039","chr3",13282756,13282783,28,10,91,129
"16040","chr3",13283022,13283046,25,63,16,104
"16041","chr3",13418791,13418813,23,91,70,184
"16042","chr3",13438292,13438316,25,141,2,168
"16043","chr3",13480276,13480305,30,25,130,185
"16044","chr3",13549162,13549189,28,106,11,145
"16045","chr3",13606981,13606998,18,144,117,279
"16046","chr3",13633955,13633995,41,129,2,172
"16047","chr3",13880137,13880169,33,14,54,101
"16048","chr3",14403078,14403124,47,34,4,85
"16049","chr3",14598348,14598378,31,113,110,254
"16050","chr3",14677493,14677515,23,73,2,98
"16051","chr3",14683876,14683895,20,146,6,172
"16052","chr3",14738631,14738652,22,77,145,244
"16053","chr3",14738808,14738835,28,63,68,159
"16054","chr3",14810590,14810664,75,86,118,279
"16055","chr3",14893722,14893770,49,16,21,86
"16056","chr3",14908885,14908915,31,4,119,154
"16057","chr3",14908922,14908952,31,41,82,154
"16058","chr3",14908950,14908989,40,78,54,172
"16059","chr3",14947613,14947630,18,71,7,96
"16060","chr3",14948587,14948622,36,133,24,193
"16061","chr3",15060516,15060539,24,86,71,181
"16062","chr3",15465236,15465283,48,7,12,67
"16063","chr3",15859563,15859610,48,132,55,235
"16064","chr3",17742520,17742541,22,99,12,133
"16065","chr3",17876822,17876851,30,20,74,124
"16066","chr3",17971036,17971061,26,57,128,211
"16067","chr3",18102005,18102028,24,126,73,223
"16068","chr3",18258547,18258564,18,50,20,88
"16069","chr3",18349641,18349686,46,13,34,93
"16070","chr3",18424925,18424957,33,48,76,157
"16071","chr3",18425141,18425174,34,11,69,114
"16072","chr3",18425340,18425362,23,27,67,117
"16073","chr3",18425361,18425390,30,55,46,131
"16074","chr3",18444826,18444854,29,43,9,81
"16075","chr3",18445269,18445292,24,72,64,160
"16076","chr3",18445289,18445308,20,88,44,152
"16077","chr3",19993732,19993756,25,14,82,121
"16078","chr3",20026466,20026484,19,78,9,106
"16079","chr3",20129008,20129029,22,100,73,195
"16080","chr3",20370616,20370633,18,25,122,165
"16081","chr3",20926945,20926970,26,15,26,67
"16082","chr3",21444380,21444402,23,100,10,133
"16083","chr3",21694043,21694061,19,8,78,105
"16084","chr3",23081964,23082001,38,50,74,162
"16085","chr3",23291850,23291876,27,8,143,178
"16086","chr3",23441369,23441389,21,77,23,121
"16087","chr3",23745928,23745953,26,12,70,108
"16088","chr3",23896135,23896156,22,65,6,93
"16089","chr3",23967024,23967043,20,147,80,247
"16090","chr3",24254200,24254245,46,77,31,154
"16091","chr3",24333097,24333128,32,142,61,235
"16092","chr3",24366622,24366639,18,77,63,158
"16093","chr3",24495409,24495430,22,69,73,164
"16094","chr3",24830340,24830357,18,1,146,165
"16095","chr3",24830421,24830442,22,28,65,115
"16096","chr3",25658061,25658078,18,76,6,100
"16097","chr3",25664850,25664867,18,36,61,115
"16098","chr3",25807966,25808006,41,146,72,259
"16099","chr3",26745510,26745537,28,142,6,176
"16100","chr3",27561261,27561284,24,14,6,44
"16101","chr3",27566120,27566148,29,121,73,223
"16102","chr3",27630416,27630433,18,41,143,202
"16103","chr3",27721915,27721948,34,60,82,176
"16104","chr3",27722867,27722897,31,102,49,182
"16105","chr3",28014716,28014745,30,58,32,120
"16106","chr3",28575970,28575998,29,44,95,168
"16107","chr3",29075018,29075045,28,92,17,137
"16108","chr3",29082882,29082904,23,46,71,140
"16109","chr3",29281502,29281520,19,86,47,152
"16110","chr3",29376904,29376937,34,143,75,252
"16111","chr3",29461921,29461949,29,30,143,202
"16112","chr3",29685043,29685077,35,77,137,249
"16113","chr3",31502466,31502500,35,144,6,185
"16114","chr3",31532902,31532922,21,55,7,83
"16115","chr3",31895135,31895152,18,11,79,108
"16116","chr3",31980806,31980863,58,8,34,100
"16117","chr3",31981114,31981140,27,25,17,69
"16118","chr3",31984027,31984054,28,75,22,125
"16119","chr3",32092757,32092801,45,83,97,225
"16120","chr3",32416362,32416397,36,65,142,243
"16121","chr3",32457634,32457654,21,33,67,121
"16122","chr3",32511726,32511746,21,9,45,75
"16123","chr3",32567704,32567721,18,76,145,239
"16124","chr3",32593382,32593410,29,6,81,116
"16125","chr3",32650886,32650912,27,5,69,101
"16126","chr3",32666632,32666651,20,136,6,162
"16127","chr3",32724413,32724430,18,8,143,169
"16128","chr3",32748812,32748847,36,84,145,265
"16129","chr3",32750545,32750570,26,9,22,57
"16130","chr3",32784391,32784415,25,7,13,45
"16131","chr3",32789862,32789886,25,129,73,227
"16132","chr3",32812432,32812452,21,133,6,160
"16133","chr3",32816655,32816673,19,9,133,161
"16134","chr3",32818023,32818046,24,52,33,109
"16135","chr3",32839661,32839682,22,6,13,41
"16136","chr3",32864846,32864893,48,86,5,139
"16137","chr3",32945168,32945191,24,48,74,146
"16138","chr3",32946362,32946389,28,122,143,293
"16139","chr3",32978964,32978993,30,7,106,143
"16140","chr3",32981400,32981440,41,96,74,211
"16141","chr3",33055451,33055478,28,76,81,185
"16142","chr3",33114038,33114065,28,70,31,129
"16143","chr3",33164001,33164023,23,144,5,172
"16144","chr3",33255086,33255108,23,126,5,154
"16145","chr3",33342894,33342912,19,28,74,121
"16146","chr3",33371331,33371350,20,31,76,127
"16147","chr3",33440411,33440437,27,27,33,87
"16148","chr3",33487713,33487734,22,120,142,284
"16149","chr3",33744673,33744697,25,57,76,158
"16150","chr3",33974456,33974476,21,93,7,121
"16151","chr3",34276081,34276133,53,101,93,247
"16152","chr3",35535096,35535125,30,78,35,143
"16153","chr3",35981264,35981282,19,145,32,196
"16154","chr3",36763992,36764040,49,8,86,143
"16155","chr3",36856294,36856331,38,130,82,250
"16156","chr3",37027200,37027234,35,109,80,224
"16157","chr3",37085523,37085541,19,18,4,41
"16158","chr3",37120106,37120124,19,8,1,28
"16159","chr3",37189929,37189955,27,8,84,119
"16160","chr3",37201399,37201419,21,44,55,120
"16161","chr3",37270203,37270223,21,126,136,283
"16162","chr3",37731215,37731237,23,78,19,120
"16163","chr3",37848937,37848988,52,5,14,71
"16164","chr3",37861815,37861886,72,69,106,247
"16165","chr3",37862108,37862141,34,31,10,75
"16166","chr3",37960481,37960506,26,3,5,34
"16167","chr3",37960506,37960536,31,33,48,112
"16168","chr3",37960536,37960578,43,75,18,136
"16169","chr3",38275501,38275521,21,31,123,175
"16170","chr3",38417880,38417897,18,135,74,227
"16171","chr3",38454761,38454778,18,32,12,62
"16172","chr3",38522498,38522522,25,76,45,146
"16173","chr3",38579882,38579919,38,91,125,254
"16174","chr3",38649724,38649760,37,6,57,100
"16175","chr3",39440386,39440406,21,40,7,68
"16176","chr3",39441098,39441124,27,76,27,130
"16177","chr3",39459713,39459737,25,104,75,204
"16178","chr3",40261568,40261585,18,8,125,151
"16179","chr3",40998781,40998828,48,60,99,207
"16180","chr3",41199958,41199980,23,81,28,132
"16181","chr3",41757630,41757652,23,15,45,83
"16182","chr3",41822723,41822741,19,10,5,34
"16183","chr3",41906217,41906237,21,3,74,98
"16184","chr3",42210086,42210117,32,102,103,237
"16185","chr3",42588077,42588114,38,146,71,255
"16186","chr3",42590979,42590998,20,6,54,80
"16187","chr3",42654293,42654320,28,80,43,151
"16188","chr3",43007980,43008002,23,82,145,250
"16189","chr3",43160307,43160325,19,78,74,171
"16190","chr3",43636014,43636040,27,115,50,192
"16191","chr3",44034343,44034361,19,7,142,168
"16192","chr3",44440914,44440931,18,76,65,159
"16193","chr3",44507303,44507329,27,6,69,102
"16194","chr3",44712991,44713013,23,69,35,127
"16195","chr3",44806738,44806763,26,8,81,115
"16196","chr3",44975748,44975773,26,56,9,91
"16197","chr3",44975773,44975805,33,15,88,136
"16198","chr3",45006405,45006427,23,121,90,234
"16199","chr3",45225151,45225195,45,50,52,147
"16200","chr3",45225517,45225552,36,138,28,202
"16201","chr3",45226345,45226363,19,37,30,86
"16202","chr3",45390625,45390668,44,74,131,249
"16203","chr3",45391549,45391570,22,88,10,120
"16204","chr3",45430584,45430602,19,9,141,169
"16205","chr3",45449157,45449179,23,75,43,141
"16206","chr3",45557282,45557305,24,13,23,60
"16207","chr3",45586244,45586263,20,60,45,125
"16208","chr3",45594779,45594844,66,133,104,303
"16209","chr3",45614410,45614427,18,136,123,277
"16210","chr3",45726870,45726896,27,69,12,108
"16211","chr3",46052028,46052050,23,28,72,123
"16212","chr3",46693734,46693770,37,10,83,130
"16213","chr3",46846067,46846093,27,60,42,129
"16214","chr3",46883139,46883179,41,19,11,71
"16215","chr3",46883316,46883352,37,48,45,130
"16216","chr3",46883357,46883386,30,22,4,56
"16217","chr3",46975522,46975548,27,8,101,136
"16218","chr3",46975842,46975863,22,8,128,158
"16219","chr3",46976958,46976982,25,58,118,201
"16220","chr3",46979918,46979950,33,14,30,77
"16221","chr3",47068800,47068818,19,144,140,303
"16222","chr3",47164013,47164053,41,30,8,79
"16223","chr3",47199527,47199544,18,77,8,103
"16224","chr3",47325945,47325963,19,43,97,159
"16225","chr3",47393497,47393515,19,101,101,221
"16226","chr3",47400873,47400918,46,74,146,266
"16227","chr3",47426423,47426453,31,6,126,163
"16228","chr3",47447689,47447724,36,14,73,123
"16229","chr3",47475824,47475855,32,73,48,153
"16230","chr3",47476084,47476106,23,73,133,229
"16231","chr3",47494678,47494706,29,11,71,111
"16232","chr3",47512551,47512572,22,85,8,115
"16233","chr3",47537671,47537701,31,60,113,204
"16234","chr3",47537697,47537718,22,77,87,186
"16235","chr3",47539324,47539341,18,136,35,189
"16236","chr3",47578821,47578895,75,88,10,173
"16237","chr3",47601689,47601713,25,4,56,85
"16238","chr3",47695763,47695783,21,11,78,110
"16239","chr3",47728079,47728104,26,8,125,159
"16240","chr3",47767184,47767210,27,28,5,60
"16241","chr3",47771749,47771792,44,112,69,225
"16242","chr3",47788558,47788575,18,72,5,95
"16243","chr3",47788953,47788981,29,19,7,55
"16244","chr3",47789940,47789962,23,82,61,166
"16245","chr3",47790622,47790644,23,8,6,37
"16246","chr3",47790849,47790867,19,6,51,76
"16247","chr3",47794231,47794254,24,31,71,126
"16248","chr3",47801947,47801965,19,81,39,139
"16249","chr3",47917995,47918013,19,89,78,186
"16250","chr3",47926179,47926201,23,8,122,153
"16251","chr3",47972886,47972914,29,100,74,203
"16252","chr3",48138408,48138434,27,65,57,149
"16253","chr3",48144658,48144675,18,49,12,79
"16254","chr3",48195328,48195352,25,56,74,155
"16255","chr3",48202107,48202134,28,77,74,179
"16256","chr3",48202584,48202638,55,117,6,178
"16257","chr3",48238501,48238520,20,132,6,158
"16258","chr3",48239115,48239135,21,5,25,51
"16259","chr3",48239432,48239459,28,87,67,182
"16260","chr3",48265272,48265301,30,20,145,195
"16261","chr3",48492151,48492188,38,13,125,176
"16262","chr3",48504038,48504064,27,12,53,92
"16263","chr3",48504231,48504296,66,24,2,92
"16264","chr3",48568744,48568772,29,104,59,192
"16265","chr3",48610705,48610729,25,46,77,148
"16266","chr3",48615883,48615906,24,105,6,135
"16267","chr3",48808242,48808272,31,77,79,187
"16268","chr3",48878274,48878310,37,135,61,233
"16269","chr3",48878800,48878818,19,6,74,99
"16270","chr3",48878858,48878888,31,76,16,123
"16271","chr3",48880575,48880596,22,19,146,187
"16272","chr3",48901177,48901217,41,98,75,214
"16273","chr3",48901554,48901584,31,139,6,176
"16274","chr3",48909809,48909832,24,83,6,113
"16275","chr3",48912673,48912691,19,73,19,111
"16276","chr3",48925102,48925131,30,8,145,183
"16277","chr3",48933236,48933288,53,127,147,327
"16278","chr3",48940332,48940384,53,8,112,173
"16279","chr3",48948265,48948283,19,5,122,146
"16280","chr3",48968202,48968225,24,8,75,107
"16281","chr3",49007819,49007838,20,21,6,47
"16282","chr3",49007936,49007961,26,104,54,184
"16283","chr3",49039031,49039058,28,136,2,166
"16284","chr3",49050249,49050273,25,145,119,289
"16285","chr3",49090459,49090478,20,77,6,103
"16286","chr3",49096799,49096835,37,145,75,257
"16287","chr3",49113583,49113613,31,74,4,109
"16288","chr3",49149326,49149347,22,14,73,109
"16289","chr3",49186000,49186017,18,75,130,223
"16290","chr3",49190664,49190687,24,9,74,107
"16291","chr3",49193374,49193397,24,128,72,224
"16292","chr3",49218377,49218400,24,9,31,64
"16293","chr3",49240213,49240240,28,7,25,60
"16294","chr3",49247227,49247245,19,74,112,205
"16295","chr3",49258602,49258633,32,68,5,105
"16296","chr3",49260067,49260088,22,143,74,239
"16297","chr3",49275520,49275548,29,8,10,47
"16298","chr3",49281492,49281532,41,113,38,192
"16299","chr3",49341510,49341528,19,139,32,190
"16300","chr3",49345828,49345848,21,133,6,160
"16301","chr3",49357108,49357137,30,99,4,133
"16302","chr3",49357997,49358019,23,52,120,195
"16303","chr3",49358241,49358260,20,18,27,65
"16304","chr3",49369007,49369039,33,74,11,118
"16305","chr3",49451372,49451397,26,147,71,244
"16306","chr3",49464587,49464639,53,144,6,203
"16307","chr3",49479629,49479655,27,8,130,165
"16308","chr3",49541201,49541222,22,32,82,136
"16309","chr3",49554659,49554698,40,29,36,105
"16310","chr3",49554786,49554820,35,20,20,75
"16311","chr3",49672782,49672799,18,78,9,105
"16312","chr3",49673796,49673842,47,113,130,290
"16313","chr3",49710269,49710296,28,7,12,47
"16314","chr3",49852762,49852780,19,60,67,146
"16315","chr3",49893899,49893931,33,11,6,50
"16316","chr3",49962151,49962168,18,144,20,182
"16317","chr3",50087999,50088016,18,76,12,106
"16318","chr3",50119750,50119768,19,28,96,143
"16319","chr3",50253199,50253221,23,125,46,194
"16320","chr3",50281361,50281378,18,123,144,285
"16321","chr3",50283627,50283649,23,77,6,106
"16322","chr3",50301616,50301634,19,111,75,205
"16323","chr3",50429593,50429620,28,77,31,136
"16324","chr3",50503465,50503487,23,78,8,109
"16325","chr3",50675445,50675470,26,58,62,146
"16326","chr3",51091683,51091702,20,46,98,164
"16327","chr3",51260985,51261010,26,12,73,111
"16328","chr3",51385311,51385352,42,50,53,145
"16329","chr3",51385525,51385556,32,115,26,173
"16330","chr3",51454669,51454692,24,9,3,36
"16331","chr3",51498050,51498081,32,16,6,54
"16332","chr3",51523025,51523042,18,79,5,102
"16333","chr3",51583587,51583606,20,35,75,130
"16334","chr3",51659099,51659123,25,8,141,174
"16335","chr3",51693477,51693497,21,76,80,177
"16336","chr3",51707075,51707103,29,75,80,184
"16337","chr3",51923725,51923748,24,130,75,229
"16338","chr3",51967343,51967362,20,27,78,125
"16339","chr3",51967510,51967531,22,134,37,193
"16340","chr3",51973506,51973533,28,11,48,87
"16341","chr3",52410162,52410219,58,47,5,110
"16342","chr3",52533930,52533951,22,72,70,164
"16343","chr3",52542620,52542644,25,145,74,244
"16344","chr3",52966006,52966027,22,5,6,33
"16345","chr3",53045609,53045630,22,31,101,154
"16346","chr3",53151125,53151145,21,8,85,114
"16347","chr3",53156625,53156650,26,139,32,197
"16348","chr3",53161850,53161877,28,33,22,83
"16349","chr3",53206622,53206644,23,37,135,195
"16350","chr3",53267268,53267293,26,5,74,105
"16351","chr3",53282075,53282101,27,7,12,46
"16352","chr3",53389237,53389278,42,129,6,177
"16353","chr3",53494622,53494644,23,55,21,99
"16354","chr3",53500254,53500282,29,145,9,183
"16355","chr3",53810759,53810792,34,93,5,132
"16356","chr3",54122472,54122537,66,109,70,245
"16357","chr3",54183886,54183920,35,53,5,93
"16358","chr3",55191758,55191779,22,77,119,218
"16359","chr3",56446612,56446643,32,8,21,61
"16360","chr3",56468325,56468352,28,20,9,57
"16361","chr3",56509796,56509824,29,136,5,170
"16362","chr3",56535448,56535482,35,108,7,150
"16363","chr3",56802406,56802440,35,11,16,62
"16364","chr3",56893812,56893852,41,14,1,56
"16365","chr3",57079272,57079297,26,29,11,66
"16366","chr3",57185845,57185891,47,123,74,244
"16367","chr3",57211528,57211551,24,13,8,45
"16368","chr3",57445995,57446024,30,132,67,229
"16369","chr3",57590090,57590135,46,78,75,199
"16370","chr3",57614524,57614562,39,8,121,168
"16371","chr3",57619853,57619883,31,89,71,191
"16372","chr3",57684152,57684170,19,58,8,85
"16373","chr3",57707235,57707279,45,78,4,127
"16374","chr3",57844712,57844731,20,7,32,59
"16375","chr3",57885377,57885422,46,61,6,113
"16376","chr3",57953896,57953920,25,31,59,115
"16377","chr3",57965864,57965881,18,50,70,138
"16378","chr3",58195614,58195639,26,80,25,131
"16379","chr3",58237463,58237504,42,31,62,135
"16380","chr3",58327289,58327307,19,75,56,150
"16381","chr3",58333372,58333389,18,139,64,221
"16382","chr3",58492060,58492084,25,18,102,145
"16383","chr3",58669693,58669753,61,37,5,103
"16384","chr3",59501915,59501941,27,68,45,140
"16385","chr3",59577971,59578004,34,99,26,159
"16386","chr3",60224703,60224745,43,90,16,149
"16387","chr3",60500772,60500797,26,26,75,127
"16388","chr3",60543908,60543931,24,29,146,199
"16389","chr3",60732685,60732706,22,47,122,191
"16390","chr3",60957234,60957255,22,76,22,120
"16391","chr3",61295167,61295193,27,37,75,139
"16392","chr3",61742404,61742423,20,70,35,125
"16393","chr3",61795640,61795667,28,65,6,99
"16394","chr3",61923693,61923711,19,31,37,87
"16395","chr3",62069638,62069685,48,100,85,233
"16396","chr3",62069685,62069716,32,131,38,201
"16397","chr3",62326023,62326040,18,56,75,149
"16398","chr3",62372522,62372565,44,146,5,195
"16399","chr3",62373587,62373604,18,19,43,80
"16400","chr3",62594560,62594578,19,104,46,169
"16401","chr3",62748169,62748196,28,77,23,128
"16402","chr3",63196776,63196811,36,75,3,114
"16403","chr3",63863798,63863824,27,2,19,48
"16404","chr3",63863938,63863978,41,16,89,146
"16405","chr3",64444392,64444429,38,18,14,70
"16406","chr3",64535533,64535568,36,73,117,226
"16407","chr3",64687877,64687910,34,54,34,122
"16408","chr3",64696565,64696589,25,109,6,140
"16409","chr3",64929907,64929925,19,60,31,110
"16410","chr3",64964384,64964403,20,14,40,74
"16411","chr3",65379376,65379426,51,84,109,244
"16412","chr3",65798305,65798337,33,92,73,198
"16413","chr3",66131060,66131084,25,10,106,141
"16414","chr3",66170792,66170821,30,8,90,128
"16415","chr3",66295391,66295421,31,78,75,184
"16416","chr3",66488006,66488023,18,141,139,298
"16417","chr3",66533207,66533228,22,8,143,173
"16418","chr3",66561211,66561235,25,76,33,134
"16419","chr3",66807917,66807940,24,119,73,216
"16420","chr3",67446418,67446448,31,76,123,230
"16421","chr3",67985405,67985435,31,8,37,76
"16422","chr3",68007320,68007343,24,128,83,235
"16423","chr3",68741792,68741818,27,86,18,131
"16424","chr3",69386434,69386457,24,141,3,168
"16425","chr3",69814659,69814683,25,16,106,147
"16426","chr3",69846817,69846836,20,127,74,221
"16427","chr3",69961394,69961415,22,138,62,222
"16428","chr3",69961551,69961583,33,85,27,145
"16429","chr3",70841549,70841580,32,29,75,136
"16430","chr3",71065026,71065052,27,5,8,40
"16431","chr3",71074226,71074243,18,7,86,111
"16432","chr3",71145545,71145574,30,105,71,206
"16433","chr3",71476658,71476676,19,29,93,141
"16434","chr3",71583808,71583825,18,9,43,70
"16435","chr3",71656285,71656334,50,5,62,117
"16436","chr3",71725274,71725308,35,2,28,65
"16437","chr3",71725439,71725477,39,62,28,129
"16438","chr3",71725484,71725513,30,98,19,147
"16439","chr3",71753648,71753693,46,147,19,212
"16440","chr3",72898725,72898749,25,8,72,105
"16441","chr3",73047871,73047893,23,7,144,174
"16442","chr3",73048249,73048273,25,50,71,146
"16443","chr3",73081385,73081404,20,76,54,150
"16444","chr3",73091222,73091243,22,76,19,117
"16445","chr3",73271746,73271771,26,7,49,82
"16446","chr3",73356889,73356910,22,29,143,194
"16447","chr3",74229817,74229838,22,29,75,126
"16448","chr3",74614434,74614478,45,65,72,182
"16449","chr3",74614676,74614698,23,25,38,86
"16450","chr3",74817767,74817786,20,75,37,132
"16451","chr3",75386354,75386391,38,98,111,247
"16452","chr3",75620914,75620954,41,4,135,180
"16453","chr3",77040050,77040094,45,84,44,173
"16454","chr3",77112194,77112217,24,32,25,81
"16455","chr3",77473441,77473477,37,82,106,225
"16456","chr3",77490100,77490118,19,76,117,212
"16457","chr3",77675850,77675878,29,10,56,95
"16458","chr3",78171721,78171747,27,142,74,243
"16459","chr3",78505587,78505610,24,12,14,50
"16460","chr3",78672416,78672442,27,145,35,207
"16461","chr3",78939451,78939468,18,77,36,131
"16462","chr3",79788013,79788040,28,30,108,166
"16463","chr3",81023239,81023257,19,75,26,120
"16464","chr3",81659503,81659521,19,29,143,191
"16465","chr3",81777899,81777928,30,124,74,228
"16466","chr3",81986761,81986788,28,77,106,211
"16467","chr3",83177792,83177811,20,36,76,132
"16468","chr3",83775614,83775645,32,57,38,127
"16469","chr3",84632200,84632217,18,144,27,189
"16470","chr3",84824150,84824172,23,38,74,135
"16471","chr3",84961611,84961638,28,18,52,98
"16472","chr3",85806736,85806776,41,125,80,246
"16473","chr3",86248427,86248444,18,68,6,92
"16474","chr3",86351987,86352009,23,70,138,231
"16475","chr3",86553056,86553082,27,77,33,137
"16476","chr3",86911216,86911238,23,77,32,132
"16477","chr3",86911405,86911424,20,139,57,216
"16478","chr3",87027603,87027641,39,5,51,95
"16479","chr3",87226925,87226947,23,39,93,155
"16480","chr3",87635556,87635573,18,20,74,112
"16481","chr3",88089192,88089209,18,147,74,239
"16482","chr3",89203326,89203358,33,18,142,193
"16483","chr3",89537054,89537071,18,121,10,149
"16484","chr3",93844472,93844494,23,9,56,88
"16485","chr3",93979241,93979269,29,29,80,138
"16486","chr3",95038756,95038780,25,8,29,62
"16487","chr3",95501421,95501454,34,62,6,102
"16488","chr3",95885036,95885057,22,75,79,176
"16489","chr3",96814785,96814808,24,1,26,51
"16490","chr3",97762395,97762413,19,6,73,98
"16491","chr3",97972612,97972646,35,68,37,140
"16492","chr3",98690514,98690539,26,53,107,186
"16493","chr3",98690839,98690862,24,22,66,112
"16494","chr3",98905755,98905775,21,13,6,40
"16495","chr3",99696977,99697004,28,8,134,170
"16496","chr3",99876085,99876116,32,72,128,232
"16497","chr3",99983390,99983520,131,58,15,204
"16498","chr3",100478970,100479043,74,76,62,212
"16499","chr3",101512975,101512998,24,58,86,168
"16500","chr3",101513214,101513245,32,68,27,127
"16501","chr3",101682191,101682213,23,74,32,129
"16502","chr3",101779608,101779630,23,1,70,94
"16503","chr3",102463884,102463901,18,146,121,285
"16504","chr3",104688054,104688072,19,43,61,123
"16505","chr3",105617962,105617980,19,55,9,83
"16506","chr3",106405922,106405957,36,77,121,234
"16507","chr3",106874790,106874814,25,29,106,160
"16508","chr3",107166358,107166379,22,26,119,167
"16509","chr3",107523219,107523247,29,6,24,59
"16510","chr3",107525317,107525371,55,40,15,110
"16511","chr3",107798836,107798865,30,10,7,47
"16512","chr3",107913234,107913254,21,8,54,83
"16513","chr3",109192273,109192304,32,105,4,141
"16514","chr3",109317706,109317733,28,146,32,206
"16515","chr3",109330301,109330345,45,77,6,128
"16516","chr3",109340800,109340830,31,75,143,249
"16517","chr3",109371776,109371802,27,77,95,199
"16518","chr3",109421528,109421547,20,75,35,130
"16519","chr3",109477904,109477969,66,68,29,163
"16520","chr3",109592926,109592944,19,71,142,232
"16521","chr3",110068525,110068560,36,9,43,88
"16522","chr3",110311064,110311084,21,76,71,168
"16523","chr3",110603510,110603533,24,76,142,242
"16524","chr3",110892691,110892710,20,8,29,57
"16525","chr3",111009336,111009377,42,28,30,100
"16526","chr3",111337701,111337735,35,32,74,141
"16527","chr3",112027634,112027652,19,77,27,123
"16528","chr3",112363200,112363222,23,99,18,140
"16529","chr3",112561655,112561689,35,75,32,142
"16530","chr3",113116841,113116878,38,75,89,202
"16531","chr3",113211709,113211744,36,67,32,135
"16532","chr3",113407143,113407160,18,113,20,151
"16533","chr3",113515620,113515641,22,129,6,157
"16534","chr3",113850779,113850816,38,4,80,122
"16535","chr3",113947695,113947724,30,77,33,140
"16536","chr3",113998307,113998329,23,66,73,162
"16537","chr3",115064444,115064468,25,75,18,118
"16538","chr3",115613972,115613989,18,3,6,27
"16539","chr3",115661475,115661497,23,27,128,178
"16540","chr3",117023697,117023731,35,136,132,303
"16541","chr3",117271404,117271426,23,52,74,149
"16542","chr3",118318013,118318036,24,139,76,239
"16543","chr3",118572070,118572098,29,9,16,54
"16544","chr3",119303787,119303813,27,127,55,209
"16545","chr3",119677004,119677036,33,23,67,123
"16546","chr3",119970614,119970637,24,27,29,80
"16547","chr3",120094385,120094408,24,2,108,134
"16548","chr3",120450712,120450732,21,16,27,64
"16549","chr3",120502738,120502759,22,13,56,91
"16550","chr3",121572237,121572257,21,6,40,67
"16551","chr3",121642080,121642098,19,68,7,94
"16552","chr3",121842004,121842035,32,78,8,118
"16553","chr3",122023785,122023815,31,26,14,71
"16554","chr3",122184289,122184309,21,93,30,144
"16555","chr3",122523505,122523569,65,42,6,113
"16556","chr3",122529754,122529771,18,4,6,28
"16557","chr3",122543261,122543290,30,3,95,128
"16558","chr3",122681195,122681219,25,73,17,115
"16559","chr3",122966858,122966901,44,7,145,196
"16560","chr3",123112535,123112560,26,70,60,156
"16561","chr3",123264797,123264815,19,24,74,117
"16562","chr3",123348037,123348089,53,121,131,305
"16563","chr3",123448118,123448146,29,22,25,76
"16564","chr3",123682177,123682200,24,86,142,252
"16565","chr3",123701238,123701257,20,34,45,99
"16566","chr3",123704748,123704770,23,77,27,127
"16567","chr3",123884352,123884384,33,140,23,196
"16568","chr3",124033259,124033330,72,19,4,95
"16569","chr3",124642807,124642826,20,68,16,104
"16570","chr3",124887046,124887095,50,1,43,94
"16571","chr3",124887906,124887935,30,10,10,50
"16572","chr3",124898644,124898675,32,29,74,135
"16573","chr3",125055821,125055851,31,22,11,64
"16574","chr3",125269206,125269224,19,70,139,228
"16575","chr3",125467085,125467103,19,11,72,102
"16576","chr3",125522391,125522412,22,137,4,163
"16577","chr3",125595842,125595861,20,8,72,100
"16578","chr3",125644029,125644061,33,3,42,78
"16579","chr3",125747219,125747236,18,110,136,264
"16580","chr3",125761118,125761144,27,73,144,244
"16581","chr3",125805714,125805734,21,37,75,133
"16582","chr3",125911768,125911792,25,53,117,195
"16583","chr3",126357535,126357578,44,3,110,157
"16584","chr3",126535558,126535575,18,123,10,151
"16585","chr3",126934537,126934566,30,76,59,165
"16586","chr3",126982996,126983027,32,22,31,85
"16587","chr3",126983208,126983271,64,29,26,119
"16588","chr3",127280933,127280954,22,54,6,82
"16589","chr3",127547775,127547885,111,7,31,149
"16590","chr3",127618556,127618574,19,14,100,133
"16591","chr3",127672839,127672862,24,43,34,101
"16592","chr3",127737631,127737659,29,73,83,185
"16593","chr3",127788868,127788887,20,96,124,240
"16594","chr3",128005362,128005407,46,8,1,55
"16595","chr3",128008164,128008190,27,30,78,135
"16596","chr3",128076963,128076981,19,22,96,137
"16597","chr3",128497941,128497973,33,70,139,242
"16598","chr3",128651030,128651067,38,8,56,102
"16599","chr3",128651896,128651923,28,76,4,108
"16600","chr3",128652578,128652611,34,9,27,70
"16601","chr3",128658437,128658460,24,13,54,91
"16602","chr3",128666026,128666048,23,27,132,182
"16603","chr3",128669422,128669453,32,1,32,65
"16604","chr3",128697895,128697923,29,50,145,224
"16605","chr3",128824838,128824889,52,20,88,160
"16606","chr3",128857746,128857766,21,149,6,176
"16607","chr3",128948378,128948404,27,31,8,66
"16608","chr3",129084897,129084917,21,78,10,109
"16609","chr3",129094506,129094533,28,9,50,87
"16610","chr3",129121679,129121714,36,22,4,62
"16611","chr3",129125096,129125113,18,75,135,228
"16612","chr3",129206965,129206982,18,15,5,38
"16613","chr3",129210936,129210954,19,8,74,101
"16614","chr3",129245085,129245135,51,92,122,265
"16615","chr3",129263015,129263035,21,68,48,137
"16616","chr3",129333088,129333105,18,10,115,143
"16617","chr3",129399357,129399376,20,37,23,80
"16618","chr3",129530507,129530568,62,139,27,228
"16619","chr3",129627539,129627570,32,107,56,195
"16620","chr3",129639245,129639271,27,9,79,115
"16621","chr3",130673011,130673029,19,77,73,169
"16622","chr3",130894164,130894190,27,14,27,68
"16623","chr3",131087236,131087258,23,41,50,114
"16624","chr3",131958971,131959018,48,8,52,108
"16625","chr3",132277587,132277626,40,118,67,225
"16626","chr3",133424213,133424241,29,29,81,139
"16627","chr3",133502130,133502186,57,28,76,161
"16628","chr3",133502184,133502296,113,4,22,139
"16629","chr3",133804096,133804128,33,33,6,72
"16630","chr3",133889389,133889445,57,69,44,170
"16631","chr3",133895650,133895685,36,1,53,90
"16632","chr3",133927527,133927545,19,60,112,191
"16633","chr3",133962067,133962095,29,74,16,119
"16634","chr3",134030034,134030061,28,48,16,92
"16635","chr3",134250656,134250674,19,2,101,122
"16636","chr3",134327627,134327648,22,72,98,192
"16637","chr3",134374902,134374938,37,81,146,264
"16638","chr3",134397388,134397419,32,18,43,93
"16639","chr3",134397698,134397719,22,27,4,53
"16640","chr3",134462965,134463003,39,124,136,299
"16641","chr3",135692833,135692863,31,12,5,48
"16642","chr3",135910452,135910488,37,76,123,236
"16643","chr3",135929025,135929043,19,46,70,135
"16644","chr3",135965669,135965699,31,25,84,140
"16645","chr3",135966037,135966058,22,125,15,162
"16646","chr3",136140913,136140941,29,112,3,144
"16647","chr3",136180700,136180734,35,20,6,61
"16648","chr3",136180740,136180819,80,105,34,219
"16649","chr3",136238846,136238873,28,31,74,133
"16650","chr3",136264875,136264895,21,129,74,224
"16651","chr3",136630200,136630218,19,56,1,76
"16652","chr3",136679729,136679752,24,145,6,175
"16653","chr3",137162073,137162104,32,8,97,137
"16654","chr3",138159204,138159231,28,12,63,103
"16655","chr3",138198494,138198525,32,71,44,147
"16656","chr3",138256403,138256427,25,120,11,156
"16657","chr3",138423978,138424024,47,88,7,142
"16658","chr3",138556528,138556551,24,28,74,126
"16659","chr3",138799177,138799195,19,75,51,145
"16660","chr3",138810923,138810942,20,144,71,235
"16661","chr3",138817339,138817366,28,145,5,178
"16662","chr3",138827987,138828010,24,89,8,121
"16663","chr3",138828185,138828203,19,8,37,64
"16664","chr3",138830553,138830575,23,101,74,198
"16665","chr3",138835008,138835033,26,16,142,184
"16666","chr3",138848169,138848194,26,28,75,129
"16667","chr3",138858552,138858573,22,27,5,54
"16668","chr3",138885134,138885157,24,10,112,146
"16669","chr3",138939916,138939951,36,107,127,270
"16670","chr3",140154642,140154662,21,76,61,158
"16671","chr3",140490013,140490089,77,9,59,145
"16672","chr3",140671687,140671704,18,77,112,207
"16673","chr3",141051397,141051432,36,1,10,47
"16674","chr3",141486916,141486962,47,40,10,97
"16675","chr3",141660192,141660211,20,17,30,67
"16676","chr3",141661349,141661369,21,45,13,79
"16677","chr3",141943889,141943906,18,137,5,160
"16678","chr3",141968245,141969288,1044,148,4,1196
"16679","chr3",142227398,142227469,72,53,3,128
"16680","chr3",142362581,142362607,27,91,131,249
"16681","chr3",142362625,142362648,24,132,87,243
"16682","chr3",142572066,142572087,22,8,145,175
"16683","chr3",142599751,142599769,19,72,23,114
"16684","chr3",142895289,142895372,84,2,6,92
"16685","chr3",143868867,143868892,26,76,93,195
"16686","chr3",144485700,144485722,23,69,75,167
"16687","chr3",146008708,146008736,29,59,3,91
"16688","chr3",146163316,146163333,18,29,75,122
"16689","chr3",146792586,146792609,24,11,44,79
"16690","chr3",146807256,146807274,19,8,135,162
"16691","chr3",147394469,147394487,19,75,120,214
"16692","chr3",147397327,147397344,18,30,106,154
"16693","chr3",147409990,147410042,53,66,2,121
"16694","chr3",147476724,147476744,21,76,1,98
"16695","chr3",147609543,147609570,28,76,132,236
"16696","chr3",147825976,147825997,22,53,26,101
"16697","chr3",148822125,148822143,19,145,27,191
"16698","chr3",149057108,149057136,29,5,7,41
"16699","chr3",149077248,149077294,47,33,74,154
"16700","chr3",149096751,149096769,19,61,73,153
"16701","chr3",149141520,149141552,33,9,9,51
"16702","chr3",149144215,149144233,19,77,33,129
"16703","chr3",149212138,149212159,22,74,27,123
"16704","chr3",149224344,149224368,25,77,27,129
"16705","chr3",149267646,149267664,19,108,116,243
"16706","chr3",149446899,149446951,53,63,56,172
"16707","chr3",149651993,149652015,23,28,78,129
"16708","chr3",149658143,149658168,26,70,27,123
"16709","chr3",149659332,149659350,19,76,77,172
"16710","chr3",149670645,149670678,34,33,73,140
"16711","chr3",149970906,149970963,58,41,94,193
"16712","chr3",150082530,150082552,23,104,6,133
"16713","chr3",150565789,150565812,24,7,80,111
"16714","chr3",150665516,150665533,18,136,75,229
"16715","chr3",150747779,150747811,33,106,33,172
"16716","chr3",150747788,150747814,27,109,24,160
"16717","chr3",150747965,150747987,23,4,5,32
"16718","chr3",151086804,151086821,18,63,23,104
"16719","chr3",151229474,151229496,23,76,75,174
"16720","chr3",151273403,151273422,20,37,135,192
"16721","chr3",152194292,152194315,24,77,27,128
"16722","chr3",152776711,152776736,26,69,132,227
"16723","chr3",153071341,153071367,27,75,143,245
"16724","chr3",153194943,153194966,24,67,1,92
"16725","chr3",153312112,153312129,18,76,47,141
"16726","chr3",153867830,153867848,19,100,58,177
"16727","chr3",154848535,154848564,30,100,74,204
"16728","chr3",154977408,154977426,19,141,75,235
"16729","chr3",155726863,155726893,31,29,143,203
"16730","chr3",155781769,155781790,22,9,6,37
"16731","chr3",155821769,155821786,18,4,8,30
"16732","chr3",155823698,155823730,33,77,46,156
"16733","chr3",155933194,155933219,26,75,72,173
"16734","chr3",155994160,155994188,29,88,5,122
"16735","chr3",156182696,156182718,23,129,92,244
"16736","chr3",156674864,156674889,26,147,23,196
"16737","chr3",156816142,156816164,23,28,68,119
"16738","chr3",157142669,157142691,23,12,90,125
"16739","chr3",157159984,157160011,28,33,81,142
"16740","chr3",157506016,157506036,21,19,143,183
"16741","chr3",158102930,158102955,26,33,99,158
"16742","chr3",158105756,158105832,77,35,25,137
"16743","chr3",158105810,158105854,45,57,41,143
"16744","chr3",158106167,158106261,95,58,26,179
"16745","chr3",158106572,158106636,65,70,97,232
"16746","chr3",158117882,158117912,31,14,36,81
"16747","chr3",158643500,158643523,24,14,39,77
"16748","chr3",158733281,158733300,20,18,71,109
"16749","chr3",159165789,159165810,22,38,67,127
"16750","chr3",159742835,159742858,24,28,75,127
"16751","chr3",159764483,159764502,20,29,34,83
"16752","chr3",159764661,159764693,33,28,59,120
"16753","chr3",160530135,160530159,25,119,6,150
"16754","chr3",160755575,160755604,30,17,121,168
"16755","chr3",161024265,161024282,18,13,6,37
"16756","chr3",161906019,161906037,19,23,101,143
"16757","chr3",162044752,162044774,23,51,1,75
"16758","chr3",162690519,162690538,20,8,37,65
"16759","chr3",164340908,164340928,21,149,102,272
"16760","chr3",164947289,164947314,26,54,4,84
"16761","chr3",165399085,165399132,48,119,6,173
"16762","chr3",165861316,165861460,145,7,143,295
"16763","chr3",166055609,166055678,70,21,26,117
"16764","chr3",166065555,166065587,33,37,113,183
"16765","chr3",166932332,166932355,24,128,74,226
"16766","chr3",167070064,167070085,22,77,35,134
"16767","chr3",167327914,167327934,21,95,74,190
"16768","chr3",169149078,169149097,20,130,43,193
"16769","chr3",169659073,169659091,19,6,6,31
"16770","chr3",169772317,169772337,21,56,113,190
"16771","chr3",169814480,169814504,25,37,93,155
"16772","chr3",169966955,169966977,23,15,1,39
"16773","chr3",170017859,170017879,21,78,6,105
"16774","chr3",170038081,170038105,25,12,20,57
"16775","chr3",170041299,170041319,21,8,101,130
"16776","chr3",170063534,170063574,41,92,6,139
"16777","chr3",170150532,170150554,23,136,35,194
"16778","chr3",170165754,170165778,25,23,6,54
"16779","chr3",170198020,170198077,58,128,74,260
"16780","chr3",170234032,170234050,19,77,47,143
"16781","chr3",170285079,170285097,19,76,131,226
"16782","chr3",170295676,170295695,20,77,74,171
"16783","chr3",170357731,170357757,27,19,3,49
"16784","chr3",170404146,170404175,30,76,143,249
"16785","chr3",170549215,170549233,19,77,139,235
"16786","chr3",170948564,170948586,23,37,73,133
"16787","chr3",171459676,171459711,36,125,140,301
"16788","chr3",171467283,171467301,19,79,108,206
"16789","chr3",171582278,171582296,19,117,108,244
"16790","chr3",171697238,171697262,25,8,142,175
"16791","chr3",171808540,171808560,21,34,2,57
"16792","chr3",171808816,171808842,27,76,11,114
"16793","chr3",172006047,172006076,30,143,85,258
"16794","chr3",172011772,172011789,18,140,126,284
"16795","chr3",172039625,172039666,42,11,2,55
"16796","chr3",172611806,172611841,36,86,2,124
"16797","chr3",172735642,172735667,26,8,51,85
"16798","chr3",174501078,174501096,19,8,89,116
"16799","chr3",176419516,176419547,32,8,97,137
"16800","chr3",176813730,176813765,36,9,55,100
"16801","chr3",177217025,177217046,22,76,106,204
"16802","chr3",177218237,177218269,33,68,72,173
"16803","chr3",177218250,177218277,28,76,59,163
"16804","chr3",177218566,177218598,33,7,137,177
"16805","chr3",177283653,177283678,26,76,146,248
"16806","chr3",177313675,177313709,35,3,21,59
"16807","chr3",177315663,177315680,18,52,144,214
"16808","chr3",177315667,177315700,34,72,140,246
"16809","chr3",177353989,177354010,22,5,57,84
"16810","chr3",177365841,177365863,23,33,69,125
"16811","chr3",177394832,177394883,52,70,14,136
"16812","chr3",177435072,177435101,30,5,87,122
"16813","chr3",177534420,177534439,20,9,147,176
"16814","chr3",177593207,177593225,19,75,30,124
"16815","chr3",177809012,177809035,24,6,42,72
"16816","chr3",178308580,178308598,19,27,76,122
"16817","chr3",178379309,178379330,22,113,8,143
"16818","chr3",178810903,178810925,23,29,74,126
"16819","chr3",179173405,179173428,24,76,25,125
"16820","chr3",179346752,179346787,36,6,7,49
"16821","chr3",179347119,179347141,23,80,96,199
"16822","chr3",179359420,179359438,19,126,11,156
"16823","chr3",179359597,179359619,23,35,16,74
"16824","chr3",179639838,179639860,23,19,124,166
"16825","chr3",179653183,179653208,26,14,67,107
"16826","chr3",179654214,179654232,19,133,6,158
"16827","chr3",179829944,179829968,25,29,75,129
"16828","chr3",180785288,180785310,23,4,6,33
"16829","chr3",180796437,180796485,49,70,81,200
"16830","chr3",181674330,181674361,32,67,4,103
"16831","chr3",181715434,181715483,50,27,28,105
"16832","chr3",181726992,181727020,29,9,35,73
"16833","chr3",181783898,181783920,23,144,26,193
"16834","chr3",181860636,181860658,23,4,103,130
"16835","chr3",181897339,181897360,22,8,20,50
"16836","chr3",182598750,182598783,34,112,5,151
"16837","chr3",182645609,182645629,21,29,76,126
"16838","chr3",182793445,182793468,24,56,17,97
"16839","chr3",182930975,182930998,24,70,73,167
"16840","chr3",182980542,182980560,19,15,27,61
"16841","chr3",183005085,183005109,25,29,4,58
"16842","chr3",183040099,183040127,29,141,3,173
"16843","chr3",183153175,183153192,18,43,6,67
"16844","chr3",183161381,183161407,27,7,96,130
"16845","chr3",183163953,183163988,36,17,38,91
"16846","chr3",183177509,183177526,18,76,75,169
"16847","chr3",183192137,183192155,19,7,129,155
"16848","chr3",183355614,183355638,25,28,75,128
"16849","chr3",183525270,183525295,26,120,68,214
"16850","chr3",183546912,183546929,18,58,123,199
"16851","chr3",183608972,183608990,19,5,8,32
"16852","chr3",183639630,183639653,24,33,6,63
"16853","chr3",183692220,183692258,39,70,5,114
"16854","chr3",183697722,183697745,24,62,4,90
"16855","chr3",183795981,183795999,19,7,114,140
"16856","chr3",183820907,183820924,18,56,74,148
"16857","chr3",183855956,183855991,36,95,78,209
"16858","chr3",183891687,183891853,167,36,120,323
"16859","chr3",183990107,183990125,19,74,141,234
"16860","chr3",184107325,184107349,25,69,4,98
"16861","chr3",184138960,184138985,26,6,60,92
"16862","chr3",184153015,184153049,35,148,74,257
"16863","chr3",184155446,184155473,28,7,12,47
"16864","chr3",184248017,184248034,18,36,71,125
"16865","chr3",184254541,184254559,19,141,35,195
"16866","chr3",184261471,184261542,72,25,32,129
"16867","chr3",184309464,184309487,24,74,75,173
"16868","chr3",184379814,184379851,38,52,112,202
"16869","chr3",184380176,184380204,29,14,11,54
"16870","chr3",184411952,184411974,23,7,111,141
"16871","chr3",184414465,184414929,465,58,141,664
"16872","chr3",184492024,184492073,50,22,5,77
"16873","chr3",184562182,184562216,35,26,13,74
"16874","chr3",184562251,184562277,27,50,37,114
"16875","chr3",184562301,184562329,29,13,32,74
"16876","chr3",184568881,184568907,27,50,28,105
"16877","chr3",184569550,184569575,26,121,2,149
"16878","chr3",184686839,184686865,27,145,74,246
"16879","chr3",184693608,184693632,25,15,74,114
"16880","chr3",185075593,185075619,27,72,73,172
"16881","chr3",185136726,185136749,24,132,72,228
"16882","chr3",185264403,185264424,22,9,90,121
"16883","chr3",185327929,185328020,92,19,106,217
"16884","chr3",185345229,185345256,28,129,78,235
"16885","chr3",185380188,185380206,19,123,4,146
"16886","chr3",185529892,185529993,102,42,41,185
"16887","chr3",185587733,185587752,20,8,75,103
"16888","chr3",185637137,185637176,40,48,3,91
"16889","chr3",185661636,185661657,22,42,7,71
"16890","chr3",185762367,185762386,20,148,69,237
"16891","chr3",185797898,185797920,23,148,98,269
"16892","chr3",185864468,185864496,29,71,72,172
"16893","chr3",185944929,185944955,27,5,5,37
"16894","chr3",186036672,186036689,18,75,50,143
"16895","chr3",186069502,186069520,19,44,95,158
"16896","chr3",186120958,186120979,22,8,108,138
"16897","chr3",186141184,186141219,36,6,83,125
"16898","chr3",186194804,186194822,19,12,43,74
"16899","chr3",186239202,186239227,26,72,101,199
"16900","chr3",186424850,186424873,24,145,13,182
"16901","chr3",186723759,186723777,19,114,132,265
"16902","chr3",186774157,186774176,20,101,125,246
"16903","chr3",186776833,186776868,36,8,117,161
"16904","chr3",186802024,186802045,22,112,5,139
"16905","chr3",186815008,186815030,23,77,118,218
"16906","chr3",186948529,186948585,57,27,80,164
"16907","chr3",186992481,186992507,27,143,100,270
"16908","chr3",187000396,187000413,18,78,25,121
"16909","chr3",187139057,187139087,31,25,76,132
"16910","chr3",187306510,187306557,48,64,12,124
"16911","chr3",187329580,187329618,39,87,5,131
"16912","chr3",187528855,187528878,24,76,26,126
"16913","chr3",187753416,187753436,21,16,75,112
"16914","chr3",188005408,188005432,25,45,6,76
"16915","chr3",188150396,188150415,20,145,27,192
"16916","chr3",188154158,188154214,57,27,1,85
"16917","chr3",188154188,188154228,41,41,5,87
"16918","chr3",188230774,188230796,23,24,15,62
"16919","chr3",188294057,188294083,27,51,83,161
"16920","chr3",188311188,188311205,18,134,89,241
"16921","chr3",188475905,188475923,19,115,4,138
"16922","chr3",188735373,188735394,22,3,81,106
"16923","chr3",189477468,189477496,29,128,5,162
"16924","chr3",189880228,189880262,35,3,26,64
"16925","chr3",189987480,189987498,19,101,5,125
"16926","chr3",190119125,190119210,86,54,54,194
"16927","chr3",190120677,190120705,29,63,90,182
"16928","chr3",190751184,190751204,21,8,27,56
"16929","chr3",190834034,190834058,25,83,23,131
"16930","chr3",191037368,191037389,22,76,115,213
"16931","chr3",191137067,191137090,24,8,5,37
"16932","chr3",191195881,191195907,27,78,94,199
"16933","chr3",191234697,191234714,18,97,74,189
"16934","chr3",192197947,192197971,25,144,5,174
"16935","chr3",192245273,192245295,23,33,133,189
"16936","chr3",192409061,192409101,41,55,12,108
"16937","chr3",192905636,192905681,46,75,75,196
"16938","chr3",192931303,192931321,19,136,67,222
"16939","chr3",193241119,193241142,24,12,39,75
"16940","chr3",193721938,193721967,30,73,18,121
"16941","chr3",194134845,194134862,18,34,7,59
"16942","chr3",194135038,194135073,36,15,4,55
"16943","chr3",194141542,194141564,23,48,29,100
"16944","chr3",194141580,194141600,21,1,83,105
"16945","chr3",194270211,194270248,38,4,139,181
"16946","chr3",194295979,194295996,18,145,77,240
"16947","chr3",194296850,194296881,32,24,127,183
"16948","chr3",194299598,194299634,37,8,139,184
"16949","chr3",194338830,194338852,23,56,42,121
"16950","chr3",194374694,194374713,20,76,104,200
"16951","chr3",194383195,194383213,19,115,66,200
"16952","chr3",194396037,194396054,18,21,11,50
"16953","chr3",194410297,194410331,35,22,121,178
"16954","chr3",194558009,194558031,23,79,13,115
"16955","chr3",194583890,194583921,32,73,109,214
"16956","chr3",194599560,194599601,42,75,58,175
"16957","chr3",194613157,194613191,35,96,102,233
"16958","chr3",194728614,194728653,40,52,144,236
"16959","chr3",194791463,194791480,18,123,126,267
"16960","chr3",194850910,194850947,38,6,146,190
"16961","chr3",194954720,194954772,53,20,74,147
"16962","chr3",195162097,195162114,18,12,124,154
"16963","chr3",195245160,195245178,19,76,12,107
"16964","chr3",195456812,195456846,35,8,136,179
"16965","chr3",195634246,195634269,24,6,22,52
"16966","chr3",195634560,195634578,19,85,4,108
"16967","chr3",195658131,195658158,28,28,51,107
"16968","chr3",195732320,195732377,58,76,135,269
"16969","chr3",195747963,195747996,34,10,121,165
"16970","chr3",195811126,195811190,65,7,24,96
"16971","chr3",195857225,195857271,47,7,35,89
"16972","chr3",195857564,195857612,49,42,1,92
"16973","chr3",195869452,195869469,18,9,17,44
"16974","chr3",195884646,195884664,19,48,71,138
"16975","chr3",195909759,195909780,22,25,12,59
"16976","chr3",195926654,195926676,23,8,21,52
"16977","chr3",195955063,195955088,26,6,83,115
"16978","chr3",195990197,195990224,28,53,26,107
"16979","chr3",196119144,196119162,19,76,8,103
"16980","chr3",196143441,196143476,36,8,26,70
"16981","chr3",196166789,196166807,19,65,80,164
"16982","chr3",196196930,196196950,21,43,43,107
"16983","chr3",196206660,196206695,36,72,69,177
"16984","chr3",196207627,196207688,62,51,45,158
"16985","chr3",196207724,196207750,27,113,18,158
"16986","chr3",196207932,196207955,24,42,6,72
"16987","chr3",196226774,196226806,33,25,6,64
"16988","chr3",196263633,196263652,20,10,137,167
"16989","chr3",196325953,196325991,39,75,46,160
"16990","chr3",196424704,196424722,19,10,108,137
"16991","chr3",196432404,196432421,18,23,10,51
"16992","chr3",196451689,196451723,35,107,53,195
"16993","chr3",196456317,196456343,27,4,74,105
"16994","chr3",196468265,196468294,30,8,79,117
"16995","chr3",196491314,196491344,31,125,73,229
"16996","chr3",196509217,196509237,21,29,75,125
"16997","chr3",196528446,196528486,41,40,6,87
"16998","chr3",196569045,196569071,27,114,3,144
"16999","chr3",196570701,196570729,29,8,86,123
"17000","chr3",196621379,196621403,25,105,71,201
"17001","chr3",196655544,196655562,19,111,65,195
"17002","chr3",196659297,196659318,22,38,64,124
"17003","chr3",196682934,196682971,38,20,55,113
"17004","chr3",196700232,196700250,19,10,5,34
"17005","chr3",196740043,196740067,25,23,23,71
"17006","chr3",196808558,196808575,18,140,77,235
"17007","chr3",196852961,196852983,23,20,74,117
"17008","chr3",196979507,196979531,25,73,6,104
"17009","chr3",197038138,197038172,35,5,11,51
"17010","chr3",197305695,197305718,24,115,74,213
"17011","chr3",197381871,197381892,22,32,63,117
"17012","chr3",197405924,197405941,18,18,70,106
"17013","chr3",197464105,197464152,48,7,106,161
"17014","chr3",197542522,197542540,19,8,83,110
"17015","chr3",197555249,197555268,20,98,48,166
"17016","chr3",197594275,197594292,18,73,93,184
"17017","chr3",197600383,197600405,23,20,108,151
"17018","chr3",197627787,197627814,28,53,26,107
"17019","chr3",197666186,197666224,39,58,111,208
"17020","chr3",197755612,197755659,48,23,144,215
"17021","chr3",197771777,197771797,21,124,6,151
"17022","chr3",197776385,197776404,20,39,63,122
"17023","chr3",197828704,197828724,21,7,86,114
"17024","chr3",197915164,197915221,58,48,74,180
"17025","chr3",197987159,197987177,19,8,126,153
"17026","chr4",270426,270451,26,123,6,155
"17027","chr4",299863,299882,20,103,143,266
"17028","chr4",407551,407582,32,74,67,173
"17029","chr4",576097,576126,30,3,131,164
"17030","chr4",576233,576263,31,140,56,227
"17031","chr4",698495,698517,23,83,5,111
"17032","chr4",698522,698560,39,23,46,108
"17033","chr4",758166,758192,27,89,8,124
"17034","chr4",813265,813283,19,8,81,108
"17035","chr4",826222,826506,285,47,16,348
"17036","chr4",843849,843867,19,145,27,191
"17037","chr4",847013,847030,18,81,64,163
"17038","chr4",894979,895017,39,133,75,247
"17039","chr4",952698,952720,23,127,135,285
"17040","chr4",973352,973374,23,4,25,52
"17041","chr4",987578,987595,18,25,31,74
"17042","chr4",1003182,1003199,18,1,75,94
"17043","chr4",1009653,1009687,35,48,14,97
"17044","chr4",1011392,1011417,26,86,36,148
"17045","chr4",1011702,1011724,23,29,21,73
"17046","chr4",1012004,1012030,27,85,22,134
"17047","chr4",1012103,1012125,23,60,62,145
"17048","chr4",1025267,1025305,39,75,73,187
"17049","chr4",1041433,1041459,27,71,128,226
"17050","chr4",1113834,1113852,19,15,84,118
"17051","chr4",1248861,1248883,23,19,66,108
"17052","chr4",1249245,1249264,20,45,134,199
"17053","chr4",1265696,1265722,27,36,31,94
"17054","chr4",1294810,1294836,27,53,40,120
"17055","chr4",1303233,1303255,23,81,27,131
"17056","chr4",1345645,1345674,30,66,74,170
"17057","chr4",1403680,1403706,27,47,7,81
"17058","chr4",1417548,1417565,18,16,72,106
"17059","chr4",1568662,1568754,93,13,34,140
"17060","chr4",1600652,1600674,23,43,90,156
"17061","chr4",1608114,1608136,23,63,4,90
"17062","chr4",1633653,1633670,18,99,139,256
"17063","chr4",1651951,1653130,1180,65,24,1269
"17064","chr4",1671225,1671248,24,44,12,80
"17065","chr4",1671431,1671460,30,39,24,93
"17066","chr4",1671543,1671572,30,100,12,142
"17067","chr4",1672760,1672787,28,36,60,124
"17068","chr4",1688319,1688341,23,5,104,132
"17069","chr4",1721702,1721731,30,41,13,84
"17070","chr4",1730035,1730057,23,9,54,86
"17071","chr4",1742105,1742122,18,42,64,124
"17072","chr4",1793205,1793247,43,18,48,109
"17073","chr4",1793715,1793741,27,21,3,51
"17074","chr4",1801152,1801169,18,1,135,154
"17075","chr4",1847825,1847848,24,79,73,176
"17076","chr4",1850645,1850665,21,130,22,173
"17077","chr4",1871335,1871369,35,1,64,100
"17078","chr4",1896745,1896855,111,114,67,292
"17079","chr4",1932440,1932460,21,142,73,236
"17080","chr4",2042402,2042420,19,24,26,69
"17081","chr4",2058931,2058948,18,1,16,35
"17082","chr4",2059377,2059420,44,66,55,165
"17083","chr4",2138894,2138922,29,47,74,150
"17084","chr4",2242828,2242846,19,72,105,196
"17085","chr4",2262612,2262630,19,22,34,75
"17086","chr4",2278220,2278238,19,41,27,87
"17087","chr4",2279431,2279449,19,99,43,161
"17088","chr4",2312727,2312751,25,108,7,140
"17089","chr4",2344900,2344928,29,11,2,42
"17090","chr4",2369834,2369869,36,77,30,143
"17091","chr4",2387057,2387082,26,11,1,38
"17092","chr4",2418707,2418732,26,13,131,170
"17093","chr4",2454556,2454640,85,37,26,148
"17094","chr4",2456951,2456970,20,14,13,47
"17095","chr4",2504727,2504747,21,73,134,228
"17096","chr4",2508912,2508936,25,8,11,44
"17097","chr4",2536157,2536184,28,70,55,153
"17098","chr4",2536569,2536591,23,39,19,81
"17099","chr4",2536598,2536633,36,5,34,75
"17100","chr4",2540469,2540488,20,98,5,123
"17101","chr4",2549383,2549414,32,76,12,120
"17102","chr4",2555607,2555633,27,43,111,181
"17103","chr4",2576090,2576111,22,123,126,271
"17104","chr4",2726951,2726970,20,139,5,164
"17105","chr4",2752131,2752166,36,113,48,197
"17106","chr4",2847121,2847143,23,122,70,215
"17107","chr4",2852139,2852332,194,64,10,268
"17108","chr4",2852279,2852341,63,5,2,70
"17109","chr4",2880464,2880493,30,76,107,213
"17110","chr4",3024857,3024878,22,37,9,68
"17111","chr4",3024874,3024893,20,52,58,130
"17112","chr4",3074223,3074254,32,121,66,219
"17113","chr4",3074877,3074940,64,33,31,128
"17114","chr4",3074939,3074968,30,61,6,97
"17115","chr4",3152814,3152833,20,38,75,133
"17116","chr4",3249503,3249520,18,85,127,230
"17117","chr4",3266741,3266765,25,136,6,167
"17118","chr4",3293109,3293132,24,13,22,59
"17119","chr4",3293304,3293352,49,25,12,86
"17120","chr4",3336092,3336125,34,94,6,134
"17121","chr4",3521973,3521998,26,147,34,207
"17122","chr4",3765932,3765953,22,45,31,98
"17123","chr4",3921434,3921470,37,21,89,147
"17124","chr4",4054375,4054400,26,75,64,165
"17125","chr4",4068401,4068418,18,74,36,128
"17126","chr4",4359920,4359943,24,75,144,243
"17127","chr4",4397946,4397971,26,7,19,52
"17128","chr4",4402372,4402405,34,8,76,118
"17129","chr4",4459728,4459750,23,1,119,143
"17130","chr4",4574978,4575007,30,61,99,190
"17131","chr4",4606616,4606644,29,76,47,152
"17132","chr4",4851967,4851985,19,59,59,137
"17133","chr4",4861474,4861503,30,62,12,104
"17134","chr4",5289686,5289715,30,25,75,130
"17135","chr4",5479077,5479138,62,77,130,269
"17136","chr4",5711492,5711511,20,30,36,86
"17137","chr4",5965370,5965387,18,92,54,164
"17138","chr4",5995475,5995518,44,60,14,118
"17139","chr4",6200659,6200688,30,25,4,59
"17140","chr4",6241882,6241900,19,10,30,59
"17141","chr4",6259789,6259809,21,99,84,204
"17142","chr4",6304816,6304835,20,54,10,84
"17143","chr4",6316062,6316088,27,7,5,39
"17144","chr4",6379988,6380010,23,41,105,169
"17145","chr4",6425814,6425902,89,79,72,240
"17146","chr4",6471997,6472054,58,75,57,190
"17147","chr4",6525406,6525436,31,51,5,87
"17148","chr4",6548220,6548249,30,5,41,76
"17149","chr4",6576804,6576821,18,120,26,164
"17150","chr4",6624807,6624829,23,14,29,66
"17151","chr4",6678041,6678073,33,2,63,98
"17152","chr4",6713993,6714019,27,7,18,52
"17153","chr4",6718785,6718802,18,39,40,97
"17154","chr4",6912379,6912419,41,134,75,250
"17155","chr4",6987207,6987225,19,8,102,129
"17156","chr4",6987268,6987285,18,1,41,60
"17157","chr4",7034059,7034077,19,80,35,134
"17158","chr4",7042780,7042798,19,3,9,31
"17159","chr4",7192755,7192775,21,30,16,67
"17160","chr4",7208636,7208659,24,12,51,87
"17161","chr4",7240928,7240947,20,71,70,161
"17162","chr4",7621303,7621608,306,21,118,445
"17163","chr4",7636371,7636405,35,3,57,95
"17164","chr4",7663709,7663753,45,44,21,110
"17165","chr4",7674574,7674605,32,74,73,179
"17166","chr4",7723419,7723436,18,41,105,164
"17167","chr4",7844283,7844302,20,47,21,88
"17168","chr4",7880279,7880297,19,8,1,28
"17169","chr4",7982702,7982722,21,77,17,115
"17170","chr4",8040611,8040640,30,88,74,192
"17171","chr4",8066333,8066363,31,3,47,81
"17172","chr4",8066361,8066430,70,70,19,159
"17173","chr4",8418866,8418900,35,31,67,133
"17174","chr4",8621876,8621894,19,35,135,189
"17175","chr4",8624585,8624609,25,15,3,43
"17176","chr4",8627514,8627535,22,35,135,192
"17177","chr4",8630226,8630245,20,15,3,38
"17178","chr4",8633152,8633169,18,35,135,188
"17179","chr4",8635868,8635895,28,15,3,46
"17180","chr4",8860951,8860988,38,42,11,91
"17181","chr4",8890051,8890068,18,134,6,158
"17182","chr4",8997830,8997862,33,124,45,202
"17183","chr4",9002916,9002935,20,71,33,124
"17184","chr4",9056892,9056912,21,80,50,151
"17185","chr4",9146867,9146890,24,26,3,53
"17186","chr4",9496603,9496638,36,55,11,102
"17187","chr4",9529141,9529161,21,96,6,123
"17188","chr4",9712251,9712272,22,7,129,158
"17189","chr4",9769082,9769099,18,34,46,98
"17190","chr4",10064707,10064725,19,77,27,123
"17191","chr4",10116586,10116609,24,7,3,34
"17192","chr4",10410716,10410736,21,34,1,56
"17193","chr4",10504117,10504138,22,8,109,139
"17194","chr4",10610034,10610074,41,8,67,116
"17195","chr4",11429644,11429673,30,76,1,107
"17196","chr4",11920999,11921040,42,11,74,127
"17197","chr4",12027188,12027207,20,41,83,144
"17198","chr4",12263258,12263290,33,52,108,193
"17199","chr4",12783731,12783761,31,8,75,114
"17200","chr4",12803472,12803497,26,17,67,110
"17201","chr4",13627498,13627570,73,99,95,267
"17202","chr4",15003113,15003136,24,42,24,90
"17203","chr4",15003255,15003277,23,93,140,256
"17204","chr4",15003724,15003749,26,1,16,43
"17205","chr4",15004115,15004134,20,42,61,123
"17206","chr4",15250743,15250770,28,114,75,217
"17207","chr4",15259477,15259518,42,77,35,154
"17208","chr4",15318602,15318621,20,35,121,176
"17209","chr4",15407927,15407949,23,110,6,139
"17210","chr4",15440407,15440425,19,8,89,116
"17211","chr4",15873039,15873078,40,113,6,159
"17212","chr4",15920131,15920171,41,46,40,127
"17213","chr4",16226554,16226574,21,3,24,48
"17214","chr4",16226627,16226650,24,15,31,70
"17215","chr4",16901783,16901806,24,15,9,48
"17216","chr4",16944897,16944930,34,111,67,212
"17217","chr4",17446259,17446290,32,20,143,195
"17218","chr4",17476437,17476523,87,93,67,247
"17219","chr4",17606330,17606355,26,44,141,211
"17220","chr4",17626964,17626982,19,77,17,113
"17221","chr4",17688681,17688707,27,74,69,170
"17222","chr4",17747921,17747948,28,71,6,105
"17223","chr4",17748104,17748128,25,80,74,179
"17224","chr4",17775171,17775202,32,26,68,126
"17225","chr4",18021687,18021727,41,29,34,104
"17226","chr4",18440785,18440824,40,86,59,185
"17227","chr4",20251997,20252025,29,17,44,90
"17228","chr4",20518552,20518588,37,42,95,174
"17229","chr4",20518588,20518622,35,8,59,102
"17230","chr4",21177671,21177709,39,143,136,318
"17231","chr4",22497760,22497782,23,132,20,175
"17232","chr4",22511882,22511914,33,76,22,131
"17233","chr4",22515679,22515697,19,7,132,158
"17234","chr4",22516046,22516063,18,26,6,50
"17235","chr4",22623507,22623537,31,8,106,145
"17236","chr4",22864808,22864830,23,77,27,127
"17237","chr4",23244411,23244435,25,105,10,140
"17238","chr4",23552362,23552381,20,8,34,62
"17239","chr4",23603522,23603546,25,89,27,141
"17240","chr4",23974800,23974827,28,28,52,108
"17241","chr4",24470272,24470325,54,92,57,203
"17242","chr4",24472664,24472696,33,88,126,247
"17243","chr4",24472778,24472809,32,97,12,141
"17244","chr4",24472922,24472951,30,26,91,147
"17245","chr4",25030640,25030658,19,55,24,98
"17246","chr4",25443649,25443666,18,83,6,107
"17247","chr4",25557772,25557797,26,21,1,48
"17248","chr4",25583379,25583398,20,77,75,172
"17249","chr4",25586794,25586812,19,75,15,109
"17250","chr4",25634376,25634417,42,7,128,177
"17251","chr4",25729713,25729734,22,117,43,182
"17252","chr4",25742182,25742201,20,6,75,101
"17253","chr4",25750235,25750266,32,117,5,154
"17254","chr4",25798833,25798856,24,59,1,84
"17255","chr4",25826661,25826709,49,36,15,100
"17256","chr4",25934038,25934070,33,86,50,169
"17257","chr4",26253308,26253329,22,8,2,32
"17258","chr4",26255404,26255426,23,53,6,82
"17259","chr4",26294064,26294113,50,74,139,263
"17260","chr4",26318997,26319021,25,24,6,55
"17261","chr4",26328994,26329012,19,77,33,129
"17262","chr4",26335618,26335637,20,6,7,33
"17263","chr4",26860925,26860942,18,26,80,124
"17264","chr4",27481885,27481920,36,123,72,231
"17265","chr4",27726308,27726326,19,15,78,112
"17266","chr4",28869795,28869820,26,77,1,104
"17267","chr4",29633992,29634013,22,77,34,133
"17268","chr4",29666132,29666156,25,17,4,46
"17269","chr4",29887562,29887613,52,87,1,140
"17270","chr4",30341109,30341128,20,84,26,130
"17271","chr4",30797245,30797287,43,5,26,74
"17272","chr4",31362129,31362146,18,75,6,99
"17273","chr4",31549954,31549974,21,76,26,123
"17274","chr4",32632739,32632766,28,78,122,228
"17275","chr4",33131636,33131664,29,106,2,137
"17276","chr4",34200909,34200937,29,8,17,54
"17277","chr4",34972008,34972032,25,7,144,176
"17278","chr4",34986613,34986691,79,28,69,176
"17279","chr4",36906763,36906815,53,40,6,99
"17280","chr4",37567651,37567674,24,110,132,266
"17281","chr4",37570147,37570171,25,29,26,80
"17282","chr4",37630357,37630382,26,8,71,105
"17283","chr4",37719922,37719955,34,77,35,146
"17284","chr4",37891044,37891089,46,116,54,216
"17285","chr4",38279019,38279042,24,94,74,192
"17286","chr4",38597162,38597194,33,8,12,53
"17287","chr4",38622190,38622211,22,6,105,133
"17288","chr4",38663526,38663550,25,46,4,75
"17289","chr4",38663970,38663997,28,39,88,155
"17290","chr4",38725104,38725127,24,77,77,178
"17291","chr4",38862931,38862954,24,15,109,148
"17292","chr4",38868053,38868080,28,145,37,210
"17293","chr4",38882319,38882341,23,88,67,178
"17294","chr4",39184411,39184435,25,27,5,57
"17295","chr4",39299916,39299946,31,42,73,146
"17296","chr4",39374610,39374631,22,38,20,80
"17297","chr4",39628681,39628700,20,96,4,120
"17298","chr4",39651433,39651471,39,13,122,174
"17299","chr4",39662508,39662526,19,99,7,125
"17300","chr4",39704870,39704890,21,78,67,166
"17301","chr4",39715026,39715043,18,8,59,85
"17302","chr4",39724584,39724610,27,66,34,127
"17303","chr4",39739443,39739462,20,6,33,59
"17304","chr4",39762011,39762028,18,144,25,187
"17305","chr4",39762937,39762963,27,87,136,250
"17306","chr4",39803707,39803728,22,62,98,182
"17307","chr4",39803726,39803744,19,78,79,176
"17308","chr4",39807712,39807749,38,80,74,192
"17309","chr4",39807892,39807921,30,70,78,178
"17310","chr4",39807910,39807955,46,104,60,210
"17311","chr4",39867550,39867570,21,77,14,112
"17312","chr4",39888242,39888265,24,114,146,284
"17313","chr4",39957787,39957806,20,80,5,105
"17314","chr4",39975107,39975128,22,144,75,241
"17315","chr4",39977560,39977582,23,7,83,113
"17316","chr4",39986359,39986392,34,74,5,113
"17317","chr4",39990285,39990302,18,147,75,240
"17318","chr4",39992910,39992936,27,6,64,97
"17319","chr4",40023183,40023220,38,72,74,184
"17320","chr4",40024625,40024660,36,146,34,216
"17321","chr4",40031501,40031526,26,66,93,185
"17322","chr4",40031682,40031703,22,29,79,130
"17323","chr4",40071891,40071914,24,65,120,209
"17324","chr4",40270960,40270985,26,75,67,168
"17325","chr4",40317757,40317791,35,102,22,159
"17326","chr4",40339663,40339681,19,77,77,173
"17327","chr4",40512414,40512433,20,147,14,181
"17328","chr4",40562462,40562482,21,7,42,70
"17329","chr4",40610611,40610631,21,9,73,103
"17330","chr4",40640999,40641032,34,42,6,82
"17331","chr4",40952186,40952206,21,58,6,85
"17332","chr4",41166574,41166607,34,5,127,166
"17333","chr4",41211457,41211499,43,7,100,150
"17334","chr4",41216420,41216447,28,5,1,34
"17335","chr4",41227713,41227736,24,51,75,150
"17336","chr4",41227738,41227760,23,75,50,148
"17337","chr4",41745775,41745795,21,20,128,169
"17338","chr4",41745976,41746022,47,81,74,202
"17339","chr4",42128767,42128789,23,148,85,256
"17340","chr4",42173919,42173956,38,72,70,180
"17341","chr4",42296115,42296157,43,21,66,130
"17342","chr4",42349670,42349690,21,69,33,123
"17343","chr4",42657254,42657271,18,59,49,126
"17344","chr4",42767193,42767218,26,129,6,161
"17345","chr4",43585889,43585915,27,135,25,187
"17346","chr4",43995035,43995053,19,144,25,188
"17347","chr4",44316796,44316823,28,127,26,181
"17348","chr4",45188516,45188541,26,66,75,167
"17349","chr4",46164216,46164248,33,77,133,243
"17350","chr4",46389991,46390028,38,6,71,115
"17351","chr4",46390186,46390213,28,9,19,56
"17352","chr4",47008630,47008650,21,77,107,205
"17353","chr4",47008854,47008882,29,9,20,58
"17354","chr4",47032129,47032161,33,97,15,145
"17355","chr4",47398769,47398807,39,7,126,172
"17356","chr4",47474188,47474208,21,145,25,191
"17357","chr4",47866138,47866159,22,56,99,177
"17358","chr4",48107900,48107925,26,149,34,209
"17359","chr4",48341707,48341732,26,6,75,107
"17360","chr4",48671667,48671686,20,128,74,222
"17361","chr4",48736851,48736883,33,33,118,184
"17362","chr4",48785849,48785873,25,8,121,154
"17363","chr4",49262220,49262237,18,36,7,61
"17364","chr4",49277080,49277105,26,49,59,134
"17365","chr4",49333158,49333181,24,61,47,132
"17366","chr4",49518145,49518170,26,34,131,191
"17367","chr4",49518170,49518201,32,65,106,203
"17368","chr4",51882770,51882788,19,55,71,145
"17369","chr4",52038077,52038095,19,77,33,129
"17370","chr4",52723691,52723725,35,35,3,73
"17371","chr4",52723702,52723754,53,64,23,140
"17372","chr4",53156399,53156426,28,23,74,125
"17373","chr4",53247868,53247893,26,98,67,191
"17374","chr4",53601075,53601093,19,23,77,119
"17375","chr4",53601092,53601116,25,46,60,131
"17376","chr4",54103595,54103612,18,20,76,114
"17377","chr4",54103612,54103655,44,10,59,113
"17378","chr4",54403684,54403708,25,131,74,230
"17379","chr4",54509439,54509522,84,131,43,258
"17380","chr4",55585525,55585562,38,40,77,155
"17381","chr4",55603927,55604027,101,19,59,179
"17382","chr4",55636107,55636126,20,124,104,248
"17383","chr4",56669661,56669704,44,35,122,201
"17384","chr4",56737039,56737063,25,6,6,37
"17385","chr4",56755440,56755463,24,132,24,180
"17386","chr4",56827300,56827323,24,96,73,193
"17387","chr4",56827321,56827343,23,116,52,191
"17388","chr4",56833252,56833271,20,74,129,223
"17389","chr4",56837239,56837272,34,57,4,95
"17390","chr4",56891942,56891963,22,91,6,119
"17391","chr4",56907402,56907424,23,48,127,198
"17392","chr4",56975872,56975896,25,76,78,179
"17393","chr4",57194655,57194677,23,69,73,165
"17394","chr4",57440256,57440286,31,31,76,138
"17395","chr4",57627914,57627956,43,80,72,195
"17396","chr4",58327861,58327905,45,21,111,177
"17397","chr4",58476045,58476067,23,128,6,157
"17398","chr4",59225743,59225771,29,113,74,216
"17399","chr4",60519272,60519298,27,15,129,171
"17400","chr4",61200502,61200525,24,111,88,223
"17401","chr4",61202746,61202780,35,40,93,168
"17402","chr4",61476709,61476746,38,23,3,64
"17403","chr4",61775884,61775914,31,4,130,165
"17404","chr4",62013550,62013572,23,112,116,251
"17405","chr4",63478885,63478905,21,78,8,107
"17406","chr4",64313978,64314000,23,77,27,127
"17407","chr4",64537349,64537382,34,114,144,292
"17408","chr4",66261180,66261197,18,76,138,232
"17409","chr4",66335895,66335916,22,109,28,159
"17410","chr4",67562602,67562622,21,145,35,201
"17411","chr4",67998489,67998513,25,77,120,222
"17412","chr4",68478452,68478472,21,8,137,166
"17413","chr4",69445795,69445817,23,132,7,162
"17414","chr4",70688974,70688992,19,24,22,65
"17415","chr4",70837564,70837582,19,5,6,30
"17416","chr4",70837634,70837652,19,7,4,30
"17417","chr4",70892948,70892968,21,77,74,172
"17418","chr4",71151757,71151774,18,143,101,262
"17419","chr4",71187285,71187329,45,3,37,85
"17420","chr4",71755149,71755177,29,5,72,106
"17421","chr4",72127304,72127331,28,26,74,128
"17422","chr4",72127356,72127381,26,8,22,56
"17423","chr4",72577809,72577834,26,63,6,95
"17424","chr4",72578040,72578083,44,93,32,169
"17425","chr4",73276563,73276581,19,29,56,104
"17426","chr4",73304725,73304743,19,52,26,97
"17427","chr4",73304743,73304771,29,11,8,48
"17428","chr4",74933051,74933088,38,5,61,104
"17429","chr4",74934990,74935022,33,62,91,186
"17430","chr4",75551810,75551833,24,36,3,63
"17431","chr4",75674696,75674719,24,55,45,124
"17432","chr4",75674719,75674740,22,76,22,120
"17433","chr4",75720797,75720843,47,68,73,188
"17434","chr4",75738837,75738863,27,69,88,184
"17435","chr4",75850252,75850285,34,13,67,114
"17436","chr4",75940890,75940907,18,56,140,214
"17437","chr4",76387822,76387840,19,54,7,80
"17438","chr4",76612771,76612790,20,145,107,272
"17439","chr4",76855156,76855178,23,6,18,47
"17440","chr4",77075445,77075467,23,73,23,119
"17441","chr4",77075475,77075502,28,108,23,159
"17442","chr4",77075643,77075666,24,18,11,53
"17443","chr4",77075883,77075911,29,42,23,94
"17444","chr4",77819050,77819075,26,148,46,220
"17445","chr4",77819614,77819695,82,66,57,205
"17446","chr4",77819761,77819786,26,57,1,84
"17447","chr4",77820019,77820036,18,6,11,35
"17448","chr4",78648501,78648547,47,25,81,153
"17449","chr4",78776615,78776635,21,53,11,85
"17450","chr4",79674579,79674602,24,7,30,61
"17451","chr4",79718691,79718718,28,81,6,115
"17452","chr4",80021150,80021172,23,114,5,142
"17453","chr4",80202322,80202344,23,8,12,43
"17454","chr4",81215236,81215274,39,115,17,171
"17455","chr4",81406937,81406982,46,58,4,108
"17456","chr4",81430300,81430319,20,30,7,57
"17457","chr4",81435464,81435486,23,8,21,52
"17458","chr4",81637205,81637828,624,119,117,860
"17459","chr4",82045018,82045042,25,76,71,172
"17460","chr4",82145369,82145387,19,25,142,186
"17461","chr4",82344128,82344152,25,30,75,130
"17462","chr4",82396870,82396891,22,73,29,124
"17463","chr4",82397044,82397067,24,145,75,244
"17464","chr4",82411356,82411382,27,6,141,174
"17465","chr4",82432645,82432673,29,24,135,188
"17466","chr4",82449058,82449081,24,136,6,166
"17467","chr4",82561547,82561572,26,45,63,134
"17468","chr4",82726418,82726435,18,84,5,107
"17469","chr4",82800976,82800998,23,28,76,127
"17470","chr4",82813733,82813756,24,116,3,143
"17471","chr4",82888047,82888072,26,59,5,90
"17472","chr4",82891207,82891224,18,5,52,75
"17473","chr4",82932658,82932675,18,77,101,196
"17474","chr4",82993607,82993633,27,7,56,90
"17475","chr4",83010797,83010814,18,76,19,113
"17476","chr4",83015899,83015932,34,38,23,95
"17477","chr4",83115927,83115953,27,12,66,105
"17478","chr4",83117398,83117439,42,141,5,188
"17479","chr4",83124821,83124900,80,14,91,185
"17480","chr4",83178465,83178499,35,8,33,76
"17481","chr4",83312678,83312695,18,127,6,151
"17482","chr4",83893959,83894003,45,45,129,219
"17483","chr4",84103857,84103882,26,134,72,232
"17484","chr4",84475410,84475433,24,8,1,33
"17485","chr4",84482589,84482611,23,7,75,105
"17486","chr4",84496355,84496381,27,57,11,95
"17487","chr4",84497819,84497862,44,9,40,93
"17488","chr4",84498059,84498086,28,40,9,77
"17489","chr4",84847603,84847624,22,145,35,202
"17490","chr4",85141789,85141816,28,105,1,134
"17491","chr4",85494680,85494706,27,37,43,107
"17492","chr4",85495095,85495114,20,25,74,119
"17493","chr4",85495342,85495368,27,76,48,151
"17494","chr4",85541143,85541171,29,8,46,83
"17495","chr4",86227486,86227527,42,127,7,176
"17496","chr4",86517270,86517293,24,8,116,148
"17497","chr4",86594582,86594599,18,39,119,176
"17498","chr4",86901391,86901422,32,5,36,73
"17499","chr4",86914392,86914418,27,44,128,199
"17500","chr4",86932035,86932058,24,72,6,102
"17501","chr4",87060836,87060891,56,64,37,157
"17502","chr4",87222942,87222970,29,71,87,187
"17503","chr4",87256570,87256625,56,21,71,148
"17504","chr4",87335919,87335941,23,127,74,224
"17505","chr4",88008022,88008040,19,43,39,101
"17506","chr4",88186919,88186942,24,144,6,174
"17507","chr4",88456376,88456404,29,1,114,144
"17508","chr4",88602056,88602078,23,111,6,140
"17509","chr4",89401415,89401442,28,7,55,90
"17510","chr4",89441176,89441201,26,8,132,166
"17511","chr4",89837163,89837200,38,99,52,189
"17512","chr4",90559810,90559835,26,146,19,191
"17513","chr4",91013928,91013963,36,39,137,212
"17514","chr4",92131474,92131491,18,78,55,151
"17515","chr4",92305517,92305544,28,20,51,99
"17516","chr4",92749311,92749332,22,76,133,231
"17517","chr4",94132922,94132953,32,69,64,165
"17518","chr4",94282093,94282117,25,11,21,57
"17519","chr4",94340651,94340675,25,7,48,80
"17520","chr4",94340826,94340862,37,76,75,188
"17521","chr4",94527047,94527074,28,126,133,287
"17522","chr4",94566986,94567008,23,73,36,132
"17523","chr4",94816314,94816337,24,29,143,196
"17524","chr4",95324039,95324064,26,64,71,161
"17525","chr4",95549254,95549277,24,43,113,180
"17526","chr4",95769954,95769973,20,98,75,193
"17527","chr4",96636604,96636623,20,5,53,78
"17528","chr4",97722965,97722985,21,29,26,76
"17529","chr4",98221581,98221601,21,146,25,192
"17530","chr4",98261351,98261378,28,93,70,191
"17531","chr4",98571963,98571990,28,75,98,201
"17532","chr4",98673982,98674007,26,57,14,97
"17533","chr4",98948332,98948369,38,38,70,146
"17534","chr4",98995555,98995584,30,46,75,151
"17535","chr4",99086940,99086964,25,10,41,76
"17536","chr4",99851708,99851734,27,37,75,139
"17537","chr4",99986176,99986194,19,145,73,237
"17538","chr4",101015604,101015623,20,8,75,103
"17539","chr4",101346096,101346114,19,134,8,161
"17540","chr4",101346878,101346904,27,17,79,123
"17541","chr4",101347322,101347368,47,4,64,115
"17542","chr4",101347535,101347554,20,38,28,86
"17543","chr4",102080918,102080938,21,8,26,55
"17544","chr4",102775464,102775488,25,27,74,126
"17545","chr4",105159236,105159254,19,56,22,97
"17546","chr4",105159252,105159269,18,4,6,28
"17547","chr4",105348134,105348176,43,90,35,168
"17548","chr4",105519918,105519946,29,77,72,178
"17549","chr4",105710388,105710407,20,34,75,129
"17550","chr4",107415662,107415712,51,58,59,168
"17551","chr4",108007096,108007122,27,6,71,104
"17552","chr4",108580114,108580132,19,77,27,123
"17553","chr4",108606090,108606114,25,37,143,205
"17554","chr4",108682835,108682857,23,4,3,30
"17555","chr4",108835862,108835889,28,126,3,157
"17556","chr4",109439475,109439519,45,75,67,187
"17557","chr4",109560093,109560110,18,121,6,145
"17558","chr4",109612259,109612282,24,6,6,36
"17559","chr4",109615406,109615423,18,6,26,50
"17560","chr4",109641268,109641285,18,37,28,83
"17561","chr4",109730124,109730163,40,147,105,292
"17562","chr4",109756872,109756980,109,10,61,180
"17563","chr4",110186189,110186224,36,5,75,116
"17564","chr4",110199042,110199071,30,31,81,142
"17565","chr4",110231086,110231104,19,65,73,157
"17566","chr4",110298477,110298553,77,115,51,243
"17567","chr4",110402237,110402447,211,52,75,338
"17568","chr4",112103694,112103716,23,29,75,127
"17569","chr4",112516023,112516041,19,145,23,187
"17570","chr4",112635130,112635147,18,115,74,207
"17571","chr4",112790475,112790505,31,8,77,116
"17572","chr4",112820906,112820924,19,71,140,230
"17573","chr4",112822239,112822268,30,145,35,210
"17574","chr4",113408879,113408915,37,76,54,167
"17575","chr4",115638828,115638864,37,149,7,193
"17576","chr4",116136863,116136893,31,47,75,153
"17577","chr4",116136897,116136928,32,82,41,155
"17578","chr4",116492740,116492764,25,37,43,105
"17579","chr4",116600284,116600348,65,20,68,153
"17580","chr4",116981191,116981223,33,4,64,101
"17581","chr4",118760876,118760899,24,34,74,132
"17582","chr4",118861322,118861351,30,86,141,257
"17583","chr4",119022663,119022793,131,75,51,257
"17584","chr4",119110674,119110694,21,29,75,125
"17585","chr4",119592151,119592174,24,11,73,108
"17586","chr4",119626920,119626946,27,31,77,135
"17587","chr4",119627253,119627271,19,14,3,36
"17588","chr4",119628600,119628645,46,137,43,226
"17589","chr4",119628971,119628994,24,132,95,251
"17590","chr4",119686403,119686421,19,91,67,177
"17591","chr4",120970190,120970217,28,99,61,188
"17592","chr4",121527078,121527099,22,8,66,96
"17593","chr4",121926399,121926425,27,9,18,54
"17594","chr4",122153160,122153179,20,38,128,186
"17595","chr4",122492848,122492870,23,3,128,154
"17596","chr4",122783022,122783062,41,65,120,226
"17597","chr4",122827056,122827113,58,21,41,120
"17598","chr4",123396753,123396775,23,126,137,286
"17599","chr4",123398930,123398952,23,139,14,176
"17600","chr4",123483937,123483963,27,21,80,128
"17601","chr4",124712701,124712718,18,34,39,91
"17602","chr4",124712784,124712810,27,36,1,64
"17603","chr4",125314693,125314724,32,10,127,169
"17604","chr4",125315653,125315670,18,20,77,115
"17605","chr4",127569276,127569298,23,149,6,178
"17606","chr4",127570153,127570181,29,43,6,78
"17607","chr4",128033948,128033977,30,9,33,72
"17608","chr4",128037119,128037145,27,76,6,109
"17609","chr4",128057348,128057379,32,126,9,167
"17610","chr4",128062003,128062025,23,104,40,167
"17611","chr4",128063428,128063457,30,107,74,211
"17612","chr4",128097296,128097325,30,8,46,84
"17613","chr4",128129165,128129204,40,76,74,190
"17614","chr4",128617412,128617432,21,11,1,33
"17615","chr4",128631756,128631796,41,77,34,152
"17616","chr4",128634919,128634946,28,144,32,204
"17617","chr4",128706667,128706685,19,148,6,173
"17618","chr4",128778539,128778561,23,14,7,44
"17619","chr4",128805334,128805356,23,76,111,210
"17620","chr4",128808497,128808517,21,7,89,117
"17621","chr4",128811872,128811891,20,58,6,84
"17622","chr4",128812298,128812318,21,28,79,128
"17623","chr4",129280719,129280742,24,132,74,230
"17624","chr4",129767978,129768001,24,3,14,41
"17625","chr4",130515027,130515044,18,144,27,189
"17626","chr4",130827054,130827087,34,111,27,172
"17627","chr4",131290698,131290727,30,1,126,157
"17628","chr4",131536002,131536023,22,129,26,177
"17629","chr4",131615771,131615794,24,25,27,76
"17630","chr4",131725498,131725563,66,12,56,134
"17631","chr4",131728004,131728041,38,13,56,107
"17632","chr4",131730488,131730533,46,4,56,106
"17633","chr4",131732986,131733025,40,5,52,97
"17634","chr4",131742936,131742987,52,6,56,114
"17635","chr4",131750374,131750421,48,5,56,109
"17636","chr4",133487482,133487503,22,147,7,176
"17637","chr4",135229961,135229983,23,30,76,129
"17638","chr4",135636906,135636956,51,9,44,104
"17639","chr4",136018383,136018409,27,27,143,197
"17640","chr4",136761721,136761741,21,77,77,175
"17641","chr4",136824843,136824860,18,25,37,80
"17642","chr4",137034632,137034671,40,56,6,102
"17643","chr4",137080047,137080064,18,72,97,187
"17644","chr4",138785763,138785789,27,4,10,41
"17645","chr4",139051226,139051249,24,99,5,128
"17646","chr4",139084412,139084441,30,63,12,105
"17647","chr4",139084439,139084462,24,18,43,85
"17648","chr4",139092367,139092474,108,146,68,322
"17649","chr4",139127965,139127983,19,3,74,96
"17650","chr4",139179255,139179279,25,11,75,111
"17651","chr4",139188242,139188265,24,4,1,29
"17652","chr4",139298439,139298459,21,135,6,162
"17653","chr4",139314985,139315007,23,27,136,186
"17654","chr4",139315002,139315075,74,95,119,288
"17655","chr4",139331618,139331636,19,27,143,189
"17656","chr4",139348039,139348056,18,32,67,117
"17657","chr4",139352663,139352684,22,75,62,159
"17658","chr4",139415345,139415371,27,134,32,193
"17659","chr4",139447659,139447684,26,8,120,154
"17660","chr4",139556235,139556259,25,28,116,169
"17661","chr4",139666098,139666134,37,109,77,223
"17662","chr4",139709000,139709035,36,56,8,100
"17663","chr4",139731436,139731468,33,78,34,145
"17664","chr4",139832095,139832122,28,76,8,112
"17665","chr4",139837123,139837159,37,91,5,133
"17666","chr4",140151190,140151241,52,78,52,182
"17667","chr4",140712749,140712787,39,6,67,112
"17668","chr4",140756367,140756419,53,53,22,128
"17669","chr4",141155253,141155270,18,28,143,189
"17670","chr4",141682960,141682984,25,9,4,38
"17671","chr4",141764247,141764272,26,67,97,190
"17672","chr4",141768376,141768393,18,77,27,122
"17673","chr4",142409496,142409525,30,135,71,236
"17674","chr4",142845729,142845756,28,21,80,129
"17675","chr4",143336749,143336780,32,72,94,198
"17676","chr4",143573322,143573341,20,6,114,140
"17677","chr4",143705041,143705079,39,16,3,58
"17678","chr4",143808759,143808779,21,8,59,88
"17679","chr4",143912123,143912163,41,24,39,104
"17680","chr4",143938286,143938313,28,9,85,122
"17681","chr4",144048221,144048247,27,9,85,121
"17682","chr4",144684428,144684451,24,28,73,125
"17683","chr4",145180067,145180089,23,101,116,240
"17684","chr4",145260887,145260915,29,129,6,164
"17685","chr4",145353288,145353322,35,34,131,200
"17686","chr4",145706809,145706828,20,7,143,170
"17687","chr4",146639306,146639340,35,64,85,184
"17688","chr4",146640089,146640126,38,52,52,142
"17689","chr4",148071623,148071649,27,49,67,143
"17690","chr4",148210182,148210204,23,72,114,209
"17691","chr4",148442418,148442444,27,112,109,248
"17692","chr4",150622689,150622716,28,122,71,221
"17693","chr4",150792029,150792051,23,17,74,114
"17694","chr4",151007505,151007529,25,101,74,200
"17695","chr4",151010888,151010905,18,147,2,167
"17696","chr4",151031340,151031358,19,4,25,48
"17697","chr4",151085167,151085185,19,13,7,39
"17698","chr4",151153957,151153974,18,3,118,139
"17699","chr4",151312912,151312940,29,54,63,146
"17700","chr4",151409092,151409142,51,16,13,80
"17701","chr4",152535804,152535850,47,128,114,289
"17702","chr4",152535997,152536031,35,148,22,205
"17703","chr4",152671747,152671778,32,47,6,85
"17704","chr4",153032217,153032238,22,145,6,173
"17705","chr4",153057974,153057996,23,45,105,173
"17706","chr4",153058243,153058293,51,15,9,75
"17707","chr4",153173666,153173685,20,13,71,104
"17708","chr4",153273271,153273293,23,8,11,42
"17709","chr4",153437922,153437946,25,145,39,209
"17710","chr4",153466265,153466308,44,35,1,80
"17711","chr4",153480338,153480362,25,137,75,237
"17712","chr4",153504267,153504297,31,8,10,49
"17713","chr4",153753543,153753561,19,62,68,149
"17714","chr4",153789506,153789551,46,104,83,233
"17715","chr4",154742854,154742887,34,92,26,152
"17716","chr4",154826150,154826174,25,59,93,177
"17717","chr4",157220633,157220674,42,4,55,101
"17718","chr4",157352719,157352738,20,114,7,141
"17719","chr4",157381747,157381777,31,105,5,141
"17720","chr4",157391846,157391878,33,98,7,138
"17721","chr4",157581757,157581803,47,4,121,172
"17722","chr4",157581783,157581807,25,8,95,128
"17723","chr4",158141921,158141955,35,121,131,287
"17724","chr4",159094444,159094479,36,68,79,183
"17725","chr4",159103436,159103453,18,12,22,52
"17726","chr4",159103864,159103886,23,2,104,129
"17727","chr4",159104055,159104073,19,82,40,141
"17728","chr4",159335836,159335859,24,105,5,134
"17729","chr4",159455064,159455091,28,139,7,174
"17730","chr4",159731387,159731425,39,91,68,198
"17731","chr4",160054231,160054252,22,147,70,239
"17732","chr4",160872093,160872124,32,76,112,220
"17733","chr4",161606241,161606264,24,75,65,164
"17734","chr4",163166365,163166389,25,41,21,87
"17735","chr4",163259649,163259688,40,68,62,170
"17736","chr4",163493996,163494019,24,77,1,102
"17737","chr4",163494172,163494211,40,1,3,44
"17738","chr4",164836321,164836418,98,36,67,201
"17739","chr4",164860961,164860987,27,7,87,121
"17740","chr4",164962390,164962418,29,31,73,133
"17741","chr4",164993308,164993330,23,7,44,74
"17742","chr4",165062359,165062378,20,75,142,237
"17743","chr4",165090214,165090237,24,81,71,176
"17744","chr4",165207473,165207504,32,29,32,93
"17745","chr4",166348096,166348150,55,32,15,102
"17746","chr4",166838783,166838803,21,68,41,130
"17747","chr4",167243267,167243285,19,10,62,91
"17748","chr4",168397895,168397914,20,56,13,89
"17749","chr4",168557033,168557062,30,77,102,209
"17750","chr4",168626401,168626421,21,5,74,100
"17751","chr4",168761646,168761676,31,21,57,109
"17752","chr4",168790159,168790176,18,73,65,156
"17753","chr4",169046529,169046567,39,76,59,174
"17754","chr4",169082518,169082560,43,9,143,195
"17755","chr4",169102916,169102939,24,76,130,230
"17756","chr4",169712022,169712043,22,36,85,143
"17757","chr4",169859422,169859453,32,63,75,170
"17758","chr4",169864620,169864642,23,4,1,28
"17759","chr4",169917723,169917768,46,8,16,70
"17760","chr4",171095565,171095601,37,17,66,120
"17761","chr4",171220218,171220478,261,112,22,395
"17762","chr4",171852848,171852865,18,10,124,152
"17763","chr4",172233206,172233224,19,144,70,233
"17764","chr4",172658150,172658169,20,132,6,158
"17765","chr4",173283636,173283653,18,80,38,136
"17766","chr4",173333857,173333876,20,73,140,233
"17767","chr4",173507198,173507226,29,7,53,89
"17768","chr4",173511424,173511454,31,5,87,123
"17769","chr4",173527252,173527278,27,106,49,182
"17770","chr4",173529188,173529229,42,29,32,103
"17771","chr4",173529557,173529574,18,9,6,33
"17772","chr4",173587347,173587400,54,48,27,129
"17773","chr4",174023397,174023418,22,58,65,145
"17774","chr4",174224771,174225004,234,20,115,369
"17775","chr4",174356843,174356869,27,76,147,250
"17776","chr4",174790826,174790846,21,137,26,184
"17777","chr4",175238080,175238097,18,7,145,170
"17778","chr4",175425147,175425169,23,106,68,197
"17779","chr4",175473598,175473617,20,128,6,154
"17780","chr4",175479059,175479106,48,78,137,263
"17781","chr4",175484847,175484872,26,148,26,200
"17782","chr4",175558839,175558861,23,28,6,57
"17783","chr4",176325040,176325068,29,125,120,274
"17784","chr4",176792810,176792835,26,110,95,231
"17785","chr4",176792884,176792905,22,67,21,110
"17786","chr4",176931548,176931588,41,65,2,108
"17787","chr4",177349035,177349055,21,29,75,125
"17788","chr4",177358291,177358323,33,74,81,188
"17789","chr4",177381687,177381707,21,46,41,108
"17790","chr4",177540934,177540956,23,119,6,148
"17791","chr4",178041597,178041618,22,77,27,126
"17792","chr4",178817978,178817997,20,73,21,114
"17793","chr4",178959772,178959952,181,74,141,396
"17794","chr4",179857399,179857422,24,64,68,156
"17795","chr4",179883247,179883280,34,7,130,171
"17796","chr4",180084183,180084212,30,74,26,130
"17797","chr4",180408619,180408677,59,109,72,240
"17798","chr4",180605132,180605159,28,29,75,132
"17799","chr4",180997309,180997334,26,85,6,117
"17800","chr4",181138193,181138221,29,19,6,54
"17801","chr4",181576786,181576830,45,7,146,198
"17802","chr4",181576980,181577210,231,25,76,332
"17803","chr4",182144203,182144227,25,4,94,123
"17804","chr4",182449092,182449111,20,83,43,146
"17805","chr4",182589978,182589998,21,131,70,222
"17806","chr4",182674871,182674889,19,71,15,105
"17807","chr4",182757312,182757337,26,41,74,141
"17808","chr4",182807697,182807748,52,87,97,236
"17809","chr4",182862254,182862276,23,128,36,187
"17810","chr4",182877276,182877305,30,63,4,97
"17811","chr4",183060550,183060569,20,8,132,160
"17812","chr4",183311579,183311597,19,11,83,113
"17813","chr4",183324544,183324561,18,77,74,169
"17814","chr4",183382548,183382575,28,8,130,166
"17815","chr4",183519120,183519147,28,78,6,112
"17816","chr4",183583888,183583909,22,23,3,48
"17817","chr4",183593026,183593058,33,74,53,160
"17818","chr4",183643060,183643111,52,114,5,171
"17819","chr4",183661758,183661779,22,8,58,88
"17820","chr4",183722693,183722715,23,72,74,169
"17821","chr4",183796546,183796568,23,121,26,170
"17822","chr4",184122405,184122439,35,15,88,138
"17823","chr4",184354361,184354388,28,47,8,83
"17824","chr4",184396427,184396451,25,7,46,78
"17825","chr4",184576681,184576729,49,27,72,148
"17826","chr4",184829080,184829099,20,48,11,79
"17827","chr4",184933042,184933065,24,71,111,206
"17828","chr4",184955716,184955733,18,123,10,151
"17829","chr4",185128035,185128065,31,60,28,119
"17830","chr4",185143606,185143632,27,39,72,138
"17831","chr4",185206661,185206682,22,15,71,108
"17832","chr4",185303659,185303681,23,117,6,146
"17833","chr4",185314857,185314874,18,79,75,172
"17834","chr4",185426880,185426915,36,78,23,137
"17835","chr4",185606675,185606692,18,12,23,53
"17836","chr4",185886555,185886599,45,3,6,54
"17837","chr4",186025936,186025983,48,79,71,198
"17838","chr4",186040529,186040550,22,78,81,181
"17839","chr4",186054191,186054221,31,86,34,151
"17840","chr4",186092592,186092612,21,48,33,102
"17841","chr4",186092612,186092630,19,66,13,98
"17842","chr4",186144723,186144747,25,12,32,69
"17843","chr4",186144925,186144961,37,18,53,108
"17844","chr4",186173693,186173718,26,103,27,156
"17845","chr4",186237080,186237116,37,76,9,122
"17846","chr4",186259260,186259281,22,19,40,81
"17847","chr4",186259280,186259305,26,43,20,89
"17848","chr4",186292801,186292825,25,35,54,114
"17849","chr4",186330047,186330068,22,36,75,133
"17850","chr4",186430743,186430776,34,73,89,196
"17851","chr4",186430751,186430779,29,76,81,186
"17852","chr4",186483331,186483353,23,124,74,221
"17853","chr4",186573956,186573982,27,77,34,138
"17854","chr4",186574131,186574148,18,104,7,129
"17855","chr4",186733330,186733351,22,53,27,102
"17856","chr4",187241495,187241522,28,129,6,163
"17857","chr4",187421094,187421114,21,58,67,146
"17858","chr4",187572326,187572344,19,111,4,134
"17859","chr4",187946470,187946492,23,53,4,80
"17860","chr4",188064088,188064112,25,76,12,113
"17861","chr4",188112581,188112598,18,126,15,159
"17862","chr4",188148902,188148928,27,5,11,43
"17863","chr4",188156177,188156195,19,76,142,237
"17864","chr4",188244606,188244628,23,20,74,117
"17865","chr4",188312763,188312780,18,67,118,203
"17866","chr4",188440200,188440217,18,139,20,177
"17867","chr4",188707288,188707307,20,139,29,188
"17868","chr4",188883260,188883278,19,23,74,116
"17869","chr4",189096458,189096475,18,9,136,163
"17870","chr4",190067638,190067658,21,98,50,169
"17871","chr4",190067795,190067815,21,1,30,52
"17872","chr4",190069556,190069584,29,15,7,51
"17873","chr4",190070902,190070967,66,3,85,154
"17874","chr4",190071092,190071112,21,1,30,52
"17875","chr4",190072859,190072881,23,15,1,39
"17876","chr4",190073190,190073233,44,18,42,104
"17877","chr4",190074195,190074260,66,3,77,146
"17878","chr4",190074385,190074405,21,1,30,52
"17879","chr4",190076152,190076174,23,15,1,39
"17880","chr4",190077488,190077553,66,3,77,146
"17881","chr4",190077678,190077698,21,1,30,52
"17882","chr4",190079445,190079467,23,15,1,39
"17883","chr4",190079776,190079819,44,14,42,100
"17884","chr4",190080785,190080853,69,3,85,157
"17885","chr4",190080978,190080998,21,1,30,52
"17886","chr4",190082739,190082761,23,15,1,39
"17887","chr4",190084079,190084147,69,3,77,149
"17888","chr4",190084272,190084292,21,1,30,52
"17889","chr4",190086039,190086061,23,15,1,39
"17890","chr4",190087375,190087440,66,3,77,146
"17891","chr4",190087565,190087585,21,1,30,52
"17892","chr4",190089332,190089354,23,15,1,39
"17893","chr4",190090672,190090740,69,3,77,149
"17894","chr4",190090865,190090885,21,1,30,52
"17895","chr4",190092632,190092654,23,15,1,39
"17896","chr4",190173435,190173505,71,110,77,258
"17897","chr4",190173630,190173654,25,1,30,56
"17898","chr4",190175401,190175423,23,15,1,39
"17899","chr5",98838,98856,19,129,80,228
"17900","chr5",271025,271044,20,87,132,239
"17901","chr5",311688,311712,25,77,16,118
"17902","chr5",443221,443278,58,1,19,78
"17903","chr5",507078,507124,47,15,67,129
"17904","chr5",507167,507186,20,77,137,234
"17905","chr5",524253,524281,29,6,123,158
"17906","chr5",528569,528595,27,10,42,79
"17907","chr5",544221,544239,19,6,15,40
"17908","chr5",784750,784778,29,26,18,73
"17909","chr5",891688,891716,29,96,77,202
"17910","chr5",1002891,1002917,27,49,73,149
"17911","chr5",1004196,1004236,41,70,38,149
"17912","chr5",1009101,1009125,25,15,16,56
"17913","chr5",1089572,1089591,20,104,34,158
"17914","chr5",1251453,1251473,21,22,56,99
"17915","chr5",1310042,1310065,24,95,59,178
"17916","chr5",1314140,1314160,21,23,29,73
"17917","chr5",1365716,1365758,43,19,88,150
"17918","chr5",1403305,1403434,130,62,59,251
"17919","chr5",1408204,1408223,20,37,39,96
"17920","chr5",1504715,1504732,18,26,5,49
"17921","chr5",1518334,1518357,24,138,9,171
"17922","chr5",1634516,1634542,27,10,21,58
"17923","chr5",1746627,1746680,54,67,17,138
"17924","chr5",1757120,1757148,29,29,73,131
"17925","chr5",1878383,1878402,20,21,3,44
"17926","chr5",2042999,2043016,18,8,5,31
"17927","chr5",2206842,2206867,26,11,12,49
"17928","chr5",2289830,2289870,41,47,4,92
"17929","chr5",2751182,2751206,25,6,1,32
"17930","chr5",2756107,2756129,23,33,84,140
"17931","chr5",3136815,3136840,26,69,33,128
"17932","chr5",3141319,3141337,19,39,74,132
"17933","chr5",3303771,3303789,19,14,11,44
"17934","chr5",3398905,3398964,60,10,146,216
"17935","chr5",3528443,3528462,20,14,74,108
"17936","chr5",3674160,3674218,59,68,34,161
"17937","chr5",3763924,3763953,30,142,64,236
"17938","chr5",4240098,4240121,24,127,17,168
"17939","chr5",4240102,4240124,23,130,13,166
"17940","chr5",4280066,4280091,26,10,7,43
"17941","chr5",5036595,5036612,18,77,6,101
"17942","chr5",5138660,5138685,26,8,75,109
"17943","chr5",5206426,5206447,22,26,6,54
"17944","chr5",5422615,5422669,55,23,110,188
"17945","chr5",5908871,5908932,62,8,23,93
"17946","chr5",5927991,5928017,27,131,68,226
"17947","chr5",6037070,6037114,45,35,137,217
"17948","chr5",6447182,6448619,1438,6,90,1534
"17949","chr5",6448719,6448759,41,25,72,138
"17950","chr5",6463599,6463642,44,73,89,206
"17951","chr5",6506986,6507009,24,82,105,211
"17952","chr5",6631094,6631121,28,44,6,78
"17953","chr5",6713843,6713868,26,111,8,145
"17954","chr5",6714719,6714736,18,101,26,145
"17955","chr5",7651792,7651814,23,94,50,167
"17956","chr5",7665829,7665856,28,8,65,101
"17957","chr5",8071574,8071604,31,32,74,137
"17958","chr5",8158203,8158226,24,3,6,33
"17959","chr5",8969270,8969309,40,49,6,95
"17960","chr5",9546156,9546200,45,59,48,152
"17961","chr5",9546199,9546218,20,77,5,102
"17962","chr5",9660226,9660249,24,29,143,196
"17963","chr5",9930299,9930323,25,9,56,90
"17964","chr5",9942509,9942535,27,76,49,152
"17965","chr5",10153421,10153444,24,59,75,158
"17966","chr5",10249898,10249934,37,119,6,162
"17967","chr5",10297570,10297587,18,7,73,98
"17968","chr5",10353740,10353764,25,64,28,117
"17969","chr5",10354139,10354167,29,65,73,167
"17970","chr5",10564226,10564244,19,66,130,215
"17971","chr5",10577051,10577133,83,62,134,279
"17972","chr5",10613282,10613302,21,76,71,168
"17973","chr5",10761386,10761418,33,4,123,160
"17974","chr5",10917817,10917892,76,51,114,241
"17975","chr5",12186390,12186414,25,8,128,161
"17976","chr5",13810585,13810604,20,109,27,156
"17977","chr5",13989483,13989501,19,8,65,92
"17978","chr5",14011855,14011883,29,78,51,158
"17979","chr5",14047204,14047231,28,29,141,198
"17980","chr5",14143566,14143590,25,91,20,136
"17981","chr5",14144905,14144925,21,51,13,85
"17982","chr5",14388689,14388706,18,33,126,177
"17983","chr5",14581967,14581990,24,19,74,117
"17984","chr5",14818064,14818095,32,102,73,207
"17985","chr5",14871718,14871739,22,7,129,158
"17986","chr5",14871812,14871833,22,73,35,130
"17987","chr5",14891102,14891124,23,116,49,188
"17988","chr5",14901991,14902014,24,7,37,68
"17989","chr5",14931008,14931036,29,3,82,114
"17990","chr5",15096607,15096641,35,72,121,228
"17991","chr5",15107317,15107334,18,5,3,26
"17992","chr5",15957109,15957128,20,55,47,122
"17993","chr5",16179079,16179096,18,29,58,105
"17994","chr5",16179468,16179494,27,27,135,189
"17995","chr5",16767168,16767188,21,8,2,31
"17996","chr5",16811069,16811096,28,16,6,50
"17997","chr5",16973212,16973269,58,67,7,132
"17998","chr5",17048420,17048449,30,130,6,166
"17999","chr5",17084279,17084296,18,37,75,130
"18000","chr5",17098549,17098566,18,54,109,181
"18001","chr5",17098564,17098583,20,71,94,185
"18002","chr5",17140609,17140629,21,136,73,230
"18003","chr5",17186897,17186922,26,95,15,136
"18004","chr5",17217614,17217660,47,2,20,69
"18005","chr5",17792577,17792600,24,77,27,128
"18006","chr5",18128619,18128640,22,82,73,177
"18007","chr5",18736672,18736698,27,4,20,51
"18008","chr5",19804121,19804143,23,136,43,202
"18009","chr5",20266572,20266600,29,28,74,131
"18010","chr5",20418243,20418266,24,41,24,89
"18011","chr5",21430942,21430982,41,31,73,145
"18012","chr5",21459124,21459155,32,86,78,196
"18013","chr5",21577307,21577330,24,10,126,160
"18014","chr5",21959753,21959776,24,77,28,129
"18015","chr5",22086511,22086548,38,47,26,111
"18016","chr5",22382101,22382300,200,19,72,291
"18017","chr5",22382815,22382843,29,71,27,127
"18018","chr5",22535139,22535174,36,10,75,121
"18019","chr5",22815770,22815810,41,134,6,181
"18020","chr5",22950902,22950920,19,76,24,119
"18021","chr5",22961368,22961390,23,35,75,133
"18022","chr5",23364880,23364904,25,58,72,155
"18023","chr5",23413938,23413960,23,17,6,46
"18024","chr5",23563784,23563807,24,30,143,197
"18025","chr5",24223445,24223473,29,34,141,204
"18026","chr5",24563598,24563617,20,105,29,154
"18027","chr5",25100955,25100993,39,122,75,236
"18028","chr5",26203348,26203367,20,73,25,118
"18029","chr5",26952459,26952488,30,80,27,137
"18030","chr5",27085843,27085883,41,142,33,216
"18031","chr5",27094150,27094168,19,64,4,87
"18032","chr5",27431444,27431470,27,80,28,135
"18033","chr5",28294083,28294105,23,78,12,113
"18034","chr5",28687635,28687704,70,12,67,149
"18035","chr5",29090894,29090911,18,76,123,217
"18036","chr5",29568743,29568761,19,15,49,83
"18037","chr5",29786087,29786126,40,61,124,225
"18038","chr5",31013867,31013887,21,8,47,76
"18039","chr5",31190737,31190764,28,8,115,151
"18040","chr5",31572491,31572513,23,77,8,108
"18041","chr5",31729100,31729120,21,14,64,99
"18042","chr5",31949839,31949856,18,30,76,124
"18043","chr5",31951065,31951082,18,33,46,97
"18044","chr5",31956557,31956599,43,135,64,242
"18045","chr5",31958935,31958952,18,10,133,161
"18046","chr5",32058675,32058693,19,145,73,237
"18047","chr5",32095905,32095924,20,37,146,203
"18048","chr5",32172696,32172714,19,80,33,132
"18049","chr5",32180684,32180703,20,74,80,174
"18050","chr5",32185818,32185844,27,35,67,129
"18051","chr5",32444036,32444055,20,29,13,62
"18052","chr5",32444058,32444083,26,57,133,216
"18053","chr5",32444238,32444265,28,97,5,130
"18054","chr5",32446113,32446135,23,148,50,221
"18055","chr5",32711848,32711874,27,28,141,196
"18056","chr5",33229205,33229228,24,73,1,98
"18057","chr5",34183323,34183348,26,8,99,133
"18058","chr5",34499909,34499934,26,3,55,84
"18059","chr5",34658797,34658818,22,35,75,132
"18060","chr5",34873063,34873088,26,147,6,179
"18061","chr5",34929657,34929680,24,21,28,73
"18062","chr5",34929736,34929753,18,94,93,205
"18063","chr5",35618111,35618128,18,95,27,140
"18064","chr5",36265978,36266000,23,142,5,170
"18065","chr5",36290899,36290917,19,24,75,118
"18066","chr5",36552278,36552297,20,75,109,204
"18067","chr5",36663381,36663405,25,20,145,190
"18068","chr5",36877200,36877225,26,6,59,91
"18069","chr5",37012457,37012481,25,20,2,47
"18070","chr5",37273408,37273448,41,5,80,126
"18071","chr5",37308695,37308730,36,109,9,154
"18072","chr5",37317173,37317201,29,8,70,107
"18073","chr5",37352361,37352387,27,144,121,292
"18074","chr5",37378299,37378322,24,8,9,41
"18075","chr5",37378905,37378947,43,82,78,203
"18076","chr5",37379088,37379106,19,71,23,113
"18077","chr5",37467705,37467738,34,80,141,255
"18078","chr5",38016197,38016218,22,126,75,223
"18079","chr5",38239552,38239590,39,4,111,154
"18080","chr5",38556698,38556746,49,28,92,169
"18081","chr5",39429512,39429544,33,78,64,175
"18082","chr5",39454770,39454807,38,59,81,178
"18083","chr5",39649452,39649476,25,6,15,46
"18084","chr5",39822749,39822769,21,133,36,190
"18085","chr5",40797860,40797879,20,93,11,124
"18086","chr5",40895045,40895063,19,123,51,193
"18087","chr5",41712208,41712246,39,28,144,211
"18088","chr5",42424172,42424219,48,47,74,169
"18089","chr5",42476214,42476236,23,7,1,31
"18090","chr5",42847334,42847359,26,144,27,197
"18091","chr5",42993459,42993500,42,3,94,139
"18092","chr5",43062676,43062698,23,145,27,195
"18093","chr5",43062846,43062872,27,4,8,39
"18094","chr5",43078749,43078768,20,76,6,102
"18095","chr5",43118550,43118570,21,8,8,37
"18096","chr5",43162911,43162928,18,15,50,83
"18097","chr5",43162970,43162987,18,74,9,101
"18098","chr5",43200295,43200316,22,6,23,51
"18099","chr5",43249045,43249087,43,8,137,188
"18100","chr5",43556848,43556872,25,40,99,164
"18101","chr5",45611245,45611289,45,76,48,169
"18102","chr5",45695871,45695908,38,6,60,104
"18103","chr5",45696214,45696239,26,37,33,96
"18104","chr5",50667583,50667600,18,96,136,250
"18105","chr5",51313232,51313257,26,112,9,147
"18106","chr5",53020849,53020866,18,28,75,121
"18107","chr5",53109548,53109567,20,132,133,285
"18108","chr5",53267388,53267418,31,80,25,136
"18109","chr5",53480199,53480231,33,41,16,90
"18110","chr5",53606014,53606034,21,145,119,285
"18111","chr5",53619115,53619141,27,100,73,200
"18112","chr5",53619307,53619324,18,145,35,198
"18113","chr5",53832194,53832220,27,74,127,228
"18114","chr5",54011000,54011017,18,69,56,143
"18115","chr5",54661954,54661992,39,74,74,187
"18116","chr5",55307414,55307434,21,61,45,127
"18117","chr5",55601127,55601148,22,38,47,107
"18118","chr5",55881302,55881336,35,11,74,120
"18119","chr5",56027694,56027711,18,76,106,200
"18120","chr5",56036912,56036936,25,35,69,129
"18121","chr5",56083166,56083203,38,70,58,166
"18122","chr5",56087139,56087166,28,8,132,168
"18123","chr5",56246172,56246189,18,6,143,167
"18124","chr5",56757919,56757941,23,49,59,131
"18125","chr5",56815266,56815299,34,46,30,110
"18126","chr5",56829350,56829368,19,118,143,280
"18127","chr5",57110285,57110317,33,141,3,177
"18128","chr5",57177649,57177678,30,33,67,130
"18129","chr5",57185259,57185277,19,7,49,75
"18130","chr5",57211577,57211603,27,10,142,179
"18131","chr5",57423460,57423477,18,146,31,195
"18132","chr5",57497285,57497307,23,77,27,127
"18133","chr5",57688543,57688571,29,75,111,215
"18134","chr5",57876971,57876995,25,8,95,128
"18135","chr5",58260852,58260890,39,70,31,140
"18136","chr5",58745393,58745419,27,13,11,51
"18137","chr5",59175782,59175806,25,60,141,226
"18138","chr5",59893360,59893401,42,60,10,112
"18139","chr5",59893413,59893431,19,23,46,88
"18140","chr5",59916955,59916983,29,35,143,207
"18141","chr5",59930164,59930186,23,149,72,244
"18142","chr5",60337165,60337182,18,76,76,170
"18143","chr5",60726035,60726052,18,54,74,146
"18144","chr5",61265939,61265971,33,135,48,216
"18145","chr5",61332327,61332372,46,48,60,154
"18146","chr5",61332423,61332458,36,26,48,110
"18147","chr5",61332694,61332734,41,31,33,105
"18148","chr5",61332777,61332823,47,77,32,156
"18149","chr5",61341874,61341897,24,76,48,148
"18150","chr5",61392610,61392627,18,33,146,197
"18151","chr5",61606162,61606189,28,121,45,194
"18152","chr5",61814127,61814147,21,31,72,124
"18153","chr5",61951020,61951037,18,7,59,84
"18154","chr5",62415465,62415485,21,26,135,182
"18155","chr5",64174960,64174985,26,8,119,153
"18156","chr5",64388543,64388572,30,34,5,69
"18157","chr5",64538486,64538574,89,36,45,170
"18158","chr5",64858138,64858164,27,134,6,167
"18159","chr5",65023810,65023829,20,145,4,169
"18160","chr5",65529799,65529821,23,75,132,230
"18161","chr5",65576374,65576394,21,8,102,131
"18162","chr5",65925711,65925729,19,112,14,145
"18163","chr5",65966681,65966709,29,69,5,103
"18164","chr5",66068169,66068191,23,36,31,90
"18165","chr5",66596841,66596859,19,30,28,77
"18166","chr5",66935651,66935677,27,68,23,118
"18167","chr5",67166220,67166245,26,22,29,77
"18168","chr5",67397737,67397755,19,29,143,191
"18169","chr5",67398890,67398923,34,5,42,81
"18170","chr5",67496617,67496666,50,98,63,211
"18171","chr5",68092758,68092777,20,29,76,125
"18172","chr5",68580854,68580871,18,145,27,190
"18173","chr5",68999739,68999774,36,8,57,101
"18174","chr5",69180982,69180999,18,76,59,153
"18175","chr5",69224032,69224049,18,88,7,113
"18176","chr5",69385267,69385286,20,7,3,30
"18177","chr5",69475445,69475463,19,26,72,117
"18178","chr5",69599590,69599614,25,6,16,47
"18179","chr5",69619736,69619762,27,95,7,129
"18180","chr5",69642699,69642743,45,4,49,98
"18181","chr5",69646519,69646550,32,10,103,145
"18182","chr5",69909898,69909925,28,105,8,141
"18183","chr5",69913704,69913748,45,51,2,98
"18184","chr5",69969883,69969900,18,77,28,123
"18185","chr5",70052543,70052561,19,134,4,157
"18186","chr5",70061822,70061867,46,6,4,56
"18187","chr5",70126981,70127007,27,9,93,129
"18188","chr5",70204375,70204419,45,4,49,98
"18189","chr5",70208202,70208239,38,10,103,151
"18190","chr5",70222429,70222469,41,4,45,90
"18191","chr5",70226252,70226289,38,10,103,151
"18192","chr5",70474877,70474903,27,95,7,129
"18193","chr5",70497539,70497579,41,4,41,86
"18194","chr5",70501356,70501385,30,10,103,143
"18195","chr5",70522639,70522666,28,10,103,141
"18196","chr5",70784964,70784989,26,105,8,139
"18197","chr5",70788755,70788798,44,51,2,97
"18198","chr5",70844954,70844971,18,77,28,123
"18199","chr5",70927962,70927980,19,134,4,157
"18200","chr5",70937246,70937291,46,6,4,56
"18201","chr5",71002402,71002426,25,9,91,125
"18202","chr5",71028320,71028347,28,7,13,48
"18203","chr5",71078907,71078928,22,69,85,176
"18204","chr5",71127298,71127322,25,7,91,123
"18205","chr5",71204772,71204809,38,4,37,79
"18206","chr5",71208581,71208608,28,10,103,141
"18207","chr5",71222801,71222838,38,4,37,79
"18208","chr5",71226605,71226632,28,10,103,141
"18209","chr5",71440184,71440201,18,77,28,123
"18210","chr5",71535599,71535616,18,29,51,98
"18211","chr5",71598429,71598447,19,66,57,142
"18212","chr5",71873937,71873959,23,7,31,61
"18213","chr5",72158007,72158027,21,9,75,105
"18214","chr5",73004048,73004073,26,39,74,139
"18215","chr5",73120484,73120506,23,51,114,188
"18216","chr5",73447176,73447194,19,11,83,113
"18217","chr5",73447200,73447240,41,17,59,117
"18218","chr5",73447454,73447487,34,1,3,38
"18219","chr5",73448193,73448210,18,132,19,169
"18220","chr5",73608763,73608783,21,7,102,130
"18221","chr5",74487765,74487784,20,52,67,139
"18222","chr5",74640843,74640885,43,7,16,66
"18223","chr5",74684659,74684695,37,76,111,224
"18224","chr5",74697728,74697746,19,55,77,151
"18225","chr5",75611548,75611605,58,64,103,225
"18226","chr5",76220618,76220636,19,51,131,201
"18227","chr5",76356709,76356726,18,76,4,98
"18228","chr5",76667878,76667900,23,11,130,164
"18229","chr5",76671690,76671709,20,19,2,41
"18230","chr5",76715947,76715971,25,1,118,144
"18231","chr5",76786696,76786723,28,13,5,46
"18232","chr5",77280899,77280930,32,119,71,222
"18233","chr5",77621324,77621342,19,75,27,121
"18234","chr5",77752532,77752560,29,60,142,231
"18235","chr5",77954073,77954093,21,35,75,131
"18236","chr5",77967318,77967336,19,10,21,50
"18237","chr5",77985880,77985903,24,76,139,239
"18238","chr5",78363200,78363222,23,3,3,29
"18239","chr5",78550555,78550587,33,75,76,184
"18240","chr5",78727342,78727361,20,144,67,231
"18241","chr5",78911573,78911611,39,111,7,157
"18242","chr5",79150110,79150151,42,113,74,229
"18243","chr5",79239811,79239845,35,138,6,179
"18244","chr5",79316899,79316922,24,62,13,99
"18245","chr5",79519955,79519976,22,71,56,149
"18246","chr5",79525024,79525042,19,145,27,191
"18247","chr5",79551132,79551169,38,94,4,136
"18248","chr5",79594192,79594224,33,8,135,176
"18249","chr5",79965325,79965344,20,145,25,190
"18250","chr5",80272339,80272376,38,103,7,148
"18251","chr5",80307663,80307692,30,83,3,116
"18252","chr5",80381053,80381075,23,139,22,184
"18253","chr5",81234022,81234046,25,73,138,236
"18254","chr5",81393703,81393720,18,57,138,213
"18255","chr5",81393716,81393737,22,74,125,221
"18256","chr5",81463759,81463781,23,71,14,108
"18257","chr5",81750239,81750273,35,17,93,145
"18258","chr5",81750441,81750467,27,5,35,67
"18259","chr5",81750520,81750546,27,57,37,121
"18260","chr5",81811220,81811249,30,74,106,210
"18261","chr5",81824885,81824911,27,37,67,131
"18262","chr5",82439699,82439727,29,130,7,166
"18263","chr5",83217359,83217377,19,50,121,190
"18264","chr5",83701928,83701958,31,55,72,158
"18265","chr5",83747044,83747073,30,17,4,51
"18266","chr5",83835514,83835533,20,82,23,125
"18267","chr5",84230764,84230799,36,83,88,207
"18268","chr5",84346126,84346153,28,68,2,98
"18269","chr5",85426711,85426736,26,12,6,44
"18270","chr5",85924788,85924808,21,78,25,124
"18271","chr5",86144218,86144244,27,14,23,64
"18272","chr5",86150301,86150331,31,25,56,112
"18273","chr5",86226233,86226257,25,20,26,71
"18274","chr5",86239941,86239968,28,37,66,131
"18275","chr5",86413658,86413687,30,46,74,150
"18276","chr5",86615975,86615993,19,8,99,126
"18277","chr5",87252964,87252983,20,83,2,105
"18278","chr5",87776224,87776256,33,68,56,157
"18279","chr5",88141323,88141367,45,107,140,292
"18280","chr5",88141436,88141460,25,48,27,100
"18281","chr5",88208034,88208062,29,8,73,110
"18282","chr5",88680063,88680126,64,50,82,196
"18283","chr5",88685550,88685595,46,8,36,90
"18284","chr5",89175880,89175917,38,77,35,150
"18285","chr5",90189750,90189768,19,68,9,96
"18286","chr5",90483144,90483164,21,99,70,190
"18287","chr5",90765894,90765912,19,61,53,133
"18288","chr5",91279732,91279756,25,17,64,106
"18289","chr5",91328165,91328184,20,6,8,34
"18290","chr5",91380210,91380239,30,19,72,121
"18291","chr5",91524527,91524545,19,78,27,124
"18292","chr5",91878272,91878291,20,31,26,77
"18293","chr5",92866902,92866930,29,9,100,138
"18294","chr5",93224997,93225021,25,98,25,148
"18295","chr5",93271998,93272024,27,107,49,183
"18296","chr5",93491154,93491199,46,144,132,322
"18297","chr5",93581669,93582088,420,80,16,516
"18298","chr5",93584321,93584343,23,79,12,114
"18299","chr5",93584907,93584952,46,20,100,166
"18300","chr5",93585115,93585138,24,41,46,111
"18301","chr5",93863426,93863448,23,85,121,229
"18302","chr5",94453340,94453359,20,28,51,99
"18303","chr5",94487954,94487977,24,44,74,142
"18304","chr5",94564385,94564406,22,48,118,188
"18305","chr5",94564458,94564486,29,128,45,202
"18306","chr5",94920743,94920792,50,87,73,210
"18307","chr5",95069868,95069885,18,38,73,129
"18308","chr5",95140694,95140730,37,145,36,218
"18309","chr5",95284570,95284635,66,70,88,224
"18310","chr5",95284674,95284699,26,55,10,91
"18311","chr5",95504081,95504114,34,73,99,206
"18312","chr5",95620841,95620865,25,106,26,157
"18313","chr5",95806014,95806032,19,72,139,230
"18314","chr5",95881510,95881528,19,51,6,76
"18315","chr5",95954574,95954614,41,30,75,146
"18316","chr5",96662314,96662346,33,32,10,75
"18317","chr5",96807561,96807578,18,121,98,237
"18318","chr5",96808188,96808261,74,72,80,226
"18319","chr5",98774163,98774181,19,2,29,50
"18320","chr5",98928807,98928826,20,112,48,180
"18321","chr5",99818095,99818114,20,37,69,126
"18322","chr5",100381847,100381864,18,8,107,133
"18323","chr5",100504864,100504900,37,8,113,158
"18324","chr5",100864575,100864603,29,38,144,211
"18325","chr5",101132010,101132028,19,9,115,143
"18326","chr5",101612123,101612181,59,105,79,243
"18327","chr5",101864018,101864044,27,146,35,208
"18328","chr5",103220484,103220511,28,37,76,141
"18329","chr5",103223668,103223685,18,75,53,146
"18330","chr5",103258684,103258715,32,5,46,83
"18331","chr5",104835410,104835430,21,77,18,116
"18332","chr5",105144834,105144862,29,8,75,112
"18333","chr5",105654924,105654946,23,55,34,112
"18334","chr5",105882799,105882817,19,43,6,68
"18335","chr5",106218230,106218249,20,7,7,34
"18336","chr5",107410023,107410046,24,9,107,140
"18337","chr5",107670031,107670055,25,30,122,177
"18338","chr5",107672507,107672529,23,24,13,60
"18339","chr5",107675320,107675344,25,64,89,178
"18340","chr5",108381006,108381048,43,5,83,131
"18341","chr5",108381296,108381322,27,4,7,38
"18342","chr5",108681944,108681971,28,77,25,130
"18343","chr5",108702652,108702680,29,148,7,184
"18344","chr5",109690753,109690777,25,19,123,167
"18345","chr5",109755002,109755020,19,22,33,74
"18346","chr5",110676732,110676775,44,8,136,188
"18347","chr5",111224440,111224462,23,41,132,196
"18348","chr5",111609439,111609478,40,76,48,164
"18349","chr5",111618114,111618134,21,20,49,90
"18350","chr5",112159902,112159919,18,68,25,111
"18351","chr5",112764079,112764096,18,145,30,193
"18352","chr5",112836010,112836035,26,123,8,157
"18353","chr5",113334591,113334608,18,8,60,86
"18354","chr5",113432134,113432160,27,64,76,167
"18355","chr5",113786193,113786210,18,56,29,103
"18356","chr5",113786210,113786230,21,76,12,109
"18357","chr5",114362472,114362491,20,85,19,124
"18358","chr5",114520121,114520159,39,79,79,197
"18359","chr5",115508905,115508931,27,27,35,89
"18360","chr5",116244647,116244683,37,30,85,152
"18361","chr5",116448171,116448196,26,108,34,168
"18362","chr5",116466060,116466083,24,142,58,224
"18363","chr5",116635339,116635374,36,74,46,156
"18364","chr5",116698163,116698183,21,19,6,46
"18365","chr5",116997618,116997641,24,56,8,88
"18366","chr5",117222339,117222386,48,32,74,154
"18367","chr5",117565662,117565733,72,10,11,93
"18368","chr5",117689569,117689612,44,8,76,128
"18369","chr5",118432159,118432180,22,29,143,194
"18370","chr5",118562347,118562455,109,131,65,305
"18371","chr5",118991364,118991391,28,69,74,171
"18372","chr5",119315068,119315098,31,75,56,162
"18373","chr5",119407630,119407647,18,143,72,233
"18374","chr5",120021417,120021458,42,8,125,175
"18375","chr5",120331422,120331443,22,75,11,108
"18376","chr5",121961699,121961747,49,35,119,203
"18377","chr5",122021845,122021874,30,120,142,292
"18378","chr5",122725512,122725541,30,97,1,128
"18379","chr5",122752313,122752331,19,134,63,216
"18380","chr5",122758356,122758390,35,128,8,171
"18381","chr5",122848542,122848559,18,76,32,126
"18382","chr5",123075829,123075855,27,29,74,130
"18383","chr5",123090640,123090661,22,101,147,270
"18384","chr5",123110555,123110584,30,75,142,247
"18385","chr5",123285672,123285723,52,56,110,218
"18386","chr5",123512412,123512434,23,51,10,84
"18387","chr5",123696111,123696129,19,5,109,133
"18388","chr5",124693975,124693993,19,76,17,112
"18389","chr5",124694143,124694167,25,30,75,130
"18390","chr5",125000812,125000831,20,29,24,73
"18391","chr5",126057158,126057180,23,98,29,150
"18392","chr5",126366847,126366872,26,76,71,173
"18393","chr5",126532614,126532635,22,84,3,109
"18394","chr5",126538156,126538178,23,117,50,190
"18395","chr5",126567776,126567801,26,76,8,110
"18396","chr5",126638584,126638612,29,8,134,171
"18397","chr5",126663968,126663991,24,8,9,41
"18398","chr5",126696120,126696142,23,4,69,96
"18399","chr5",126706684,126706726,43,71,56,170
"18400","chr5",126765765,126765790,26,8,39,73
"18401","chr5",126784349,126784370,22,5,129,156
"18402","chr5",126854611,126854634,24,62,111,197
"18403","chr5",126954200,126954222,23,29,143,195
"18404","chr5",127447168,127447194,27,9,135,171
"18405","chr5",127517817,127517835,19,91,100,210
"18406","chr5",127903242,127903259,18,19,7,44
"18407","chr5",128084240,128084274,35,88,15,138
"18408","chr5",128127117,128127139,23,36,60,119
"18409","chr5",128455991,128456023,33,86,71,190
"18410","chr5",128480725,128480748,24,141,59,224
"18411","chr5",129127357,129127381,25,18,11,54
"18412","chr5",129981051,129981071,21,77,27,125
"18413","chr5",130291134,130291171,38,3,74,115
"18414","chr5",130891127,130891146,20,72,67,159
"18415","chr5",131208672,131208695,24,28,76,128
"18416","chr5",131238501,131238519,19,70,8,97
"18417","chr5",131363696,131363713,18,8,126,152
"18418","chr5",131819766,131819793,28,8,26,62
"18419","chr5",131880265,131880282,18,35,67,120
"18420","chr5",132011566,132011589,24,55,62,141
"18421","chr5",132106497,132106519,23,145,34,202
"18422","chr5",132227662,132227689,28,32,118,178
"18423","chr5",132228034,132228062,29,2,4,35
"18424","chr5",132257658,132257687,30,43,5,78
"18425","chr5",132257700,132257726,27,82,87,196
"18426","chr5",132482664,132482686,23,144,135,302
"18427","chr5",132687273,132687291,19,75,47,141
"18428","chr5",132730467,132730494,28,137,73,238
"18429","chr5",132740502,132740557,56,6,141,203
"18430","chr5",132848249,132848275,27,17,7,51
"18431","chr5",132914229,132914247,19,74,72,165
"18432","chr5",132954547,132954565,19,76,74,169
"18433","chr5",132977691,132977710,20,4,82,106
"18434","chr5",133004483,133004503,21,5,136,162
"18435","chr5",133008225,133008243,19,133,6,158
"18436","chr5",133025504,133025533,30,8,6,44
"18437","chr5",133032198,133032226,29,23,6,58
"18438","chr5",133033786,133033818,33,7,73,113
"18439","chr5",133083135,133083162,28,108,6,142
"18440","chr5",133344969,133344986,18,76,31,125
"18441","chr5",133690063,133690097,35,129,41,205
"18442","chr5",133862336,133862364,29,147,70,246
"18443","chr5",134033624,134033642,19,79,108,206
"18444","chr5",134046010,134046041,32,74,120,226
"18445","chr5",134055589,134055619,31,47,73,151
"18446","chr5",134297891,134297947,57,72,1,130
"18447","chr5",134357439,134357472,34,136,11,181
"18448","chr5",134371474,134371505,32,45,104,181
"18449","chr5",134424747,134424765,19,66,74,159
"18450","chr5",134425691,134425713,23,34,7,64
"18451","chr5",134603799,134603839,41,143,6,190
"18452","chr5",134627802,134627844,43,134,3,180
"18453","chr5",134645851,134645886,36,113,74,223
"18454","chr5",134656779,134656799,21,121,12,154
"18455","chr5",134698631,134698649,19,7,96,122
"18456","chr5",134717508,134717531,24,42,5,71
"18457","chr5",134848659,134848680,22,148,76,246
"18458","chr5",134875666,134875687,22,76,139,237
"18459","chr5",134904319,134904337,19,12,2,33
"18460","chr5",135028550,135028573,24,27,54,105
"18461","chr5",135028717,135028736,20,72,33,125
"18462","chr5",135031607,135031624,18,111,111,240
"18463","chr5",135034145,135034175,31,113,3,147
"18464","chr5",135039041,135039068,28,97,27,152
"18465","chr5",135236500,135236525,26,112,27,165
"18466","chr5",135263702,135263720,19,84,3,106
"18467","chr5",135268646,135268664,19,78,14,111
"18468","chr5",135400178,135400195,18,101,37,156
"18469","chr5",135544403,135544452,50,92,74,216
"18470","chr5",135929662,135929691,30,114,8,152
"18471","chr5",136167778,136167795,18,36,6,60
"18472","chr5",136335904,136335929,26,29,74,129
"18473","chr5",137557242,137557266,25,8,6,39
"18474","chr5",137712157,137712182,26,143,8,177
"18475","chr5",137916476,137916497,22,8,83,113
"18476","chr5",138067617,138067640,24,7,7,38
"18477","chr5",138108384,138108441,58,76,133,267
"18478","chr5",138220945,138220965,21,9,38,68
"18479","chr5",138249175,138249192,18,76,99,193
"18480","chr5",138258167,138258197,31,7,7,45
"18481","chr5",138265207,138265233,27,75,50,152
"18482","chr5",138270206,138270226,21,31,46,98
"18483","chr5",138322467,138322493,27,8,143,178
"18484","chr5",138439087,138439127,41,79,13,133
"18485","chr5",138465277,138465294,18,79,15,112
"18486","chr5",138474847,138474880,34,75,74,183
"18487","chr5",138494979,138495006,28,8,106,142
"18488","chr5",138550464,138550482,19,77,27,123
"18489","chr5",138577799,138577818,20,15,143,178
"18490","chr5",138755846,138755880,35,7,130,172
"18491","chr5",138893017,138893039,23,10,73,106
"18492","chr5",139035643,139035667,25,9,1,35
"18493","chr5",139227264,139227302,39,69,15,123
"18494","chr5",139231763,139231780,18,127,6,151
"18495","chr5",139250628,139250667,40,69,14,123
"18496","chr5",139275143,139275170,28,29,143,200
"18497","chr5",139341012,139341038,27,11,3,41
"18498","chr5",139405656,139405676,21,5,32,58
"18499","chr5",139492207,139492225,19,142,73,234
"18500","chr5",139497184,139497201,18,10,43,71
"18501","chr5",139517548,139517584,37,109,70,216
"18502","chr5",139521015,139521032,18,84,43,145
"18503","chr5",139536070,139536116,47,44,133,224
"18504","chr5",139561535,139561569,35,65,35,135
"18505","chr5",139561727,139561765,39,91,10,140
"18506","chr5",139582969,139582991,23,7,146,176
"18507","chr5",139710942,139710959,18,27,56,101
"18508","chr5",139711324,139711348,25,48,89,162
"18509","chr5",139771369,139771395,27,7,46,80
"18510","chr5",139795758,139795780,23,13,21,57
"18511","chr5",139848470,139848507,38,87,97,222
"18512","chr5",140042904,140042998,95,3,18,116
"18513","chr5",140043243,140043266,24,67,53,144
"18514","chr5",140107832,140107857,26,76,109,211
"18515","chr5",140158062,140158083,22,80,6,108
"18516","chr5",140200558,140200578,21,76,145,242
"18517","chr5",140304393,140304414,22,8,142,172
"18518","chr5",140314521,140314541,21,136,27,184
"18519","chr5",140358240,140358259,20,137,31,188
"18520","chr5",140402135,140402167,33,35,83,151
"18521","chr5",140429091,140429109,19,6,140,165
"18522","chr5",140648008,140648060,53,139,55,247
"18523","chr5",140746307,140746324,18,9,137,164
"18524","chr5",140966832,140966873,42,37,13,92
"18525","chr5",141202607,141202634,28,13,59,100
"18526","chr5",141236186,141236211,26,63,134,223
"18527","chr5",141320354,141320371,18,64,134,216
"18528","chr5",141334468,141334499,32,7,115,154
"18529","chr5",141455857,141455914,58,7,57,122
"18530","chr5",141573435,141573456,22,96,6,124
"18531","chr5",141683101,141683164,64,128,17,209
"18532","chr5",141688311,141688340,30,117,139,286
"18533","chr5",141703048,141703093,46,83,37,166
"18534","chr5",141850522,141850553,32,42,2,76
"18535","chr5",141873294,141873312,19,25,142,186
"18536","chr5",141878326,141878347,22,17,36,75
"18537","chr5",141878413,141878453,41,1,10,52
"18538","chr5",141878490,141878511,22,89,3,114
"18539","chr5",141937771,141937790,20,24,74,118
"18540","chr5",142108695,142108717,23,1,114,138
"18541","chr5",142172386,142172419,34,88,26,148
"18542","chr5",142188492,142188519,28,62,40,130
"18543","chr5",142188516,142188606,91,149,16,256
"18544","chr5",142196444,142196470,27,9,144,180
"18545","chr5",142251013,142251050,38,7,138,183
"18546","chr5",142252173,142252191,19,134,123,276
"18547","chr5",142336912,142336929,18,145,11,174
"18548","chr5",142383303,142383325,23,39,74,136
"18549","chr5",142417268,142417302,35,6,145,186
"18550","chr5",142438439,142438462,24,72,34,130
"18551","chr5",142442440,142442458,19,76,86,181
"18552","chr5",142488800,142488841,42,42,9,93
"18553","chr5",142526680,142526703,24,137,27,188
"18554","chr5",142557743,142557764,22,75,67,164
"18555","chr5",142869176,142869223,48,6,56,110
"18556","chr5",142993159,142993180,22,69,132,223
"18557","chr5",143464413,143464431,19,76,3,98
"18558","chr5",145498708,145498726,19,4,64,87
"18559","chr5",145640476,145640494,19,77,6,102
"18560","chr5",146161568,146161586,19,60,32,111
"18561","chr5",146184628,146184650,23,139,2,164
"18562","chr5",146259980,146260007,28,137,67,232
"18563","chr5",146454038,146454061,24,87,27,138
"18564","chr5",147235008,147235055,48,126,95,269
"18565","chr5",147453967,147453999,33,40,22,95
"18566","chr5",147494710,147494729,20,77,27,124
"18567","chr5",147571834,147571860,27,44,72,143
"18568","chr5",147676338,147676356,19,56,4,79
"18569","chr5",147782665,147782685,21,6,52,79
"18570","chr5",147952292,147952310,19,9,4,32
"18571","chr5",148059641,148059665,25,108,26,159
"18572","chr5",148105784,148105803,20,35,75,130
"18573","chr5",148128510,148128543,34,118,92,244
"18574","chr5",148295081,148295102,22,29,143,194
"18575","chr5",148430322,148430348,27,76,75,178
"18576","chr5",148605237,148605272,36,4,70,110
"18577","chr5",148826474,148826505,32,126,24,182
"18578","chr5",149174022,149174045,24,106,6,136
"18579","chr5",149271795,149271823,29,12,132,173
"18580","chr5",149732046,149732078,33,55,76,164
"18581","chr5",149777785,149777827,43,8,10,61
"18582","chr5",149777923,149777964,42,80,60,182
"18583","chr5",149809116,149809528,413,67,113,593
"18584","chr5",150011594,150011621,28,75,128,231
"18585","chr5",150046813,150046831,19,5,5,29
"18586","chr5",150068234,150068258,25,98,123,246
"18587","chr5",150084391,150084472,82,10,14,106
"18588","chr5",150113287,150113317,31,9,6,46
"18589","chr5",150245339,150245381,43,29,100,172
"18590","chr5",150421653,150421689,37,12,71,120
"18591","chr5",150470694,150470716,23,6,12,41
"18592","chr5",150474554,150474585,32,77,18,127
"18593","chr5",150483623,150483642,20,101,62,183
"18594","chr5",150484541,150484562,22,76,101,199
"18595","chr5",150508323,150508352,30,68,52,150
"18596","chr5",150624680,150624698,19,122,121,262
"18597","chr5",150656738,150656776,39,37,83,159
"18598","chr5",150683170,150683196,27,8,74,109
"18599","chr5",151358981,151359007,27,127,67,221
"18600","chr5",151397765,151397788,24,101,73,198
"18601","chr5",151686871,151686894,24,1,22,47
"18602","chr5",151687930,151687957,28,73,144,245
"18603","chr5",151698454,151698477,24,44,60,128
"18604","chr5",151699978,151700008,31,146,80,257
"18605","chr5",151728654,151728695,42,59,6,107
"18606","chr5",154611059,154611077,19,50,37,106
"18607","chr5",154646639,154646665,27,5,47,79
"18608","chr5",154650651,154650673,23,21,75,119
"18609","chr5",154670231,154670251,21,3,115,139
"18610","chr5",154789220,154789239,20,78,65,163
"18611","chr5",154891056,154891076,21,123,145,289
"18612","chr5",154938728,154938752,25,80,26,131
"18613","chr5",155000959,155000977,19,58,28,105
"18614","chr5",155840589,155840610,22,28,145,195
"18615","chr5",156054285,156054303,19,76,20,115
"18616","chr5",157131595,157131614,20,77,143,240
"18617","chr5",157560265,157560292,28,117,6,151
"18618","chr5",157620057,157620077,21,5,76,102
"18619","chr5",157647062,157647079,18,8,36,62
"18620","chr5",157743954,157743999,46,9,141,196
"18621","chr5",157768876,157768897,22,46,74,142
"18622","chr5",157828928,157828952,25,77,32,134
"18623","chr5",157865050,157865073,24,15,27,66
"18624","chr5",157872671,157872688,18,113,5,136
"18625","chr5",157897964,157897986,23,125,75,223
"18626","chr5",157910582,157910611,30,74,4,108
"18627","chr5",158454806,158454831,26,122,7,155
"18628","chr5",159099263,159099282,20,57,45,122
"18629","chr5",159099920,159099955,36,107,83,226
"18630","chr5",159209409,159209429,21,37,10,68
"18631","chr5",159521203,159521220,18,68,75,161
"18632","chr5",159657106,159657124,19,115,70,204
"18633","chr5",159866296,159866313,18,143,84,245
"18634","chr5",160088224,160088242,19,100,141,260
"18635","chr5",160119164,160119194,31,17,12,60
"18636","chr5",160136467,160136494,28,16,27,71
"18637","chr5",160138014,160138044,31,20,6,57
"18638","chr5",160222318,160222351,34,8,131,173
"18639","chr5",160344766,160344783,18,27,143,188
"18640","chr5",160372686,160372704,19,76,37,132
"18641","chr5",160390541,160390562,22,97,69,188
"18642","chr5",160421951,160421995,45,143,128,316
"18643","chr5",160667217,160667254,38,101,7,146
"18644","chr5",160798745,160798768,24,76,9,109
"18645","chr5",161161625,161161670,46,46,105,197
"18646","chr5",161706546,161706564,19,64,49,132
"18647","chr5",162224867,162224891,25,7,26,58
"18648","chr5",162915977,162916003,27,6,78,111
"18649","chr5",163319598,163319623,26,16,34,76
"18650","chr5",163502029,163502048,20,46,47,113
"18651","chr5",164809226,164809258,33,76,35,144
"18652","chr5",165226423,165226463,41,30,35,106
"18653","chr5",165354879,165354905,27,30,75,132
"18654","chr5",165498840,165498857,18,108,74,200
"18655","chr5",165542236,165542390,155,36,17,208
"18656","chr5",165964113,165964135,23,55,108,186
"18657","chr5",166042515,166042533,19,8,66,93
"18658","chr5",166204337,166204364,28,28,142,198
"18659","chr5",166867134,166867165,32,8,66,106
"18660","chr5",168143844,168143866,23,75,27,125
"18661","chr5",168238158,168238222,65,51,61,177
"18662","chr5",168271710,168271735,26,5,4,35
"18663","chr5",168431458,168431504,47,148,2,197
"18664","chr5",168504522,168504544,23,141,75,239
"18665","chr5",168579575,168579600,26,59,22,107
"18666","chr5",168677444,168677465,22,7,137,166
"18667","chr5",168905005,168905028,24,78,29,131
"18668","chr5",169187529,169187574,46,48,27,121
"18669","chr5",169265157,169265183,27,91,21,139
"18670","chr5",169520252,169520284,33,75,140,248
"18671","chr5",170305309,170305331,23,17,3,43
"18672","chr5",170308157,170308176,20,38,43,101
"18673","chr5",170566234,170566272,39,35,37,111
"18674","chr5",170587422,170587446,25,53,5,83
"18675","chr5",170861820,170861870,51,7,68,126
"18676","chr5",171309332,171309350,19,56,104,179
"18677","chr5",171315947,171315964,18,77,36,131
"18678","chr5",171324822,171324846,25,76,33,134
"18679","chr5",171367389,171367437,49,93,67,209
"18680","chr5",171374106,171374129,24,45,74,143
"18681","chr5",171394031,171394062,32,47,41,120
"18682","chr5",171420096,171420128,33,142,30,205
"18683","chr5",171437385,171437402,18,114,88,220
"18684","chr5",171445973,171446041,69,101,59,229
"18685","chr5",171449361,171449401,41,61,65,167
"18686","chr5",171449401,171449443,43,103,25,171
"18687","chr5",171450714,171450737,24,93,80,197
"18688","chr5",172010661,172010866,206,80,109,395
"18689","chr5",172112417,172112439,23,9,64,96
"18690","chr5",172121337,172121361,25,31,2,58
"18691","chr5",172188064,172188091,28,14,132,174
"18692","chr5",172188252,172188270,19,11,116,146
"18693","chr5",172195800,172195825,26,80,133,239
"18694","chr5",172286713,172286737,25,77,6,108
"18695","chr5",172314619,172314640,22,133,74,229
"18696","chr5",172331197,172331217,21,80,72,173
"18697","chr5",172379070,172379091,22,40,6,68
"18698","chr5",172454090,172454111,22,51,5,78
"18699","chr5",172454482,172454505,24,2,135,161
"18700","chr5",172454544,172454620,77,49,73,199
"18701","chr5",172570064,172570083,20,119,122,261
"18702","chr5",172624847,172624881,35,50,45,130
"18703","chr5",172697943,172697962,20,35,21,76
"18704","chr5",172702311,172702363,53,43,74,170
"18705","chr5",172751117,172751310,194,77,12,283
"18706","chr5",172812232,172812250,19,145,76,240
"18707","chr5",172851201,172851220,20,6,6,32
"18708","chr5",172938753,172938775,23,7,55,85
"18709","chr5",172958265,172958284,20,8,5,33
"18710","chr5",172974770,172974796,27,77,35,139
"18711","chr5",172979334,172979352,19,134,2,155
"18712","chr5",173017534,173017551,18,138,74,230
"18713","chr5",173027324,173027343,20,99,35,154
"18714","chr5",173049543,173049570,28,4,124,156
"18715","chr5",173058787,173058813,27,76,7,110
"18716","chr5",173129107,173129134,28,8,118,154
"18717","chr5",173172711,173172728,18,38,74,130
"18718","chr5",173238791,173238828,38,32,108,178
"18719","chr5",173328239,173328291,53,24,42,119
"18720","chr5",173464000,173464034,35,11,99,145
"18721","chr5",173602773,173602798,26,77,100,203
"18722","chr5",173636455,173636480,26,113,6,145
"18723","chr5",173907310,173907327,18,14,31,63
"18724","chr5",174142599,174142621,23,28,76,127
"18725","chr5",174353605,174353643,39,77,131,247
"18726","chr5",174528903,174528925,23,141,17,181
"18727","chr5",174541926,174541948,23,69,33,125
"18728","chr5",174615314,174615340,27,8,22,57
"18729","chr5",174650065,174650108,44,59,127,230
"18730","chr5",174710750,174710780,31,13,139,183
"18731","chr5",174721103,174721129,27,107,68,202
"18732","chr5",174727053,174727080,28,31,137,196
"18733","chr5",175028489,175028510,22,8,146,176
"18734","chr5",175169879,175169908,30,38,142,210
"18735","chr5",175302174,175302196,23,37,135,195
"18736","chr5",175602918,175602946,29,71,5,105
"18737","chr5",175838267,175838285,19,8,23,50
"18738","chr5",175873094,175873130,37,67,64,168
"18739","chr5",175990251,175990271,21,143,23,187
"18740","chr5",176058520,176058544,25,76,3,104
"18741","chr5",176128501,176128525,25,145,6,176
"18742","chr5",176238406,176238437,32,13,51,96
"18743","chr5",176291331,176291354,24,76,143,243
"18744","chr5",176364212,176364236,25,8,21,54
"18745","chr5",176412175,176412193,19,36,75,130
"18746","chr5",176445109,176445137,29,75,98,202
"18747","chr5",176477108,176477125,18,36,12,66
"18748","chr5",176525069,176525094,26,78,113,217
"18749","chr5",176544312,176544451,140,70,22,232
"18750","chr5",176556936,176556981,46,24,70,140
"18751","chr5",176556966,176556998,33,41,40,114
"18752","chr5",176609769,176609803,35,30,73,138
"18753","chr5",176610046,176610068,23,27,28,78
"18754","chr5",176630495,176630520,26,12,9,47
"18755","chr5",176810719,176810746,28,132,37,197
"18756","chr5",176852239,176852391,153,127,40,320
"18757","chr5",176895077,176895095,19,8,145,172
"18758","chr5",177013362,177013402,41,78,5,124
"18759","chr5",177096848,177097135,288,57,123,468
"18760","chr5",177108469,177108499,31,147,4,182
"18761","chr5",177115735,177115754,20,11,74,105
"18762","chr5",177117811,177117838,28,104,42,174
"18763","chr5",177133041,177133064,24,133,19,176
"18764","chr5",177159282,177159300,19,60,2,81
"18765","chr5",177207260,177207299,40,75,133,248
"18766","chr5",177261237,177261260,24,35,76,135
"18767","chr5",177303818,177303838,21,10,6,37
"18768","chr5",177303902,177303919,18,51,8,77
"18769","chr5",177352814,177352857,44,110,9,163
"18770","chr5",177415868,177415886,19,113,9,141
"18771","chr5",177416039,177416061,23,32,35,90
"18772","chr5",177426737,177426769,33,12,14,59
"18773","chr5",177447249,177447276,28,80,21,129
"18774","chr5",177461095,177461116,22,8,134,164
"18775","chr5",177473407,177473429,23,44,8,75
"18776","chr5",177490625,177490766,142,21,4,167
"18777","chr5",177492025,177492046,22,30,68,120
"18778","chr5",177497009,177497046,38,119,16,173
"18779","chr5",177497383,177497409,27,22,64,113
"18780","chr5",177553956,177553979,24,3,24,51
"18781","chr5",177593156,177593176,21,145,88,254
"18782","chr5",177672221,177672253,33,79,11,123
"18783","chr5",177672268,177672303,36,26,143,205
"18784","chr5",177709664,177709689,26,8,142,176
"18785","chr5",177785543,177785561,19,5,74,98
"18786","chr5",177853528,177853551,24,25,141,190
"18787","chr5",177965354,177965391,38,59,79,176
"18788","chr5",178007939,178007958,20,78,27,125
"18789","chr5",178079592,178079617,26,74,64,164
"18790","chr5",178179077,178179101,25,147,75,247
"18791","chr5",178180904,178180936,33,7,39,79
"18792","chr5",178203505,178203527,23,12,132,167
"18793","chr5",178205276,178205296,21,7,16,44
"18794","chr5",178220195,178220213,19,144,25,188
"18795","chr5",178232401,178232437,37,103,33,173
"18796","chr5",178249980,178250009,30,73,50,153
"18797","chr5",178425423,178425469,47,8,5,60
"18798","chr5",178565951,178565978,28,77,33,138
"18799","chr5",178609735,178609757,23,75,22,120
"18800","chr5",178659931,178659964,34,76,96,206
"18801","chr5",178701677,178701735,59,48,29,136
"18802","chr5",178728783,178728800,18,27,20,65
"18803","chr5",178791647,178791666,20,29,54,103
"18804","chr5",178857086,178857118,33,63,74,170
"18805","chr5",179013761,179013786,26,70,6,102
"18806","chr5",179205752,179205786,35,5,104,144
"18807","chr5",179302380,179302407,28,24,89,141
"18808","chr5",179309758,179309784,27,128,25,180
"18809","chr5",179345199,179345260,62,45,17,124
"18810","chr5",179345259,179345284,26,69,41,136
"18811","chr5",179457930,179457949,20,84,50,154
"18812","chr5",179479050,179479075,26,6,4,36
"18813","chr5",179529273,179529310,38,8,10,56
"18814","chr5",179548828,179548845,18,142,73,233
"18815","chr5",179549750,179549772,23,59,69,151
"18816","chr5",179550513,179550547,35,34,27,96
"18817","chr5",179550611,179550633,23,80,118,221
"18818","chr5",179581439,179581459,21,8,133,162
"18819","chr5",179587363,179587398,36,65,1,102
"18820","chr5",179597226,179597251,26,74,137,237
"18821","chr5",179609207,179609225,19,36,56,111
"18822","chr5",179612523,179612542,20,15,6,41
"18823","chr5",179622924,179622975,52,39,84,175
"18824","chr5",179632754,179632774,21,80,29,130
"18825","chr5",179633291,179633316,26,12,145,183
"18826","chr5",179633462,179633485,24,114,76,214
"18827","chr5",179677777,179677801,25,73,5,103
"18828","chr5",179679959,179679984,26,29,118,173
"18829","chr5",179687081,179687108,28,64,141,233
"18830","chr5",179693672,179693693,22,23,8,53
"18831","chr5",179695629,179695665,37,5,11,53
"18832","chr5",179696268,179696292,25,7,95,127
"18833","chr5",179743365,179743386,22,10,64,96
"18834","chr5",179790632,179790667,36,3,10,49
"18835","chr5",179805977,179806002,26,72,72,170
"18836","chr5",179806664,179806681,18,78,117,213
"18837","chr5",179806888,179806921,34,3,16,53
"18838","chr5",179809638,179809661,24,8,9,41
"18839","chr5",179857088,179857117,30,98,72,200
"18840","chr5",179860208,179860226,19,5,133,157
"18841","chr5",179907885,179907920,36,3,72,111
"18842","chr5",179968294,179968316,23,52,7,82
"18843","chr5",180066835,180066873,39,21,72,132
"18844","chr5",180170888,180170916,29,26,75,130
"18845","chr5",180182205,180182231,27,77,6,110
"18846","chr5",180183823,180183850,28,108,7,143
"18847","chr5",180194003,180194023,21,12,78,111
"18848","chr5",180195765,180195791,27,117,71,215
"18849","chr5",180199657,180199707,51,134,80,265
"18850","chr5",180209105,180209151,47,101,73,221
"18851","chr5",180291966,180291998,33,71,23,127
"18852","chr5",180313593,180313628,36,46,4,86
"18853","chr5",180352340,180352359,20,52,47,119
"18854","chr5",180425681,180425783,103,4,145,252
"18855","chr5",180426559,180426676,118,97,11,226
"18856","chr5",180452498,180452521,24,86,8,118
"18857","chr5",180475355,180475399,45,143,4,192
"18858","chr5",180494447,180494480,34,108,15,157
"18859","chr5",180500421,180500453,33,74,49,156
"18860","chr5",180503602,180503625,24,10,108,142
"18861","chr5",180649625,180649648,24,12,74,110
"18862","chr5",180650170,180650187,18,64,92,174
"18863","chr5",180663579,180663613,35,93,116,244
"18864","chr5",180802857,180802876,20,105,13,138
"18865","chr5",181053000,181053036,37,50,2,89
"18866","chr5",181146273,181146311,39,128,59,226
"18867","chr5",181174898,181174933,36,73,6,115
"18868","chr5",181178140,181178174,35,65,56,156
"18869","chr5",181254366,181254385,20,68,123,211
"18870","chr5",181442671,181442688,18,78,49,145
"18871","chr6",256464,256481,18,74,51,143
"18872","chr6",450990,451027,38,43,97,178
"18873","chr6",651657,651701,45,73,71,189
"18874","chr6",736336,736359,24,9,43,76
"18875","chr6",1171407,1171427,21,54,21,96
"18876","chr6",1389751,1389770,20,15,17,52
"18877","chr6",1390035,1390070,36,25,1,62
"18878","chr6",1390081,1390136,56,91,7,154
"18879","chr6",1390743,1390763,21,5,119,145
"18880","chr6",1392435,1392477,43,35,19,97
"18881","chr6",1540536,1540565,30,58,73,161
"18882","chr6",1609682,1609715,34,67,37,138
"18883","chr6",1611568,1611586,19,44,17,80
"18884","chr6",1611783,1611806,24,19,27,70
"18885","chr6",1611907,1611926,20,3,65,88
"18886","chr6",1614758,1614779,22,82,6,110
"18887","chr6",1682561,1682587,27,8,68,103
"18888","chr6",1722244,1722263,20,32,65,117
"18889","chr6",2141866,2141896,31,58,45,134
"18890","chr6",2283089,2283113,25,148,75,248
"18891","chr6",2357053,2357072,20,8,136,164
"18892","chr6",2788917,2788938,22,96,67,185
"18893","chr6",2851320,2851342,23,72,135,230
"18894","chr6",2999761,2999811,51,26,12,89
"18895","chr6",3053867,3053885,19,20,134,173
"18896","chr6",3126922,3126943,22,38,74,134
"18897","chr6",3163165,3163192,28,100,92,220
"18898","chr6",3280491,3280513,23,8,5,36
"18899","chr6",3396549,3396571,23,37,74,134
"18900","chr6",3457092,3457125,34,33,40,107
"18901","chr6",3839969,3840006,38,72,48,158
"18902","chr6",3839987,3840011,25,77,30,132
"18903","chr6",3904018,3904041,24,30,7,61
"18904","chr6",3904059,3904083,25,72,16,113
"18905","chr6",3923623,3923654,32,148,74,254
"18906","chr6",3933384,3933407,24,45,70,139
"18907","chr6",4413219,4413237,19,145,77,241
"18908","chr6",4746361,4746379,19,6,77,102
"18909","chr6",4769966,4770010,45,30,141,216
"18910","chr6",4776280,4776305,26,21,83,130
"18911","chr6",4780401,4780428,28,15,74,117
"18912","chr6",4970468,4970496,29,77,68,174
"18913","chr6",5011843,5011867,25,12,5,42
"18914","chr6",5144625,5144655,31,11,18,60
"18915","chr6",5577774,5577814,41,71,80,192
"18916","chr6",5891917,5891956,40,69,126,235
"18917","chr6",6003588,6003608,21,1,13,35
"18918","chr6",6007567,6007598,32,60,134,226
"18919","chr6",6856075,6856107,33,145,6,184
"18920","chr6",6937369,6937398,30,6,135,171
"18921","chr6",7107674,7107709,36,3,73,112
"18922","chr6",7108317,7108349,33,32,41,106
"18923","chr6",7642406,7642431,26,76,145,247
"18924","chr6",7652152,7652170,19,76,2,97
"18925","chr6",7719313,7719334,22,15,6,43
"18926","chr6",7727279,7727310,32,128,31,191
"18927","chr6",7835120,7835138,19,6,27,52
"18928","chr6",7910638,7910657,20,72,8,100
"18929","chr6",7910699,7910721,23,25,118,166
"18930","chr6",7961819,7961855,37,11,3,51
"18931","chr6",8226601,8226629,29,73,6,108
"18932","chr6",8326331,8326355,25,7,110,142
"18933","chr6",8946269,8946294,26,20,6,52
"18934","chr6",9494456,9494483,28,8,36,72
"18935","chr6",10147202,10147226,25,52,126,203
"18936","chr6",10326894,10326918,25,6,9,40
"18937","chr6",10349192,10349211,20,24,6,50
"18938","chr6",10376685,10376705,21,8,48,77
"18939","chr6",10398279,10398298,20,92,124,236
"18940","chr6",10398297,10398324,28,118,106,252
"18941","chr6",10412424,10412499,76,136,137,349
"18942","chr6",10579816,10579848,33,115,74,222
"18943","chr6",10601944,10601969,26,132,3,161
"18944","chr6",10694261,10694279,19,45,73,137
"18945","chr6",10823530,10823547,18,8,1,27
"18946","chr6",10848292,10848309,18,72,9,99
"18947","chr6",10881555,10881607,53,66,48,167
"18948","chr6",10883710,10883751,42,109,62,213
"18949","chr6",11034683,11034703,21,61,6,88
"18950","chr6",11380799,11380826,28,36,77,141
"18951","chr6",11591461,11591478,18,69,48,135
"18952","chr6",12009115,12009145,31,76,8,115
"18953","chr6",12012448,12012465,18,67,23,108
"18954","chr6",12041421,12041444,24,148,7,179
"18955","chr6",13319461,13319488,28,3,5,36
"18956","chr6",13328503,13328531,29,113,28,170
"18957","chr6",13365879,13365923,45,146,87,278
"18958","chr6",13487694,13487727,34,97,44,175
"18959","chr6",13574142,13574163,22,28,72,122
"18960","chr6",13705407,13705435,29,3,31,63
"18961","chr6",13711237,13711292,56,9,77,142
"18962","chr6",13711451,13711476,26,9,51,86
"18963","chr6",13711475,13711494,20,27,27,74
"18964","chr6",13775507,13775528,22,78,27,127
"18965","chr6",13804323,13804356,34,11,74,119
"18966","chr6",13873362,13873386,25,2,65,92
"18967","chr6",14117591,14117643,53,37,96,186
"18968","chr6",14211556,14211576,21,70,3,94
"18969","chr6",14271387,14271406,20,115,141,276
"18970","chr6",14823650,14823668,19,137,4,160
"18971","chr6",14840706,14840729,24,81,5,110
"18972","chr6",15022816,15022846,31,26,74,131
"18973","chr6",15023250,15023267,18,30,42,90
"18974","chr6",15023265,15023288,24,51,27,102
"18975","chr6",15061591,15061616,26,76,47,149
"18976","chr6",15084474,15084660,187,72,24,283
"18977","chr6",15095239,15095266,28,6,23,57
"18978","chr6",15114691,15114726,36,54,74,164
"18979","chr6",15147677,15147709,33,29,11,73
"18980","chr6",15147681,15147718,38,38,7,83
"18981","chr6",15162027,15162048,22,1,103,126
"18982","chr6",15174016,15174036,21,135,23,179
"18983","chr6",15229335,15229358,24,7,7,38
"18984","chr6",15236363,15236380,18,73,142,233
"18985","chr6",15248426,15248461,36,7,27,70
"18986","chr6",15282955,15282972,18,52,91,161
"18987","chr6",15283706,15283723,18,8,81,107
"18988","chr6",15693990,15694021,32,102,6,140
"18989","chr6",15832340,15832360,21,82,75,178
"18990","chr6",16066577,16066622,46,11,60,117
"18991","chr6",16129360,16129377,18,21,28,67
"18992","chr6",16256352,16256372,21,70,35,126
"18993","chr6",16327634,16327724,91,137,35,263
"18994","chr6",16574202,16574223,22,77,36,135
"18995","chr6",16606868,16606888,21,60,105,186
"18996","chr6",16663643,16663682,40,8,58,106
"18997","chr6",16814576,16814597,22,9,96,127
"18998","chr6",17102344,17102372,29,12,97,138
"18999","chr6",17232729,17232746,18,11,145,174
"19000","chr6",17393907,17393963,57,2,13,72
"19001","chr6",17487773,17487797,25,122,7,154
"19002","chr6",17728177,17728206,30,9,12,51
"19003","chr6",17741231,17741254,24,8,57,89
"19004","chr6",17750258,17750279,22,76,146,244
"19005","chr6",17757657,17757681,25,9,76,110
"19006","chr6",17814250,17814268,19,78,13,110
"19007","chr6",17987667,17987708,42,3,105,150
"19008","chr6",18006560,18006581,22,52,74,148
"19009","chr6",18007503,18007521,19,74,72,165
"19010","chr6",18119155,18119183,29,140,74,243
"19011","chr6",18155437,18155456,20,17,20,57
"19012","chr6",18214914,18214932,19,44,2,65
"19013","chr6",19528551,19528577,27,7,87,121
"19014","chr6",19837875,19837894,20,112,46,178
"19015","chr6",19967304,19967330,27,74,34,135
"19016","chr6",20068411,20068431,21,26,114,161
"19017","chr6",20102115,20102145,31,88,6,125
"19018","chr6",20152823,20152851,29,9,5,43
"19019","chr6",20171383,20171403,21,77,107,205
"19020","chr6",20402364,20402391,28,25,66,119
"19021","chr6",20402594,20402619,26,112,31,169
"19022","chr6",21318764,21318795,32,29,21,82
"19023","chr6",21332637,21332668,32,66,6,104
"19024","chr6",21354150,21354187,38,27,75,140
"19025","chr6",21499001,21499022,22,146,74,242
"19026","chr6",21545764,21545784,21,133,3,157
"19027","chr6",21554072,21554097,26,37,67,130
"19028","chr6",21588965,21588995,31,78,121,230
"19029","chr6",21606328,21606345,18,77,75,170
"19030","chr6",21629589,21629607,19,78,4,101
"19031","chr6",21636415,21636438,24,5,74,103
"19032","chr6",21640645,21640668,24,65,1,90
"19033","chr6",21658296,21658349,54,74,10,138
"19034","chr6",21660191,21660214,24,4,121,149
"19035","chr6",21675752,21675781,30,11,140,181
"19036","chr6",21686379,21686399,21,67,40,128
"19037","chr6",21715945,21715971,27,5,18,50
"19038","chr6",21746362,21746381,20,7,97,124
"19039","chr6",21758048,21758076,29,37,75,141
"19040","chr6",21758201,21758224,24,11,139,174
"19041","chr6",21762808,21762844,37,62,50,149
"19042","chr6",21805940,21805965,26,68,24,118
"19043","chr6",21812267,21812284,18,10,146,174
"19044","chr6",21814662,21814701,40,22,42,104
"19045","chr6",21895084,21895109,26,144,4,174
"19046","chr6",22570077,22570137,61,40,43,144
"19047","chr6",22570118,22570144,27,47,2,76
"19048","chr6",23948717,23948751,35,92,6,133
"19049","chr6",23949079,23949114,36,92,76,204
"19050","chr6",24432248,24432268,21,100,118,239
"19051","chr6",24475689,24475708,20,77,27,124
"19052","chr6",24483901,24483929,29,4,84,117
"19053","chr6",24748742,24748765,24,19,7,50
"19054","chr6",24819663,24819682,20,37,93,150
"19055","chr6",24914320,24914361,42,68,22,132
"19056","chr6",25180057,25180095,39,55,6,100
"19057","chr6",25271473,25271494,22,76,16,114
"19058","chr6",25299171,25299188,18,76,51,145
"19059","chr6",25526151,25526196,46,80,30,156
"19060","chr6",25988460,25988513,54,10,21,85
"19061","chr6",26019979,26020001,23,7,123,153
"19062","chr6",26145835,26145888,54,124,117,295
"19063","chr6",26221301,26221325,25,7,1,33
"19064","chr6",26241776,26241793,18,138,9,165
"19065","chr6",26349231,26349255,25,77,1,103
"19066","chr6",26467310,26467330,21,9,47,77
"19067","chr6",26570694,26570713,20,4,105,129
"19068","chr6",26587661,26587689,29,6,69,104
"19069","chr6",26588917,26588948,32,8,26,66
"19070","chr6",26676734,26676801,68,137,119,324
"19071","chr6",26708786,26708861,76,132,15,223
"19072","chr6",26792797,26792872,76,17,130,223
"19073","chr6",26824860,26824927,68,121,135,324
"19074","chr6",27142637,27142656,20,78,44,142
"19075","chr6",27147818,27147842,25,11,72,108
"19076","chr6",27171941,27171968,28,31,140,199
"19077","chr6",27210444,27210473,30,26,72,128
"19078","chr6",27213516,27213535,20,147,20,187
"19079","chr6",27235607,27235637,31,93,102,226
"19080","chr6",27236006,27236080,75,65,37,177
"19081","chr6",27372862,27372879,18,28,75,121
"19082","chr6",27525852,27525894,43,4,16,63
"19083","chr6",27526184,27526223,40,71,7,118
"19084","chr6",27561021,27561080,60,7,35,102
"19085","chr6",27577157,27577180,24,78,26,128
"19086","chr6",27583324,27583351,28,22,63,113
"19087","chr6",27615048,27615070,23,39,134,196
"19088","chr6",27629388,27629406,19,129,8,156
"19089","chr6",27664285,27664308,24,80,22,126
"19090","chr6",27739555,27739582,28,6,114,148
"19091","chr6",27875501,27875530,30,52,46,128
"19092","chr6",28080544,28080566,23,29,76,128
"19093","chr6",28398762,28398783,22,77,27,126
"19094","chr6",28605679,28605696,18,77,26,121
"19095","chr6",28638504,28638534,31,18,6,55
"19096","chr6",28665644,28665662,19,76,3,98
"19097","chr6",28695461,28695485,25,8,40,73
"19098","chr6",28709067,28709090,24,136,7,167
"19099","chr6",28716140,28716177,38,97,6,141
"19100","chr6",28742607,28742648,42,56,6,104
"19101","chr6",28796471,28796577,107,19,10,136
"19102","chr6",28891825,28891856,32,78,38,148
"19103","chr6",28894736,28894777,42,64,133,239
"19104","chr6",28934812,28934834,23,75,144,242
"19105","chr6",28951860,28951878,19,45,75,139
"19106","chr6",29005317,29005334,18,6,143,167
"19107","chr6",29651166,29651189,24,132,74,230
"19108","chr6",29682524,29682548,25,37,58,120
"19109","chr6",29692710,29692753,44,31,141,216
"19110","chr6",29702139,29702165,27,37,63,127
"19111","chr6",30162276,30162325,50,104,19,173
"19112","chr6",30187918,30187937,20,13,6,39
"19113","chr6",30212916,30212935,20,78,135,233
"19114","chr6",30243811,30243873,63,123,1,187
"19115","chr6",30487331,30487350,20,77,115,212
"19116","chr6",30488239,30488275,37,5,80,122
"19117","chr6",30499433,30499466,34,6,6,46
"19118","chr6",30512869,30512890,22,31,29,82
"19119","chr6",30515734,30515755,22,4,80,106
"19120","chr6",30581399,30581421,23,8,60,91
"19121","chr6",30615230,30615249,20,13,104,137
"19122","chr6",30632269,30632289,21,12,71,104
"19123","chr6",30672143,30672165,23,106,39,168
"19124","chr6",30685717,30685734,18,9,93,120
"19125","chr6",30687208,30687242,35,106,71,212
"19126","chr6",30697894,30697916,23,77,89,189
"19127","chr6",30700903,30700923,21,145,37,203
"19128","chr6",30706621,30706646,26,76,7,109
"19129","chr6",30776203,30776221,19,58,8,85
"19130","chr6",30803269,30803286,18,144,34,196
"19131","chr6",30834250,30834271,22,5,71,98
"19132","chr6",30904845,30904880,36,77,144,257
"19133","chr6",30980664,30980702,39,3,38,80
"19134","chr6",31052818,31052903,86,5,43,134
"19135","chr6",31127562,31127591,30,4,51,85
"19136","chr6",31193124,31193146,23,75,144,242
"19137","chr6",31399533,31399559,27,45,74,146
"19138","chr6",31491648,31491669,22,25,8,55
"19139","chr6",31498447,31498483,37,6,19,62
"19140","chr6",31618100,31618124,25,53,73,151
"19141","chr6",31620910,31620944,35,1,5,41
"19142","chr6",31683602,31683649,48,97,16,161
"19143","chr6",31696164,31696181,18,77,6,101
"19144","chr6",31706244,31706291,48,76,9,133
"19145","chr6",31746807,31746839,33,10,89,132
"19146","chr6",31750995,31751019,25,14,106,145
"19147","chr6",31835842,31835860,19,80,145,244
"19148","chr6",31835970,31835988,19,84,17,120
"19149","chr6",31941815,31941836,22,76,107,205
"19150","chr6",31977791,31977810,20,13,32,65
"19151","chr6",32130710,32130737,28,143,63,234
"19152","chr6",32131309,32131346,38,27,103,168
"19153","chr6",32143247,32143265,19,137,74,230
"19154","chr6",32143420,32143451,32,126,9,167
"19155","chr6",32145383,32145404,22,77,2,101
"19156","chr6",32150516,32150556,41,1,11,53
"19157","chr6",32190186,32190231,46,135,7,188
"19158","chr6",32392504,32392549,46,34,72,152
"19159","chr6",32838466,32838483,18,77,63,158
"19160","chr6",32838491,32838508,18,102,38,158
"19161","chr6",32919066,32919104,39,97,138,274
"19162","chr6",33200310,33200338,29,75,8,112
"19163","chr6",33219593,33219617,25,76,145,246
"19164","chr6",33311632,33311667,36,94,86,216
"19165","chr6",33313008,33313030,23,22,113,158
"19166","chr6",33317743,33317771,29,124,23,176
"19167","chr6",33318422,33318444,23,117,45,185
"19168","chr6",33412165,33412191,27,63,71,161
"19169","chr6",33428239,33428261,23,17,5,45
"19170","chr6",33440679,33440710,32,68,147,247
"19171","chr6",33576635,33576691,57,88,72,217
"19172","chr6",33594334,33594355,22,10,8,40
"19173","chr6",33621355,33621386,32,16,34,82
"19174","chr6",33633811,33633868,58,21,104,183
"19175","chr6",33636124,33636152,29,27,34,90
"19176","chr6",33661993,33662017,25,6,9,40
"19177","chr6",33725229,33725260,32,9,74,115
"19178","chr6",33734204,33734225,22,53,42,117
"19179","chr6",33751484,33751519,36,64,4,104
"19180","chr6",33758350,33758382,33,83,34,150
"19181","chr6",33774169,33774189,21,8,27,56
"19182","chr6",33847577,33847598,22,136,74,232
"19183","chr6",34128364,34128395,32,76,42,150
"19184","chr6",34154591,34154628,38,17,16,71
"19185","chr6",34162777,34162804,28,76,52,156
"19186","chr6",34189377,34189394,18,103,75,196
"19187","chr6",34221446,34221465,20,76,10,106
"19188","chr6",34256535,34256558,24,9,58,91
"19189","chr6",34297731,34297759,29,20,128,177
"19190","chr6",34299601,34299620,20,9,134,163
"19191","chr6",34448677,34448696,20,76,44,140
"19192","chr6",34456480,34456497,18,46,1,65
"19193","chr6",34459938,34459960,23,83,5,111
"19194","chr6",34464515,34464543,29,52,146,227
"19195","chr6",34498797,34498817,21,58,73,152
"19196","chr6",34702519,34702562,44,99,7,150
"19197","chr6",34711661,34711688,28,29,93,150
"19198","chr6",34723017,34723042,26,122,32,180
"19199","chr6",34742975,34742993,19,137,5,161
"19200","chr6",34752378,34752396,19,145,71,235
"19201","chr6",34755485,34755502,18,40,74,132
"19202","chr6",34780153,34780170,18,108,74,200
"19203","chr6",34781137,34781156,20,24,78,122
"19204","chr6",34795389,34795415,27,8,106,141
"19205","chr6",34848302,34848322,21,146,56,223
"19206","chr6",34889502,34889561,60,94,89,243
"19207","chr6",35182675,35182736,62,48,8,118
"19208","chr6",35182736,35182766,31,78,19,128
"19209","chr6",35213818,35213918,101,16,28,145
"19210","chr6",35254861,35254883,23,10,4,37
"19211","chr6",35354232,35354253,22,11,74,107
"19212","chr6",35399400,35399419,20,74,73,167
"19213","chr6",35433887,35433912,26,52,73,151
"19214","chr6",35512014,35512041,28,9,96,133
"19215","chr6",35526380,35526399,20,6,55,81
"19216","chr6",35534772,35534791,20,138,52,210
"19217","chr6",35542980,35543004,25,76,2,103
"19218","chr6",35623244,35623262,19,109,41,169
"19219","chr6",35625768,35625795,28,74,42,144
"19220","chr6",35627929,35627951,23,34,75,132
"19221","chr6",35656896,35656930,35,10,75,120
"19222","chr6",35728130,35728148,19,55,41,115
"19223","chr6",35802881,35802900,20,59,75,154
"19224","chr6",35825355,35825377,23,76,136,235
"19225","chr6",35994102,35994132,31,8,134,173
"19226","chr6",36027059,36027079,21,7,139,167
"19227","chr6",36043788,36043827,40,75,95,210
"19228","chr6",36280206,36280224,19,7,74,100
"19229","chr6",36376779,36376796,18,58,71,147
"19230","chr6",36387834,36387854,21,18,37,76
"19231","chr6",36402931,36402954,24,37,47,108
"19232","chr6",36424641,36424665,25,94,5,124
"19233","chr6",36530668,36530703,36,23,144,203
"19234","chr6",36554212,36554229,18,77,6,101
"19235","chr6",36610331,36610355,25,148,78,251
"19236","chr6",36616022,36616043,22,3,73,98
"19237","chr6",36680308,36680351,44,15,111,170
"19238","chr6",36681586,36681610,25,9,111,145
"19239","chr6",36716470,36716488,19,99,6,124
"19240","chr6",36840102,36840130,29,136,15,180
"19241","chr6",36894024,36894059,36,47,74,157
"19242","chr6",36901322,36901352,31,8,105,144
"19243","chr6",36901643,36901686,44,56,2,102
"19244","chr6",36992094,36992112,19,76,78,173
"19245","chr6",37029947,37029979,33,6,135,174
"19246","chr6",37052615,37052632,18,8,31,57
"19247","chr6",37060791,37060838,48,16,18,82
"19248","chr6",37087471,37087491,21,41,75,137
"19249","chr6",37104058,37104081,24,6,121,151
"19250","chr6",37116063,37116081,19,115,13,147
"19251","chr6",37125500,37125520,21,30,75,126
"19252","chr6",37133064,37133097,34,67,75,176
"19253","chr6",37151399,37151449,51,10,109,170
"19254","chr6",37170248,37170277,30,41,35,106
"19255","chr6",37170434,37170486,53,119,103,275
"19256","chr6",37182155,37182174,20,28,75,123
"19257","chr6",37211547,37211589,43,4,140,187
"19258","chr6",37307698,37307715,18,69,145,232
"19259","chr6",37325541,37325567,27,76,64,167
"19260","chr6",37352572,37352657,86,14,39,139
"19261","chr6",37353347,37353365,19,38,32,89
"19262","chr6",37420968,37420997,30,65,80,175
"19263","chr6",37582502,37582523,22,40,95,157
"19264","chr6",37727483,37727507,25,74,42,141
"19265","chr6",37819899,37819939,41,36,24,101
"19266","chr6",38465462,38465481,20,145,27,192
"19267","chr6",39300121,39300140,20,8,43,71
"19268","chr6",39588208,39588234,27,48,67,142
"19269","chr6",39598010,39598035,26,74,27,127
"19270","chr6",39905820,39905843,24,115,80,219
"19271","chr6",40587494,40587534,41,17,132,190
"19272","chr6",41173187,41173207,21,33,139,193
"19273","chr6",41339370,41339401,32,7,2,41
"19274","chr6",41372293,41372318,26,83,10,119
"19275","chr6",41443482,41443517,36,55,108,199
"19276","chr6",41691081,41691112,32,40,130,202
"19277","chr6",41765334,41765367,34,103,101,238
"19278","chr6",41779741,41779770,30,38,74,142
"19279","chr6",41779897,41779917,21,79,83,183
"19280","chr6",41788444,41788470,27,76,145,248
"19281","chr6",41920770,41920796,27,78,11,116
"19282","chr6",41925663,41925693,31,66,11,108
"19283","chr6",42020751,42020768,18,7,32,57
"19284","chr6",42049031,42049050,20,5,58,83
"19285","chr6",42050467,42050490,24,61,92,177
"19286","chr6",42064957,42064978,22,66,74,162
"19287","chr6",42115290,42115317,28,100,6,134
"19288","chr6",42156297,42156322,26,35,7,68
"19289","chr6",42164549,42164566,18,29,26,73
"19290","chr6",42168113,42168145,33,9,4,46
"19291","chr6",42216360,42216386,27,5,107,139
"19292","chr6",42216386,42216413,28,32,81,141
"19293","chr6",42216813,42216834,22,91,72,185
"19294","chr6",42620972,42620996,25,73,75,173
"19295","chr6",42684583,42684616,34,65,75,174
"19296","chr6",42699724,42699744,21,110,59,190
"19297","chr6",42782645,42782662,18,57,18,93
"19298","chr6",42800536,42800567,32,8,73,113
"19299","chr6",42825260,42825280,21,10,6,37
"19300","chr6",42848129,42848164,36,139,7,182
"19301","chr6",42852662,42852679,18,11,74,103
"19302","chr6",42878455,42878475,21,129,74,224
"19303","chr6",42922573,42922591,19,146,47,212
"19304","chr6",42929620,42929646,27,42,17,86
"19305","chr6",42958740,42958757,18,68,3,89
"19306","chr6",42963227,42963259,33,103,12,148
"19307","chr6",42996006,42996025,20,37,97,154
"19308","chr6",42997173,42997206,34,72,65,171
"19309","chr6",43021676,43021702,27,132,48,207
"19310","chr6",43022633,43022652,20,11,23,54
"19311","chr6",43067795,43067812,18,129,6,153
"19312","chr6",43076278,43076301,24,2,118,144
"19313","chr6",43076365,43076391,27,17,31,75
"19314","chr6",43095058,43095075,18,145,60,223
"19315","chr6",43151516,43151548,33,75,6,114
"19316","chr6",43243670,43243695,26,116,20,162
"19317","chr6",43243713,43243745,33,1,19,53
"19318","chr6",43275058,43275084,27,62,139,228
"19319","chr6",43281376,43281393,18,11,6,35
"19320","chr6",43282935,43283054,120,10,71,201
"19321","chr6",43398400,43398417,18,76,15,109
"19322","chr6",43416944,43416964,21,77,15,113
"19323","chr6",43457360,43457387,28,8,44,80
"19324","chr6",43509918,43509958,41,3,38,82
"19325","chr6",43510155,43510187,33,8,24,65
"19326","chr6",43514240,43514258,19,69,75,163
"19327","chr6",43535814,43535831,18,88,74,180
"19328","chr6",43628367,43628396,30,122,73,225
"19329","chr6",43628471,43628505,35,84,104,223
"19330","chr6",43629203,43629225,23,66,19,108
"19331","chr6",43646126,43646148,23,7,71,101
"19332","chr6",43659696,43659742,47,68,131,246
"19333","chr6",43659719,43659745,27,71,108,206
"19334","chr6",43929114,43929162,49,14,74,137
"19335","chr6",43971531,43971554,24,8,58,90
"19336","chr6",44002767,44002794,28,40,114,182
"19337","chr6",44073528,44073556,29,51,3,83
"19338","chr6",44127518,44127553,36,48,77,161
"19339","chr6",44127604,44127622,19,117,33,169
"19340","chr6",44188168,44188185,18,92,65,175
"19341","chr6",44223999,44224025,27,91,31,149
"19342","chr6",44257013,44257033,21,45,99,165
"19343","chr6",44270781,44270805,25,53,58,136
"19344","chr6",44270828,44270854,27,11,11,49
"19345","chr6",44275118,44275157,40,41,74,155
"19346","chr6",44297787,44297805,19,108,7,134
"19347","chr6",44326117,44326138,22,20,2,44
"19348","chr6",44441933,44441955,23,9,99,131
"19349","chr6",44870599,44870631,33,45,98,176
"19350","chr6",44956471,44956515,45,60,87,192
"19351","chr6",45053741,45053765,25,145,29,199
"19352","chr6",45422092,45422109,18,84,21,123
"19353","chr6",45422682,45422747,66,35,15,116
"19354","chr6",45422750,45422794,45,1,7,53
"19355","chr6",45454655,45454700,46,16,75,137
"19356","chr6",46490985,46491046,62,45,34,141
"19357","chr6",46491196,46491218,23,89,13,125
"19358","chr6",47040474,47040496,23,34,72,129
"19359","chr6",47154715,47154733,19,36,142,197
"19360","chr6",47239286,47239310,25,31,6,62
"19361","chr6",47317177,47317260,84,74,58,216
"19362","chr6",47377341,47377362,22,1,75,98
"19363","chr6",47378891,47378915,25,8,56,89
"19364","chr6",47482370,47482396,27,76,135,238
"19365","chr6",47616083,47616109,27,44,7,78
"19366","chr6",49558060,49558083,24,36,74,134
"19367","chr6",50023298,50023331,34,28,5,67
"19368","chr6",50133829,50133846,18,89,34,141
"19369","chr6",50565778,50565824,47,78,39,164
"19370","chr6",50714804,50714855,52,34,40,126
"19371","chr6",50859224,50859247,24,53,73,150
"19372","chr6",51454048,51454069,22,8,53,83
"19373","chr6",52270329,52270355,27,123,7,157
"19374","chr6",52304540,52304562,23,77,25,125
"19375","chr6",52402618,52402652,35,5,73,113
"19376","chr6",52589780,52589798,19,146,15,180
"19377","chr6",52757983,52758007,25,44,56,125
"19378","chr6",52924450,52924476,27,1,29,57
"19379","chr6",53028147,53028166,20,145,6,171
"19380","chr6",53133332,53133368,37,32,143,212
"19381","chr6",53141689,53141715,27,141,4,172
"19382","chr6",53177814,53177856,43,76,142,261
"19383","chr6",53185971,53185993,23,14,9,46
"19384","chr6",53188264,53188290,27,137,6,170
"19385","chr6",53443704,53443727,24,39,74,137
"19386","chr6",53471597,53471632,36,20,135,191
"19387","chr6",53544654,53544676,23,15,23,61
"19388","chr6",53729440,53729486,47,12,118,177
"19389","chr6",53729522,53729543,22,69,36,127
"19390","chr6",53737749,53737771,23,42,27,92
"19391","chr6",53900021,53900053,33,6,9,48
"19392","chr6",54669647,54669679,33,12,82,127
"19393","chr6",54831876,54831985,110,73,1,184
"19394","chr6",54851648,54851665,18,8,67,93
"19395","chr6",55174943,55174964,22,127,31,180
"19396","chr6",56099225,56099252,28,59,51,138
"19397","chr6",56276975,56277002,28,34,75,137
"19398","chr6",56444667,56444690,24,29,6,59
"19399","chr6",56774993,56775011,19,123,73,215
"19400","chr6",56892323,56892341,19,77,113,209
"19401","chr6",57011716,57011784,69,88,8,165
"19402","chr6",57834970,57835016,47,17,130,194
"19403","chr6",57866997,57867047,51,86,135,272
"19404","chr6",57961767,57961812,46,81,75,202
"19405","chr6",58348345,58348367,23,29,75,127
"19406","chr6",60758731,60758753,23,97,7,127
"19407","chr6",62156839,62156858,20,29,75,124
"19408","chr6",62307137,62307155,19,29,76,124
"19409","chr6",62538793,62538822,30,81,27,138
"19410","chr6",63193721,63193743,23,7,9,39
"19411","chr6",63454775,63454812,38,10,7,55
"19412","chr6",63486816,63486852,37,75,119,231
"19413","chr6",63547499,63547523,25,76,136,237
"19414","chr6",63591266,63591291,26,138,4,168
"19415","chr6",63950174,63950221,48,61,5,114
"19416","chr6",64958383,64958409,27,91,73,191
"19417","chr6",65455975,65456068,94,45,105,244
"19418","chr6",65663848,65663888,41,8,76,125
"19419","chr6",66331335,66331353,19,89,46,154
"19420","chr6",66999557,66999614,58,55,68,181
"19421","chr6",67061957,67061998,42,8,146,196
"19422","chr6",67195735,67195767,33,22,5,60
"19423","chr6",67200926,67200951,26,2,108,136
"19424","chr6",68101645,68101671,27,22,6,55
"19425","chr6",68152402,68152435,34,140,66,240
"19426","chr6",68807210,68807255,46,7,41,94
"19427","chr6",70494054,70494074,21,22,5,48
"19428","chr6",71584189,71584224,36,76,47,159
"19429","chr6",71856489,71856509,21,44,5,70
"19430","chr6",71856741,71856761,21,28,25,74
"19431","chr6",73158255,73158283,29,75,74,178
"19432","chr6",73193465,73193530,66,18,34,118
"19433","chr6",73224772,73224794,23,6,10,39
"19434","chr6",73258267,73258293,27,32,62,121
"19435","chr6",73263040,73263084,45,24,6,75
"19436","chr6",73290107,73290127,21,77,67,165
"19437","chr6",73308071,73308092,22,8,74,104
"19438","chr6",73446330,73446349,20,53,6,79
"19439","chr6",73449999,73450031,33,44,2,79
"19440","chr6",73450040,73450117,78,130,36,244
"19441","chr6",73460934,73460965,32,37,143,212
"19442","chr6",73461535,73461609,75,104,6,185
"19443","chr6",73541337,73541374,38,136,44,218
"19444","chr6",73621001,73621018,18,71,31,120
"19445","chr6",73651529,73651555,27,3,5,35
"19446","chr6",73653499,73653531,33,93,24,150
"19447","chr6",73673766,73673790,25,82,7,114
"19448","chr6",73725505,73725525,21,75,27,123
"19449","chr6",74799382,74799405,24,77,6,107
"19450","chr6",74922741,74922831,91,9,144,244
"19451","chr6",75208169,75208228,60,14,12,86
"19452","chr6",75319834,75319857,24,99,2,125
"19453","chr6",75340862,75340884,23,80,76,179
"19454","chr6",75355296,75355326,31,138,73,242
"19455","chr6",77238774,77238797,24,144,120,288
"19456","chr6",78629935,78629952,18,63,73,154
"19457","chr6",78630052,78630086,35,6,138,179
"19458","chr6",78861101,78861121,21,89,6,116
"19459","chr6",78908019,78908065,47,73,144,264
"19460","chr6",79102144,79102164,21,145,27,193
"19461","chr6",79563132,79563158,27,37,121,185
"19462","chr6",79831915,79831932,18,103,55,176
"19463","chr6",79844478,79844499,22,125,12,159
"19464","chr6",79881240,79881267,28,29,73,130
"19465","chr6",80055959,80056000,42,97,29,168
"19466","chr6",82253686,82253719,34,40,72,146
"19467","chr6",82836779,82836820,42,78,136,256
"19468","chr6",83213426,83213465,40,91,4,135
"19469","chr6",83275765,83275790,26,76,126,228
"19470","chr6",83398977,83399010,34,6,146,186
"19471","chr6",84033797,84033815,19,40,56,115
"19472","chr6",84595855,84595873,19,26,6,51
"19473","chr6",85183615,85183645,31,12,31,74
"19474","chr6",85592826,85592853,28,66,35,129
"19475","chr6",85627271,85627288,18,18,3,39
"19476","chr6",85643596,85643619,24,5,102,131
"19477","chr6",86392520,86392555,36,8,91,135
"19478","chr6",86772217,86772240,24,135,71,230
"19479","chr6",86937454,86937491,38,15,61,114
"19480","chr6",86937469,86937495,27,19,46,92
"19481","chr6",86995288,86995326,39,94,35,168
"19482","chr6",87084136,87084155,20,7,6,33
"19483","chr6",87092928,87092959,32,85,94,211
"19484","chr6",87122768,87122786,19,68,91,178
"19485","chr6",87152052,87152069,18,1,110,129
"19486","chr6",87317363,87317381,19,10,7,36
"19487","chr6",87422452,87422469,18,12,72,102
"19488","chr6",87610930,87610954,25,8,68,101
"19489","chr6",87627298,87627315,18,10,10,38
"19490","chr6",87642585,87642620,36,13,72,121
"19491","chr6",87666436,87666455,20,75,139,234
"19492","chr6",87676597,87676627,31,29,31,91
"19493","chr6",87696700,87696717,18,6,75,99
"19494","chr6",87766864,87766890,27,7,76,110
"19495","chr6",87775475,87775492,18,33,74,125
"19496","chr6",87844310,87844328,19,75,111,205
"19497","chr6",89351070,89351099,30,8,140,178
"19498","chr6",89411926,89411946,21,38,59,118
"19499","chr6",89412390,89412416,27,67,9,103
"19500","chr6",89420774,89420798,25,139,6,170
"19501","chr6",89609614,89609637,24,84,133,241
"19502","chr6",89805035,89805059,25,140,76,241
"19503","chr6",89838584,89838601,18,38,49,105
"19504","chr6",89840055,89840081,27,13,5,45
"19505","chr6",89849185,89849228,44,74,137,255
"19506","chr6",89858940,89858962,23,19,144,186
"19507","chr6",89870401,89870432,32,82,130,244
"19508","chr6",90123770,90123793,24,144,6,174
"19509","chr6",90243047,90243073,27,35,143,205
"19510","chr6",90296785,90296818,34,10,9,53
"19511","chr6",90297035,90297070,36,10,74,120
"19512","chr6",90586379,90586400,22,29,67,118
"19513","chr6",91004978,91005022,45,31,73,149
"19514","chr6",92098291,92098320,30,8,23,61
"19515","chr6",92606846,92606882,37,146,4,187
"19516","chr6",93417067,93417084,18,1,56,75
"19517","chr6",94451650,94451674,25,14,75,114
"19518","chr6",94540136,94540162,27,74,70,171
"19519","chr6",94676873,94676905,33,112,5,150
"19520","chr6",95579373,95579396,24,9,74,107
"19521","chr6",96055669,96055696,28,3,94,125
"19522","chr6",96055675,96055725,51,32,88,171
"19523","chr6",96851040,96851062,23,40,6,69
"19524","chr6",96924466,96924485,20,1,7,28
"19525","chr6",97510517,97510544,28,28,78,134
"19526","chr6",98835074,98835143,70,119,21,210
"19527","chr6",98835245,98835321,77,104,80,261
"19528","chr6",99006455,99006477,23,76,78,177
"19529","chr6",99382955,99382983,29,77,4,110
"19530","chr6",99385977,99386027,51,27,42,120
"19531","chr6",99394273,99394294,22,73,26,121
"19532","chr6",99487634,99487656,23,88,27,138
"19533","chr6",99515771,99515792,22,8,74,104
"19534","chr6",99613689,99613723,35,52,33,120
"19535","chr6",99613749,99613768,20,4,2,26
"19536","chr6",100453656,100453680,25,89,122,236
"19537","chr6",100665566,100665584,19,139,30,188
"19538","chr6",100781551,100781569,19,37,75,131
"19539","chr6",100881037,100881056,20,56,4,80
"19540","chr6",102905246,102905287,42,147,4,193
"19541","chr6",103338923,103338946,24,108,143,275
"19542","chr6",103695282,103695307,26,5,143,174
"19543","chr6",103695529,103695550,22,77,74,173
"19544","chr6",104026264,104026282,19,4,129,152
"19545","chr6",104561077,104561096,20,77,80,177
"19546","chr6",104720795,104720818,24,35,75,134
"19547","chr6",104941447,104941469,23,1,17,41
"19548","chr6",104966620,104966639,20,8,143,171
"19549","chr6",105960008,105960026,19,32,74,125
"19550","chr6",105992460,105992492,33,38,14,85
"19551","chr6",106361113,106361136,24,63,55,142
"19552","chr6",106430860,106430878,19,75,46,140
"19553","chr6",106676198,106676219,22,29,75,126
"19554","chr6",106690237,106690255,19,8,63,90
"19555","chr6",106872017,106872040,24,64,77,165
"19556","chr6",106897224,106897244,21,82,1,104
"19557","chr6",106914467,106914485,19,72,143,234
"19558","chr6",106940745,106940763,19,56,6,81
"19559","chr6",107011907,107011935,29,78,5,112
"19560","chr6",107027816,107027838,23,137,8,168
"19561","chr6",107105371,107105394,24,17,43,84
"19562","chr6",107106937,107106954,18,8,47,73
"19563","chr6",107129243,107129266,24,37,8,69
"19564","chr6",107155878,107155907,30,76,145,251
"19565","chr6",107156197,107156214,18,10,138,166
"19566","chr6",107288754,107288777,24,76,137,237
"19567","chr6",107347257,107347280,24,85,82,191
"19568","chr6",107490255,107490348,94,15,19,128
"19569","chr6",107634450,107634475,26,29,49,104
"19570","chr6",107635076,107635096,21,115,27,163
"19571","chr6",107850879,107850900,22,105,67,194
"19572","chr6",107930174,107930197,24,16,60,100
"19573","chr6",107962002,107962021,20,75,76,171
"19574","chr6",107986791,107986820,30,30,13,73
"19575","chr6",108229260,108229280,21,70,6,97
"19576","chr6",108271694,108271711,18,101,8,127
"19577","chr6",108959667,108959689,23,62,113,198
"19578","chr6",108959683,108959703,21,76,97,194
"19579","chr6",109140831,109140850,20,10,10,40
"19580","chr6",109395832,109395850,19,8,55,82
"19581","chr6",109455785,109455808,24,47,17,88
"19582","chr6",109483207,109483224,18,147,12,177
"19583","chr6",109483339,109483391,53,7,39,99
"19584","chr6",109483544,109483572,29,47,141,217
"19585","chr6",109488764,109488787,24,76,15,115
"19586","chr6",109761362,109761387,26,60,71,157
"19587","chr6",109761365,109761402,38,7,68,113
"19588","chr6",110356447,110356494,48,54,70,172
"19589","chr6",110558071,110558094,24,44,41,109
"19590","chr6",110654953,110654975,23,37,62,122
"19591","chr6",110691618,110691665,48,9,90,147
"19592","chr6",110916687,110916739,53,11,41,105
"19593","chr6",110936242,110936300,59,55,79,193
"19594","chr6",110936300,110936317,18,4,21,43
"19595","chr6",110951577,110951596,20,20,104,144
"19596","chr6",111008899,111008916,18,75,120,213
"19597","chr6",111216571,111216588,18,25,142,185
"19598","chr6",111255061,111255080,20,21,60,101
"19599","chr6",111482928,111482955,28,22,3,53
"19600","chr6",111494603,111494637,35,76,115,226
"19601","chr6",111534978,111535005,28,8,15,51
"19602","chr6",111866336,111866360,25,10,127,162
"19603","chr6",112273360,112273394,35,16,74,125
"19604","chr6",113734110,113734149,40,76,98,214
"19605","chr6",113741392,113741424,33,87,3,123
"19606","chr6",113743522,113743550,29,110,67,206
"19607","chr6",113746294,113746314,21,147,72,240
"19608","chr6",113855097,113855137,41,22,94,157
"19609","chr6",113970946,113970970,25,33,20,78
"19610","chr6",114342421,114342448,28,132,17,177
"19611","chr6",115051397,115051441,45,111,36,192
"19612","chr6",116241923,116241959,37,24,74,135
"19613","chr6",116668860,116668881,22,77,115,214
"19614","chr6",116747063,116747085,23,5,11,39
"19615","chr6",116877192,116877212,21,23,47,91
"19616","chr6",117265268,117265293,26,45,126,197
"19617","chr6",117300087,117300124,38,29,78,145
"19618","chr6",117452983,117453015,33,6,46,85
"19619","chr6",117482580,117482604,25,40,93,158
"19620","chr6",117482955,117482999,45,95,21,161
"19621","chr6",117907485,117907502,18,15,10,43
"19622","chr6",118717142,118717171,30,6,78,114
"19623","chr6",118843622,118843642,21,7,12,40
"19624","chr6",118843642,118843741,100,106,60,266
"19625","chr6",118893838,118893864,27,30,102,159
"19626","chr6",119130851,119130875,25,77,21,123
"19627","chr6",119141476,119141502,27,16,68,111
"19628","chr6",119144334,119144357,24,25,6,55
"19629","chr6",119161804,119161826,23,6,11,40
"19630","chr6",119275278,119275324,47,8,75,130
"19631","chr6",119667871,119667897,27,94,71,192
"19632","chr6",120197023,120197051,29,37,73,139
"19633","chr6",120758660,120758677,18,77,27,122
"19634","chr6",121397078,121397113,36,8,35,79
"19635","chr6",121440913,121440944,32,60,21,113
"19636","chr6",122627071,122627093,23,77,35,135
"19637","chr6",124223213,124223238,26,9,6,41
"19638","chr6",124508337,124508360,24,10,63,97
"19639","chr6",125301443,125301464,22,45,31,98
"19640","chr6",125930358,125930383,26,27,73,126
"19641","chr6",126026803,126026820,18,8,27,53
"19642","chr6",126643475,126643492,18,10,133,161
"19643","chr6",127117802,127118023,222,48,93,363
"19644","chr6",127266779,127266796,18,1,93,112
"19645","chr6",127380003,127380020,18,145,74,237
"19646","chr6",127422172,127422191,20,35,75,130
"19647","chr6",127516372,127516402,31,25,48,104
"19648","chr6",127592691,127592715,25,129,34,188
"19649","chr6",127593265,127593291,27,59,31,117
"19650","chr6",128430933,128430956,24,8,40,72
"19651","chr6",128508948,128508985,38,67,2,107
"19652","chr6",128868666,128868700,35,77,67,179
"19653","chr6",128895469,128895491,23,70,79,172
"19654","chr6",129603356,129603387,32,62,83,177
"19655","chr6",129610624,129610645,22,126,82,230
"19656","chr6",130018510,130018534,25,148,24,197
"19657","chr6",130019917,130019939,23,78,19,120
"19658","chr6",130019943,130019966,24,105,90,219
"19659","chr6",130019977,130020022,46,3,56,105
"19660","chr6",130020106,130020135,30,31,56,117
"19661","chr6",130261206,130261227,22,8,76,106
"19662","chr6",130292600,130292635,36,7,45,88
"19663","chr6",130767291,130767319,29,9,35,73
"19664","chr6",130801471,130801496,26,25,147,198
"19665","chr6",130801474,130801517,44,46,144,234
"19666","chr6",131385698,131385752,55,100,9,164
"19667","chr6",131535631,131535651,21,8,66,95
"19668","chr6",131698094,131698128,35,39,17,91
"19669","chr6",131807940,131807987,48,32,78,158
"19670","chr6",131815872,131815892,21,27,75,123
"19671","chr6",131887865,131887883,19,81,4,104
"19672","chr6",131912932,131912949,18,125,143,286
"19673","chr6",132097926,132097961,36,34,142,212
"19674","chr6",132401606,132401639,34,29,81,144
"19675","chr6",132827100,132827118,19,29,6,54
"19676","chr6",133675623,133675643,21,41,49,111
"19677","chr6",133678392,133678420,29,145,27,201
"19678","chr6",133889312,133889377,66,122,7,195
"19679","chr6",133891484,133891507,24,64,11,99
"19680","chr6",133952134,133952162,29,19,102,150
"19681","chr6",134116373,134116390,18,96,41,155
"19682","chr6",134122319,134122348,30,131,123,284
"19683","chr6",134191836,134191853,18,78,143,239
"19684","chr6",134268723,134268742,20,73,6,99
"19685","chr6",134495089,134495114,26,77,49,152
"19686","chr6",134498902,134498924,23,64,59,146
"19687","chr6",134498936,134498957,22,97,25,144
"19688","chr6",135014852,135014874,23,66,36,125
"19689","chr6",135069980,135070000,21,8,142,171
"19690","chr6",136629767,136629811,45,50,132,227
"19691","chr6",136677133,136677155,23,8,102,133
"19692","chr6",136792542,136792569,28,42,30,100
"19693","chr6",136951216,136951234,19,76,98,193
"19694","chr6",137254023,137254043,21,22,7,50
"19695","chr6",137259891,137259909,19,94,74,187
"19696","chr6",137415051,137415068,18,32,8,58
"19697","chr6",137494073,137494100,28,125,91,244
"19698","chr6",137722321,137722351,31,8,2,41
"19699","chr6",138034952,138034991,40,63,5,108
"19700","chr6",138107362,138107382,21,22,35,78
"19701","chr6",138161879,138161905,27,25,15,67
"19702","chr6",138382397,138382443,47,33,6,86
"19703","chr6",138647603,138647620,18,13,20,51
"19704","chr6",138663561,138663581,21,141,73,235
"19705","chr6",138684649,138684673,25,24,70,119
"19706","chr6",138692923,138692940,18,80,5,103
"19707","chr6",138864003,138864029,27,138,58,223
"19708","chr6",138987908,138987965,58,9,15,82
"19709","chr6",139056758,139056776,19,119,73,211
"19710","chr6",139083499,139083535,37,143,71,251
"19711","chr6",139135528,139135562,35,119,99,253
"19712","chr6",139283272,139283289,18,8,43,69
"19713","chr6",139387436,139387459,24,36,75,135
"19714","chr6",139532593,139532611,19,76,144,239
"19715","chr6",139620839,139620865,27,8,75,110
"19716","chr6",142910621,142910650,30,28,55,113
"19717","chr6",142944910,142944954,45,47,56,148
"19718","chr6",143060782,143060836,55,82,64,201
"19719","chr6",143552883,143552908,26,87,27,140
"19720","chr6",143565605,143565623,19,25,19,63
"19721","chr6",143580485,143580512,28,66,7,101
"19722","chr6",143925166,143925193,28,76,94,198
"19723","chr6",144008221,144008238,18,140,38,196
"19724","chr6",144095891,144095912,22,8,128,158
"19725","chr6",144717603,144717653,51,76,23,150
"19726","chr6",144772017,144772053,37,78,147,262
"19727","chr6",144930733,144930760,28,83,11,122
"19728","chr6",145690517,145690543,27,41,67,135
"19729","chr6",146196464,146196486,23,37,134,194
"19730","chr6",146349233,146349262,30,37,76,143
"19731","chr6",146781172,146781193,22,77,27,126
"19732","chr6",146997795,146997822,28,102,75,205
"19733","chr6",147954807,147954834,28,28,75,131
"19734","chr6",148267366,148267397,32,9,64,105
"19735","chr6",148278018,148278056,39,11,142,192
"19736","chr6",148280927,148280962,36,78,87,201
"19737","chr6",148301327,148301347,21,72,5,98
"19738","chr6",148304433,148304461,29,79,76,184
"19739","chr6",148311082,148311118,37,120,92,249
"19740","chr6",148334428,148334448,21,66,6,93
"19741","chr6",148334974,148335007,34,139,75,248
"19742","chr6",148343092,148343159,68,26,43,137
"19743","chr6",148349253,148349281,29,8,63,100
"19744","chr6",148399215,148399240,26,81,68,175
"19745","chr6",148738138,148738991,854,148,23,1025
"19746","chr6",148759528,148759560,33,7,5,45
"19747","chr6",149295344,149295367,24,142,6,172
"19748","chr6",149317406,149317438,33,68,16,117
"19749","chr6",149317963,149317980,18,97,67,182
"19750","chr6",149492322,149492349,28,10,109,147
"19751","chr6",149500758,149500781,24,67,74,165
"19752","chr6",149501010,149501028,19,32,5,56
"19753","chr6",149630631,149630652,22,44,4,70
"19754","chr6",149765038,149765070,33,5,77,115
"19755","chr6",149832790,149832826,37,76,141,254
"19756","chr6",149863784,149863802,19,123,24,166
"19757","chr6",149941525,149941559,35,142,5,182
"19758","chr6",149945941,149945961,21,14,74,109
"19759","chr6",150092048,150092066,19,76,143,238
"19760","chr6",150285286,150285321,36,117,102,255
"19761","chr6",150583646,150583678,33,65,111,209
"19762","chr6",150586576,150586621,46,107,31,184
"19763","chr6",150599879,150599910,32,25,62,119
"19764","chr6",150791670,150791692,23,18,74,115
"19765","chr6",150865722,150865747,26,20,50,96
"19766","chr6",150865920,150865944,25,84,108,217
"19767","chr6",151240768,151240791,24,46,9,79
"19768","chr6",151390752,151390786,35,15,20,70
"19769","chr6",151391516,151391535,20,23,21,64
"19770","chr6",151391554,151391579,26,67,23,116
"19771","chr6",151404232,151404255,24,75,47,146
"19772","chr6",151415793,151415813,21,54,74,149
"19773","chr6",151477872,151477894,23,8,40,71
"19774","chr6",151508713,151508733,21,13,6,40
"19775","chr6",151622031,151622054,24,9,86,119
"19776","chr6",151670763,151670785,23,75,63,161
"19777","chr6",151685108,151685144,37,69,66,172
"19778","chr6",151808411,151808434,24,16,83,123
"19779","chr6",152138513,152138564,52,35,4,91
"19780","chr6",152363498,152363558,61,63,2,126
"19781","chr6",152541748,152541770,23,61,6,90
"19782","chr6",152606979,152607002,24,76,120,220
"19783","chr6",152627491,152627508,18,145,33,196
"19784","chr6",153131273,153131295,23,8,2,33
"19785","chr6",153142054,153142086,33,73,72,178
"19786","chr6",153767643,153767665,23,77,36,136
"19787","chr6",154229347,154229367,21,8,147,176
"19788","chr6",154497397,154497420,24,96,69,189
"19789","chr6",154730814,154730835,22,147,70,239
"19790","chr6",154752997,154753022,26,123,35,184
"19791","chr6",154941334,154941356,23,103,76,202
"19792","chr6",154995226,154995264,39,5,6,50
"19793","chr6",155147483,155147501,19,6,134,159
"19794","chr6",155251283,155251303,21,7,48,76
"19795","chr6",155736129,155736151,23,99,73,195
"19796","chr6",155879209,155879244,36,145,35,216
"19797","chr6",156280621,156280658,38,54,143,235
"19798","chr6",156598415,156598440,26,36,41,103
"19799","chr6",156719188,156719236,49,35,44,128
"19800","chr6",156777205,156777227,23,90,66,179
"19801","chr6",156777699,156777722,24,32,31,87
"19802","chr6",156777719,156777739,21,49,11,81
"19803","chr6",156777803,156777838,36,27,4,67
"19804","chr6",156777858,156777881,24,70,59,153
"19805","chr6",156778032,156778052,21,110,80,211
"19806","chr6",156778169,156778241,73,13,74,160
"19807","chr6",156778872,156778935,64,11,29,104
"19808","chr6",156778892,156778942,51,18,9,78
"19809","chr6",156778946,156779000,55,4,29,88
"19810","chr6",156779680,156779700,21,4,113,138
"19811","chr6",156892039,156892071,33,37,25,95
"19812","chr6",156980485,156980508,24,53,4,81
"19813","chr6",156990174,156990192,19,11,33,63
"19814","chr6",157004872,157004931,60,77,6,143
"19815","chr6",157335029,157335059,31,75,52,158
"19816","chr6",157338116,157338134,19,6,92,117
"19817","chr6",157381083,157381109,27,5,129,161
"19818","chr6",157460058,157460076,19,100,25,144
"19819","chr6",157504450,157504470,21,83,12,116
"19820","chr6",157504784,157504828,45,8,72,125
"19821","chr6",157511548,157511565,18,27,75,120
"19822","chr6",157548411,157548441,31,53,95,179
"19823","chr6",157548437,157548462,26,6,69,101
"19824","chr6",157730988,157731008,21,5,96,122
"19825","chr6",157744744,157744763,20,9,109,138
"19826","chr6",157823039,157823061,23,1,95,119
"19827","chr6",157858231,157858263,33,75,143,251
"19828","chr6",158037396,158037418,23,7,15,45
"19829","chr6",158215224,158215254,31,52,6,89
"19830","chr6",158216703,158216744,42,5,142,189
"19831","chr6",158274261,158274287,27,59,31,117
"19832","chr6",158365870,158365920,51,8,46,105
"19833","chr6",158453486,158453509,24,148,4,176
"19834","chr6",158506223,158506250,28,9,124,161
"19835","chr6",158554077,158554100,24,5,72,101
"19836","chr6",158598626,158598691,66,76,75,217
"19837","chr6",158605132,158605165,34,4,101,139
"19838","chr6",158644292,158644311,20,25,40,85
"19839","chr6",158660264,158660301,38,146,7,191
"19840","chr6",158700257,158700281,25,20,73,118
"19841","chr6",158723090,158723112,23,76,93,192
"19842","chr6",158836678,158836697,20,13,8,41
"19843","chr6",158838248,158838290,43,55,53,151
"19844","chr6",158893536,158893564,29,5,3,37
"19845","chr6",158993429,158993447,19,22,132,173
"19846","chr6",158998469,158998493,25,67,6,98
"19847","chr6",159455852,159455936,85,37,34,156
"19848","chr6",159466187,159466209,23,86,147,256
"19849","chr6",159598439,159598466,28,7,75,110
"19850","chr6",159630376,159630449,74,85,30,189
"19851","chr6",159667920,159667947,28,25,42,95
"19852","chr6",159727442,159727491,50,10,143,203
"19853","chr6",159969940,159969957,18,15,21,54
"19854","chr6",160140277,160140308,32,45,25,102
"19855","chr6",160347789,160347837,49,33,56,138
"19856","chr6",160977726,160977757,32,8,17,57
"19857","chr6",160991701,160991727,27,8,25,60
"19858","chr6",160992003,160992026,24,139,17,180
"19859","chr6",161122965,161122984,20,50,50,120
"19860","chr6",161908083,161908114,32,11,1,44
"19861","chr6",161916791,161916813,23,73,75,171
"19862","chr6",162816342,162816367,26,5,70,101
"19863","chr6",163058899,163058928,30,76,75,181
"19864","chr6",163148962,163148981,20,1,89,110
"19865","chr6",163283808,163283827,20,93,67,180
"19866","chr6",163375134,163375152,19,95,73,187
"19867","chr6",163414675,163414716,42,7,48,97
"19868","chr6",163594038,163594056,19,11,5,35
"19869","chr6",163866990,163867018,29,18,18,65
"19870","chr6",164035239,164035287,49,51,63,163
"19871","chr6",164145835,164145864,30,145,27,202
"19872","chr6",164286582,164286601,20,6,10,36
"19873","chr6",164864201,164864227,27,73,5,105
"19874","chr6",165064130,165064147,18,31,27,76
"19875","chr6",165663262,165663283,22,57,27,106
"19876","chr6",166008859,166008883,25,21,8,54
"19877","chr6",166087884,166088149,266,149,92,507
"19878","chr6",166230873,166230899,27,46,7,80
"19879","chr6",166230899,166230938,40,85,49,174
"19880","chr6",166253054,166253084,31,20,34,85
"19881","chr6",166534222,166534263,42,102,74,218
"19882","chr6",166975791,166975814,24,84,4,112
"19883","chr6",167009500,167009529,30,91,84,205
"19884","chr6",167117399,167117434,36,8,140,184
"19885","chr6",167270047,167270073,27,137,13,177
"19886","chr6",167286978,167287004,27,66,74,167
"19887","chr6",167299187,167299221,35,39,5,79
"19888","chr6",167324493,167324513,21,126,13,160
"19889","chr6",167352996,167353027,32,99,73,204
"19890","chr6",167437795,167437817,23,14,6,43
"19891","chr6",167700955,167701020,66,34,7,107
"19892","chr6",167770835,167770855,21,142,133,296
"19893","chr6",167818684,167818702,19,9,134,162
"19894","chr6",167826808,167826901,94,20,23,137
"19895","chr6",167826934,167826952,19,5,17,41
"19896","chr6",167826997,167827030,34,83,59,176
"19897","chr6",167966012,167966031,20,46,15,81
"19898","chr6",168258837,168258863,27,38,75,140
"19899","chr6",168442705,168442744,40,82,44,166
"19900","chr6",168600408,168600445,38,18,73,129
"19901","chr6",168868505,168868527,23,72,84,179
"19902","chr6",169172000,169172022,23,16,5,44
"19903","chr6",169419918,169419942,25,76,33,134
"19904","chr6",169486483,169486506,24,73,108,205
"19905","chr6",169702221,169702246,26,8,27,61
"19906","chr6",169723948,169724024,77,98,5,180
"19907","chr6",169857674,169857709,36,55,86,177
"19908","chr6",169899079,169899099,21,11,130,162
"19909","chr6",169983289,169983308,20,96,122,238
"19910","chr6",170049451,170049473,23,42,85,150
"19911","chr6",170161639,170161662,24,10,50,84
"19912","chr6",170175801,170175828,28,48,104,180
"19913","chr6",170242088,170242118,31,78,25,134
"19914","chr6",170286803,170286832,30,102,98,230
"19915","chr6",170422832,170422850,19,44,72,135
"19916","chr6",170452822,170453208,387,111,3,501
"19917","chr6",170561907,170562017,111,34,48,193
"19918","chr6",170718409,170718427,19,78,49,146
"19919","chr7",162284,162325,42,19,147,208
"19920","chr7",337613,337631,19,61,123,203
"19921","chr7",510589,510632,44,88,41,173
"19922","chr7",510706,510803,98,83,139,320
"19923","chr7",519431,519451,21,32,36,89
"19924","chr7",519881,519924,44,4,43,91
"19925","chr7",539688,539735,48,102,97,247
"19926","chr7",601934,601961,28,63,57,148
"19927","chr7",602375,602399,25,16,4,45
"19928","chr7",615457,615555,99,22,10,131
"19929","chr7",647806,647831,26,73,6,105
"19930","chr7",659710,659732,23,84,82,189
"19931","chr7",708791,708808,18,6,141,165
"19932","chr7",710644,710663,20,76,5,101
"19933","chr7",757239,757261,23,56,65,144
"19934","chr7",806470,806488,19,10,4,33
"19935","chr7",807597,807614,18,4,66,88
"19936","chr7",815421,815440,20,91,74,185
"19937","chr7",816428,816465,38,33,108,179
"19938","chr7",846101,846127,27,9,6,42
"19939","chr7",850768,850792,25,63,98,186
"19940","chr7",858044,858066,23,70,30,123
"19941","chr7",864555,864573,19,3,5,27
"19942","chr7",877198,877222,25,107,124,256
"19943","chr7",925362,925383,22,77,31,130
"19944","chr7",950857,950878,22,115,6,143
"19945","chr7",954504,954521,18,64,2,84
"19946","chr7",970440,970460,21,76,5,102
"19947","chr7",980685,980705,21,8,73,102
"19948","chr7",981297,981329,33,142,41,216
"19949","chr7",1057050,1057067,18,116,134,268
"19950","chr7",1154184,1154203,20,45,144,209
"19951","chr7",1160103,1160120,18,35,97,150
"19952","chr7",1178911,1178932,22,7,17,46
"19953","chr7",1199900,1199921,22,36,9,67
"19954","chr7",1220690,1220717,28,75,32,135
"19955","chr7",1224817,1224837,21,75,42,138
"19956","chr7",1224844,1224872,29,110,15,154
"19957","chr7",1224966,1225004,39,83,91,213
"19958","chr7",1224994,1225030,37,109,63,209
"19959","chr7",1225124,1225146,23,87,91,201
"19960","chr7",1225144,1225168,25,109,71,205
"19961","chr7",1225253,1225302,50,116,100,266
"19962","chr7",1225400,1225422,23,12,87,122
"19963","chr7",1225412,1225448,37,38,75,150
"19964","chr7",1236431,1236451,21,10,133,164
"19965","chr7",1262347,1262368,22,128,6,156
"19966","chr7",1276312,1276332,21,74,2,97
"19967","chr7",1302354,1302380,27,8,38,73
"19968","chr7",1324255,1324273,19,67,102,188
"19969","chr7",1343507,1343524,18,41,71,130
"19970","chr7",1371727,1371755,29,77,27,133
"19971","chr7",1384470,1384909,440,50,9,499
"19972","chr7",1387827,1387859,33,144,5,182
"19973","chr7",1404433,1404470,38,8,103,149
"19974","chr7",1419342,1419371,30,52,114,196
"19975","chr7",1436552,1436569,18,39,7,64
"19976","chr7",1501291,1501329,39,99,68,206
"19977","chr7",1514341,1514360,20,38,36,94
"19978","chr7",1530918,1530966,49,3,66,118
"19979","chr7",1531260,1531277,18,42,4,64
"19980","chr7",1569606,1569625,20,37,61,118
"19981","chr7",1570734,1570751,18,8,35,61
"19982","chr7",1642685,1642807,123,114,19,256
"19983","chr7",1664664,1664691,28,9,9,46
"19984","chr7",1666044,1666070,27,12,45,84
"19985","chr7",1666075,1666094,20,36,14,70
"19986","chr7",1666983,1667003,21,1,1,23
"19987","chr7",1669866,1669884,19,47,43,109
"19988","chr7",1670131,1670187,57,6,7,70
"19989","chr7",1812498,1812515,18,102,134,254
"19990","chr7",1826961,1826978,18,48,62,128
"19991","chr7",1906050,1906072,23,146,6,175
"19992","chr7",1918869,1918889,21,18,106,145
"19993","chr7",1920236,1920254,19,81,12,112
"19994","chr7",1938841,1938871,31,46,138,215
"19995","chr7",1938904,1938929,26,6,75,107
"19996","chr7",1938990,1939023,34,32,48,114
"19997","chr7",1939195,1939215,21,78,29,128
"19998","chr7",1939306,1939339,34,29,97,160
"19999","chr7",2061339,2061380,42,92,72,206
"20000","chr7",2165204,2165235,32,69,74,175
"20001","chr7",2167553,2167576,24,73,2,99
"20002","chr7",2233811,2233828,18,81,27,126
"20003","chr7",2258009,2258027,19,7,1,27
"20004","chr7",2285212,2285230,19,68,6,93
"20005","chr7",2313524,2313570,47,3,76,126
"20006","chr7",2323017,2323041,25,54,6,85
"20007","chr7",2361780,2361799,20,41,84,145
"20008","chr7",2361953,2361977,25,8,66,99
"20009","chr7",2382506,2382526,21,9,60,90
"20010","chr7",2414270,2414296,27,3,122,152
"20011","chr7",2425204,2425237,34,133,75,242
"20012","chr7",2452938,2452958,21,42,78,141
"20013","chr7",2472198,2472221,24,12,2,38
"20014","chr7",2486922,2486957,36,7,137,180
"20015","chr7",2501475,2501497,23,66,74,163
"20016","chr7",2504915,2504932,18,88,63,169
"20017","chr7",2527316,2527353,38,136,9,183
"20018","chr7",2541077,2541094,18,22,66,106
"20019","chr7",2563376,2563412,37,60,63,160
"20020","chr7",2563894,2563916,23,136,6,165
"20021","chr7",2601958,2601989,32,50,37,119
"20022","chr7",2605622,2605675,54,86,4,144
"20023","chr7",2622628,2622716,89,16,111,216
"20024","chr7",2624827,2624852,26,46,62,134
"20025","chr7",2631937,2631955,19,9,120,148
"20026","chr7",2631981,2632029,49,19,76,144
"20027","chr7",2632001,2632033,33,23,56,112
"20028","chr7",2643355,2643373,19,138,74,231
"20029","chr7",2659891,2659910,20,8,31,59
"20030","chr7",2660542,2660570,29,12,68,109
"20031","chr7",2670869,2670904,36,5,62,103
"20032","chr7",2684873,2684891,19,12,93,124
"20033","chr7",2763192,2763231,40,51,21,112
"20034","chr7",2789133,2789153,21,8,132,161
"20035","chr7",2907038,2907058,21,78,23,122
"20036","chr7",2941540,2941562,23,102,64,189
"20037","chr7",2976705,2976727,23,68,6,97
"20038","chr7",3022939,3022965,27,107,55,189
"20039","chr7",3035292,3035318,27,76,122,225
"20040","chr7",3058129,3058155,27,7,80,114
"20041","chr7",3087572,3087597,26,104,107,237
"20042","chr7",3130113,3130143,31,145,61,237
"20043","chr7",3301272,3301295,24,2,62,88
"20044","chr7",3301609,3301635,27,26,20,73
"20045","chr7",3894692,3894716,25,125,30,180
"20046","chr7",3972080,3972097,18,8,7,33
"20047","chr7",4102955,4102976,22,34,69,125
"20048","chr7",4231628,4231645,18,124,89,231
"20049","chr7",4284592,4284615,24,121,74,219
"20050","chr7",4305235,4305265,31,106,4,141
"20051","chr7",4325779,4325806,28,91,74,193
"20052","chr7",4329536,4329576,41,110,115,266
"20053","chr7",4477344,4477377,34,82,8,124
"20054","chr7",4499438,4499457,20,76,14,110
"20055","chr7",4634888,4634919,32,8,84,124
"20056","chr7",4682386,4682486,101,18,47,166
"20057","chr7",4687285,4687307,23,123,92,238
"20058","chr7",4731759,4731782,24,25,7,56
"20059","chr7",4776563,4776585,23,145,25,193
"20060","chr7",4832742,4832763,22,117,3,142
"20061","chr7",4843004,4843024,21,76,137,234
"20062","chr7",4875192,4875239,48,143,6,197
"20063","chr7",4876291,4876313,23,3,143,169
"20064","chr7",4911594,4911666,73,8,126,207
"20065","chr7",4931151,4931178,28,23,117,168
"20066","chr7",4959146,4959181,36,46,8,90
"20067","chr7",5080973,5080991,19,76,54,149
"20068","chr7",5101585,5101611,27,127,142,296
"20069","chr7",5135733,5135751,19,66,42,127
"20070","chr7",5163893,5163928,36,17,73,126
"20071","chr7",5175054,5175071,18,28,42,88
"20072","chr7",5182223,5182244,22,75,5,102
"20073","chr7",5237220,5237257,38,5,8,51
"20074","chr7",5241268,5241296,29,92,57,178
"20075","chr7",5245157,5245180,24,81,7,112
"20076","chr7",5252696,5252728,33,74,14,121
"20077","chr7",5276977,5276998,22,76,52,150
"20078","chr7",5307254,5307291,38,26,36,100
"20079","chr7",5308849,5308871,23,37,102,162
"20080","chr7",5312878,5313053,176,105,41,322
"20081","chr7",5313160,5313216,57,64,45,166
"20082","chr7",5315417,5315442,26,9,6,41
"20083","chr7",5316275,5316296,22,75,29,126
"20084","chr7",5321640,5321686,47,5,74,126
"20085","chr7",5346500,5346517,18,138,70,226
"20086","chr7",5348648,5348671,24,91,78,193
"20087","chr7",5385495,5385527,33,88,67,188
"20088","chr7",5399705,5399722,18,133,7,158
"20089","chr7",5408299,5408316,18,12,74,104
"20090","chr7",5428728,5428754,27,33,12,72
"20091","chr7",5498568,5498591,24,80,132,236
"20092","chr7",5535078,5535113,36,140,9,185
"20093","chr7",5543284,5543302,19,125,5,149
"20094","chr7",5544669,5544686,18,77,83,178
"20095","chr7",5550039,5550069,31,13,66,110
"20096","chr7",5551536,5551555,20,104,71,195
"20097","chr7",5566164,5566186,23,3,13,39
"20098","chr7",5571160,5571186,27,11,145,183
"20099","chr7",5575735,5575762,28,46,6,80
"20100","chr7",5577546,5577576,31,44,136,211
"20101","chr7",5577735,5577772,38,8,98,144
"20102","chr7",5611094,5611127,34,11,88,133
"20103","chr7",5611274,5611299,26,7,75,108
"20104","chr7",5611517,5611535,19,9,8,36
"20105","chr7",5613241,5613281,41,3,109,153
"20106","chr7",5621172,5621190,19,6,57,82
"20107","chr7",5646373,5646397,25,66,2,93
"20108","chr7",5663587,5663608,22,5,71,98
"20109","chr7",5705912,5705968,57,43,1,101
"20110","chr7",5783113,5783145,33,6,90,129
"20111","chr7",5801274,5801293,20,78,60,158
"20112","chr7",5830179,5830207,29,76,35,140
"20113","chr7",5830361,5830383,23,33,71,127
"20114","chr7",5835682,5835702,21,76,96,193
"20115","chr7",5859672,5859710,39,71,95,205
"20116","chr7",5916488,5916519,32,105,48,185
"20117","chr7",5957800,5957826,27,47,70,144
"20118","chr7",6056293,6056312,20,147,124,291
"20119","chr7",6068762,6068800,39,38,16,93
"20120","chr7",6104073,6104090,18,66,85,169
"20121","chr7",6104979,6104998,20,6,44,70
"20122","chr7",6109701,6109718,18,8,145,171
"20123","chr7",6244956,6244993,38,30,75,143
"20124","chr7",6254001,6254027,27,72,66,165
"20125","chr7",6298989,6299018,30,64,116,210
"20126","chr7",6333169,6333196,28,52,62,142
"20127","chr7",6376487,6376520,34,77,6,117
"20128","chr7",6397031,6397059,29,45,5,79
"20129","chr7",6397241,6397274,34,38,74,146
"20130","chr7",6405629,6405647,19,25,11,55
"20131","chr7",6410881,6410902,22,8,134,164
"20132","chr7",6448189,6448228,40,44,31,115
"20133","chr7",6458591,6458633,43,77,74,194
"20134","chr7",6538566,6538583,18,135,7,160
"20135","chr7",6545087,6545113,27,61,74,162
"20136","chr7",6576893,6576917,25,31,101,157
"20137","chr7",6577112,6577287,176,34,75,285
"20138","chr7",6605697,6605714,18,42,89,149
"20139","chr7",6615488,6615543,56,18,47,121
"20140","chr7",6615502,6615560,59,1,33,93
"20141","chr7",6615692,6615719,28,5,34,67
"20142","chr7",6622086,6622137,52,8,32,92
"20143","chr7",6623098,6623116,19,6,48,73
"20144","chr7",6634172,6634265,94,16,117,227
"20145","chr7",6643010,6643048,39,1,118,158
"20146","chr7",6651191,6651214,24,91,30,145
"20147","chr7",6657312,6657338,27,148,127,302
"20148","chr7",6766958,6766978,21,72,45,138
"20149","chr7",6808385,6808416,32,50,103,185
"20150","chr7",6818546,6818740,195,113,9,317
"20151","chr7",6856914,6856949,36,3,135,174
"20152","chr7",7259317,7259334,18,145,28,191
"20153","chr7",7717039,7717074,36,27,92,155
"20154","chr7",7784757,7784779,23,7,33,63
"20155","chr7",7854356,7854379,24,24,73,121
"20156","chr7",7896331,7896351,21,147,5,173
"20157","chr7",7968827,7968847,21,51,64,136
"20158","chr7",7969361,7969380,20,6,63,89
"20159","chr7",8195543,8195587,45,37,5,87
"20160","chr7",8262265,8262287,23,27,7,57
"20161","chr7",8297300,8297319,20,135,29,184
"20162","chr7",9046118,9046135,18,32,74,124
"20163","chr7",9321992,9322009,18,69,85,172
"20164","chr7",9726175,9726205,31,24,19,74
"20165","chr7",10004023,10004042,20,127,33,180
"20166","chr7",11310527,11310553,27,9,140,176
"20167","chr7",11401414,11401431,18,72,14,104
"20168","chr7",11831828,11831880,53,115,136,304
"20169","chr7",12175401,12175426,26,46,146,218
"20170","chr7",12589216,12589234,19,14,115,148
"20171","chr7",12858368,12858411,44,20,141,205
"20172","chr7",13220621,13220645,25,12,6,43
"20173","chr7",14003097,14003116,20,61,122,203
"20174","chr7",14391507,14391534,28,137,142,307
"20175","chr7",14704280,14704298,19,145,23,187
"20176","chr7",14704448,14704479,32,114,6,152
"20177","chr7",14720474,14720518,45,31,141,217
"20178","chr7",14878749,14878781,33,12,74,119
"20179","chr7",15077408,15077436,29,8,130,167
"20180","chr7",15088874,15088891,18,9,131,158
"20181","chr7",15846769,15846794,26,108,27,161
"20182","chr7",15996999,15997025,27,79,75,181
"20183","chr7",16043946,16043970,25,39,68,132
"20184","chr7",16513345,16513368,24,76,46,146
"20185","chr7",16575131,16575154,24,1,58,83
"20186","chr7",16593352,16593378,27,142,34,203
"20187","chr7",16605675,16605700,26,8,15,49
"20188","chr7",16646203,16646236,34,31,24,89
"20189","chr7",16678088,16678112,25,55,33,113
"20190","chr7",16830239,16830259,21,77,25,123
"20191","chr7",17112699,17112970,272,94,39,405
"20192","chr7",17756246,17756276,31,122,83,236
"20193","chr7",17950468,17950499,32,30,74,136
"20194","chr7",18036252,18036274,23,29,4,56
"20195","chr7",18036271,18036289,19,44,120,183
"20196","chr7",18036287,18036318,32,4,104,140
"20197","chr7",18086904,18086933,30,52,11,93
"20198","chr7",18303376,18303424,49,29,84,162
"20199","chr7",18540104,18540124,21,78,25,124
"20200","chr7",18972370,18972398,29,45,85,159
"20201","chr7",19438965,19438982,18,29,75,122
"20202","chr7",20331939,20331960,22,94,75,191
"20203","chr7",20749396,20749418,23,104,107,234
"20204","chr7",20757954,20757990,37,8,21,66
"20205","chr7",20778946,20778968,23,140,8,171
"20206","chr7",20784425,20784445,21,67,38,126
"20207","chr7",20785322,20785353,32,135,9,176
"20208","chr7",20785415,20785451,37,2,21,60
"20209","chr7",20790842,20790881,40,54,82,176
"20210","chr7",21333403,21333425,23,145,47,215
"20211","chr7",21543351,21543378,28,25,15,68
"20212","chr7",21726861,21726891,31,17,6,54
"20213","chr7",21966894,21966935,42,75,126,243
"20214","chr7",22053654,22053672,19,15,74,108
"20215","chr7",22290745,22290763,19,105,6,130
"20216","chr7",22500667,22500694,28,8,18,54
"20217","chr7",22540326,22540343,18,12,23,53
"20218","chr7",22789855,22789891,37,126,139,302
"20219","chr7",22821406,22821436,31,80,12,123
"20220","chr7",22905387,22905414,28,122,136,286
"20221","chr7",23182743,23182765,23,78,24,125
"20222","chr7",23194673,23194706,34,8,47,89
"20223","chr7",23198206,23198230,25,76,18,119
"20224","chr7",23467593,23467611,19,134,69,222
"20225","chr7",23486689,23486720,32,127,32,191
"20226","chr7",23498991,23499022,32,75,6,113
"20227","chr7",23504164,23504186,23,10,5,38
"20228","chr7",23589773,23589816,44,80,89,213
"20229","chr7",24545999,24546017,19,43,67,129
"20230","chr7",24573277,24573296,20,64,58,142
"20231","chr7",24573298,24573332,35,100,37,172
"20232","chr7",24696694,24696716,23,23,76,122
"20233","chr7",24735761,24735807,47,82,3,132
"20234","chr7",24847060,24847078,19,34,74,127
"20235","chr7",24970105,24970127,23,77,48,148
"20236","chr7",25298342,25298373,32,43,53,128
"20237","chr7",25761463,25761484,22,76,56,154
"20238","chr7",25951373,25951428,56,1,86,143
"20239","chr7",25963744,25963773,30,9,10,49
"20240","chr7",26063972,26064000,29,137,33,199
"20241","chr7",26085232,26085255,24,77,32,133
"20242","chr7",26090459,26090478,20,77,6,103
"20243","chr7",26260375,26260406,32,36,3,71
"20244","chr7",26320418,26320447,30,74,9,113
"20245","chr7",26377019,26377065,47,15,69,131
"20246","chr7",26898656,26898684,29,37,77,143
"20247","chr7",27078424,27078447,24,66,15,105
"20248","chr7",27102142,27102167,26,69,68,163
"20249","chr7",27102974,27102992,19,114,77,210
"20250","chr7",27107833,27107852,20,32,87,139
"20251","chr7",27113863,27113886,24,76,67,167
"20252","chr7",27145447,27145498,52,118,65,235
"20253","chr7",27147970,27147993,24,118,91,233
"20254","chr7",27169094,27169133,40,25,142,207
"20255","chr7",27199680,27199729,50,84,116,250
"20256","chr7",27199827,27199862,36,2,73,111
"20257","chr7",27252584,27252631,48,10,56,114
"20258","chr7",27267944,27267967,24,44,100,168
"20259","chr7",27594026,27594060,35,24,71,130
"20260","chr7",28179777,28179812,36,125,43,204
"20261","chr7",28180223,28180242,20,16,53,89
"20262","chr7",28180781,28180815,35,1,16,52
"20263","chr7",28199533,28199575,43,126,98,267
"20264","chr7",28227728,28227787,60,48,113,221
"20265","chr7",28409188,28409223,36,57,125,218
"20266","chr7",28522391,28522411,21,6,59,86
"20267","chr7",28848838,28848861,24,29,75,128
"20268","chr7",29252579,29252606,28,69,54,151
"20269","chr7",29308463,29308482,20,77,2,99
"20270","chr7",29563051,29563071,21,120,6,147
"20271","chr7",29614097,29614115,19,37,82,138
"20272","chr7",29806910,29806932,23,5,2,30
"20273","chr7",29872799,29872824,26,146,3,175
"20274","chr7",29926411,29926429,19,73,72,164
"20275","chr7",30051974,30051994,21,45,73,139
"20276","chr7",30109656,30109688,33,75,6,114
"20277","chr7",30477682,30477701,20,36,75,131
"20278","chr7",30551976,30551996,21,19,75,115
"20279","chr7",30980186,30980203,18,14,73,105
"20280","chr7",31138657,31138675,19,76,12,107
"20281","chr7",31360880,31360906,27,44,27,98
"20282","chr7",31391681,31391699,19,77,27,123
"20283","chr7",31492523,31492544,22,145,27,194
"20284","chr7",32443080,32443104,25,28,3,56
"20285","chr7",32451826,32451845,20,76,45,141
"20286","chr7",32460845,32460881,37,130,6,173
"20287","chr7",32503320,32503374,55,111,96,262
"20288","chr7",32503374,32503406,33,143,42,218
"20289","chr7",32523723,32523748,26,5,66,97
"20290","chr7",32540872,32540916,45,76,26,147
"20291","chr7",32613591,32613609,19,36,136,191
"20292","chr7",32640834,32640856,23,54,143,220
"20293","chr7",32671092,32671116,25,77,33,135
"20294","chr7",32795745,32795762,18,7,131,156
"20295","chr7",32891819,32891845,27,59,33,119
"20296","chr7",32891875,32891930,56,27,88,171
"20297","chr7",33109418,33109442,25,71,39,135
"20298","chr7",33847422,33847441,20,142,73,235
"20299","chr7",34533117,34533158,42,58,127,227
"20300","chr7",34944366,34944405,40,24,71,135
"20301","chr7",35005637,35005663,27,79,77,183
"20302","chr7",35017502,35017522,21,145,67,233
"20303","chr7",35037001,35037043,43,1,121,165
"20304","chr7",35807352,35807380,29,6,75,110
"20305","chr7",35925829,35925861,33,124,34,191
"20306","chr7",36008056,36008083,28,7,74,109
"20307","chr7",36028265,36028294,30,148,129,307
"20308","chr7",36039326,36039344,19,45,66,130
"20309","chr7",36153231,36153250,20,5,95,120
"20310","chr7",36165587,36165618,32,37,75,144
"20311","chr7",36244768,36244789,22,7,13,42
"20312","chr7",36292464,36292513,50,64,8,122
"20313","chr7",36352397,36352419,23,21,6,50
"20314","chr7",36403966,36403986,21,6,145,172
"20315","chr7",36737538,36737558,21,104,143,268
"20316","chr7",37374752,37374776,25,11,80,116
"20317","chr7",37438432,37438450,19,77,27,123
"20318","chr7",37492108,37492132,25,115,120,260
"20319","chr7",38105746,38105795,50,96,5,151
"20320","chr7",38142403,38142479,77,101,21,199
"20321","chr7",38350557,38350579,23,63,28,114
"20322","chr7",38392378,38392404,27,76,139,242
"20323","chr7",38526434,38526454,21,34,146,201
"20324","chr7",39017814,39017842,29,16,3,48
"20325","chr7",39381232,39381254,23,75,75,173
"20326","chr7",39451775,39451810,36,22,7,65
"20327","chr7",39623633,39623671,39,33,77,149
"20328","chr7",39728670,39728693,24,74,42,140
"20329","chr7",39808771,39808801,31,132,6,169
"20330","chr7",39812500,39812557,58,77,85,220
"20331","chr7",39833454,39833477,24,110,31,165
"20332","chr7",39941349,39941368,20,137,80,237
"20333","chr7",39949858,39949876,19,1,72,92
"20334","chr7",39950840,39950865,26,42,143,211
"20335","chr7",39998444,39998472,29,148,33,210
"20336","chr7",40039435,40039457,23,16,143,182
"20337","chr7",40070067,40070093,27,148,19,194
"20338","chr7",40182562,40182588,27,101,74,202
"20339","chr7",40216499,40216521,23,99,75,197
"20340","chr7",41488896,41488921,26,28,27,81
"20341","chr7",41844465,41844501,37,15,102,154
"20342","chr7",42030188,42030206,19,86,51,156
"20343","chr7",42056799,42056833,35,146,23,204
"20344","chr7",42237561,42237597,37,87,21,145
"20345","chr7",42237977,42238005,29,10,13,52
"20346","chr7",42238004,42238047,44,33,59,136
"20347","chr7",42932702,42932720,19,13,56,88
"20348","chr7",43553669,43553688,20,114,74,208
"20349","chr7",43755997,43756023,27,43,94,164
"20350","chr7",43758888,43758906,19,105,105,229
"20351","chr7",43890214,43890232,19,8,136,163
"20352","chr7",43971810,43971852,43,74,140,257
"20353","chr7",44044683,44044700,18,95,39,152
"20354","chr7",44044900,44044926,27,41,6,74
"20355","chr7",44075719,44075737,19,57,109,185
"20356","chr7",44081745,44081763,19,8,76,103
"20357","chr7",44100177,44100200,24,55,45,124
"20358","chr7",44104265,44104292,28,49,49,126
"20359","chr7",44142594,44142612,19,117,61,197
"20360","chr7",44266972,44266992,21,124,94,239
"20361","chr7",44284249,44284269,21,81,83,185
"20362","chr7",44298125,44298143,19,113,73,205
"20363","chr7",44325662,44325696,35,88,43,166
"20364","chr7",44626975,44627012,38,6,51,95
"20365","chr7",44671768,44671787,20,13,6,39
"20366","chr7",44687082,44687113,32,34,50,116
"20367","chr7",44722750,44722771,22,6,118,146
"20368","chr7",44733386,44733403,18,76,75,169
"20369","chr7",44748357,44748386,30,5,41,76
"20370","chr7",44758914,44758932,19,145,6,170
"20371","chr7",44781791,44781817,27,19,10,56
"20372","chr7",44822447,44822495,49,14,7,70
"20373","chr7",44890131,44890162,32,65,143,240
"20374","chr7",45000479,45000502,24,79,125,228
"20375","chr7",45155477,45155517,41,79,66,186
"20376","chr7",45259969,45259991,23,41,9,73
"20377","chr7",45574546,45574586,41,94,2,137
"20378","chr7",45725373,45725391,19,20,39,78
"20379","chr7",45725392,45725433,42,62,20,124
"20380","chr7",45825649,45825670,22,8,22,52
"20381","chr7",45848013,45848036,24,33,122,179
"20382","chr7",45903532,45903550,19,132,6,157
"20383","chr7",46326884,46326909,26,8,134,168
"20384","chr7",46479129,46479147,19,35,143,197
"20385","chr7",46555463,46555501,39,66,56,161
"20386","chr7",47590677,47590714,38,144,5,187
"20387","chr7",47593251,47593272,22,59,6,87
"20388","chr7",47602986,47603006,21,137,33,191
"20389","chr7",47611726,47611743,18,8,62,88
"20390","chr7",47630214,47630236,23,19,133,175
"20391","chr7",47665527,47665553,27,8,80,115
"20392","chr7",47694250,47694295,46,13,74,133
"20393","chr7",47873650,47873671,22,62,71,155
"20394","chr7",47893230,47893254,25,18,74,117
"20395","chr7",49314877,49314903,27,9,70,106
"20396","chr7",49455060,49455088,29,126,67,222
"20397","chr7",49772061,49772130,70,112,83,265
"20398","chr7",49775403,49775420,18,8,1,27
"20399","chr7",49911481,49911503,23,36,76,135
"20400","chr7",50469256,50469277,22,43,105,170
"20401","chr7",50494509,50494527,19,113,4,136
"20402","chr7",50793508,50793545,38,20,37,95
"20403","chr7",50807475,50807493,19,129,124,272
"20404","chr7",50843130,50843155,26,35,74,135
"20405","chr7",51316930,51316951,22,99,45,166
"20406","chr7",52316962,52317005,44,70,75,189
"20407","chr7",52454745,52454772,28,29,75,132
"20408","chr7",52620577,52620600,24,78,27,129
"20409","chr7",53278168,53278195,28,66,118,212
"20410","chr7",54354715,54354734,20,40,57,117
"20411","chr7",54669717,54669752,36,7,117,160
"20412","chr7",54713974,54713993,20,61,74,155
"20413","chr7",54774787,54774807,21,25,75,121
"20414","chr7",54834086,54834108,23,92,1,116
"20415","chr7",55194227,55194244,18,76,70,164
"20416","chr7",55235300,55235323,24,127,113,264
"20417","chr7",55353524,55353542,19,80,75,174
"20418","chr7",55405491,55405510,20,8,119,147
"20419","chr7",55764450,55764470,21,84,74,179
"20420","chr7",55781983,55782024,42,111,74,227
"20421","chr7",55788377,55788405,29,9,6,44
"20422","chr7",55887601,55887639,39,97,59,195
"20423","chr7",55933687,55933705,19,59,56,134
"20424","chr7",56042219,56042237,19,16,78,113
"20425","chr7",56052779,56052805,27,70,48,145
"20426","chr7",56056726,56056747,22,9,12,43
"20427","chr7",56064883,56064910,28,13,6,47
"20428","chr7",56095677,56095697,21,7,131,159
"20429","chr7",56097440,56097467,28,75,3,106
"20430","chr7",56287921,56287942,22,95,21,138
"20431","chr7",56335930,56335952,23,123,34,180
"20432","chr7",56340881,56340901,21,134,73,228
"20433","chr7",56355769,56355797,29,25,6,60
"20434","chr7",56415772,56415791,20,64,5,89
"20435","chr7",56538320,56538360,41,7,11,59
"20436","chr7",56726259,56726291,33,5,135,173
"20437","chr7",56978646,56978667,22,76,133,231
"20438","chr7",56983590,56983622,33,128,55,216
"20439","chr7",56995450,56995477,28,69,71,168
"20440","chr7",57003944,57003963,20,31,42,93
"20441","chr7",57004086,57004203,118,30,88,236
"20442","chr7",57004098,57004215,118,42,76,236
"20443","chr7",57010019,57010054,36,29,34,99
"20444","chr7",57020325,57020393,69,74,121,264
"20445","chr7",63015330,63015363,34,12,74,120
"20446","chr7",63114428,63114456,29,75,18,122
"20447","chr7",63556476,63556544,69,123,72,264
"20448","chr7",63566824,63566859,36,26,27,89
"20449","chr7",63572921,63572950,30,44,45,119
"20450","chr7",63575149,63575175,27,9,7,43
"20451","chr7",63576011,63576028,18,7,123,148
"20452","chr7",63581472,63581499,28,73,67,168
"20453","chr7",63593334,63593366,33,57,126,216
"20454","chr7",63598285,63598304,20,135,74,229
"20455","chr7",63797094,63797116,23,34,74,131
"20456","chr7",63830545,63830585,41,110,65,216
"20457","chr7",63850768,63850794,27,5,4,36
"20458","chr7",64091938,64091956,19,10,38,67
"20459","chr7",64182020,64182076,57,40,100,197
"20460","chr7",64306899,64306938,40,64,38,142
"20461","chr7",64451171,64451201,31,91,78,200
"20462","chr7",64476530,64476556,27,73,89,189
"20463","chr7",64480097,64480125,29,57,116,202
"20464","chr7",64557555,64557594,40,136,74,250
"20465","chr7",64567023,64567040,18,7,59,84
"20466","chr7",64570502,64570541,40,1,9,50
"20467","chr7",64575237,64575265,29,125,22,176
"20468","chr7",64769470,64769491,22,37,143,202
"20469","chr7",64825502,64825523,22,42,114,178
"20470","chr7",64943574,64943606,33,119,83,235
"20471","chr7",65022479,65022514,36,75,94,205
"20472","chr7",65022674,65022700,27,4,66,97
"20473","chr7",65338992,65339009,18,8,135,161
"20474","chr7",65402223,65402246,24,75,108,207
"20475","chr7",65413652,65413679,28,76,94,198
"20476","chr7",65751917,65751943,27,28,74,129
"20477","chr7",65795956,65796019,64,70,120,254
"20478","chr7",65847314,65847343,30,8,57,95
"20479","chr7",65859122,65859159,38,7,71,116
"20480","chr7",65873238,65873367,130,8,4,142
"20481","chr7",65890125,65890148,24,8,25,57
"20482","chr7",66019752,66019794,43,22,8,73
"20483","chr7",66074688,66074731,44,25,22,91
"20484","chr7",66096083,66096102,20,80,74,174
"20485","chr7",66124045,66124080,36,14,6,56
"20486","chr7",66165609,66165626,18,77,16,111
"20487","chr7",66376681,66376717,37,7,5,49
"20488","chr7",66415215,66415237,23,52,140,215
"20489","chr7",66415237,66415261,25,8,118,151
"20490","chr7",66418153,66418193,41,9,144,194
"20491","chr7",66494579,66494597,19,139,45,203
"20492","chr7",66543282,66543313,32,74,64,170
"20493","chr7",66550446,66550466,21,70,7,98
"20494","chr7",66599051,66599068,18,12,145,175
"20495","chr7",66601483,66601504,22,69,143,234
"20496","chr7",66606150,66606168,19,76,28,123
"20497","chr7",66611864,66611889,26,10,78,114
"20498","chr7",66612111,66612135,25,76,69,170
"20499","chr7",66621267,66621299,33,147,24,204
"20500","chr7",66621969,66621987,19,10,6,35
"20501","chr7",66628737,66628754,18,128,82,228
"20502","chr7",66677762,66677780,19,131,74,224
"20503","chr7",66678565,66678589,25,25,6,56
"20504","chr7",66746619,66746640,22,7,115,144
"20505","chr7",66813843,66813866,24,147,76,247
"20506","chr7",66995252,66995270,19,73,81,173
"20507","chr7",67008660,67008683,24,47,104,175
"20508","chr7",67031193,67031211,19,10,74,103
"20509","chr7",67240129,67240157,29,120,31,180
"20510","chr7",67246094,67246121,28,6,73,107
"20511","chr7",67248730,67248756,27,8,86,121
"20512","chr7",67316507,67316529,23,129,72,224
"20513","chr7",67382795,67382814,20,36,39,95
"20514","chr7",67384940,67384959,20,65,1,86
"20515","chr7",67469886,67469911,26,76,120,222
"20516","chr7",67648600,67648650,51,82,125,258
"20517","chr7",67684917,67684940,24,76,145,245
"20518","chr7",67759508,67759529,22,76,15,113
"20519","chr7",67891470,67891499,30,34,138,202
"20520","chr7",67928804,67928850,47,73,40,160
"20521","chr7",68067267,68067310,44,7,70,121
"20522","chr7",68233671,68233694,24,131,73,228
"20523","chr7",68248037,68248074,38,33,64,135
"20524","chr7",68421891,68421933,43,31,77,151
"20525","chr7",68575313,68575330,18,79,73,170
"20526","chr7",68602822,68602850,29,57,72,158
"20527","chr7",68785843,68785879,37,135,95,267
"20528","chr7",68997381,68997407,27,128,6,161
"20529","chr7",69346516,69346539,24,145,69,238
"20530","chr7",69361694,69361719,26,73,66,165
"20531","chr7",69430438,69430464,27,70,54,151
"20532","chr7",69494434,69494456,23,78,34,135
"20533","chr7",69571417,69571434,18,41,7,66
"20534","chr7",69598055,69598073,19,116,80,215
"20535","chr7",69598310,69598359,50,8,75,133
"20536","chr7",69598386,69598408,23,35,3,61
"20537","chr7",69598634,69598653,20,146,18,184
"20538","chr7",69689641,69689695,55,8,144,207
"20539","chr7",69850297,69850325,29,128,8,165
"20540","chr7",70004810,70004841,32,75,29,136
"20541","chr7",70108784,70108814,31,58,50,139
"20542","chr7",70280451,70280469,19,29,75,123
"20543","chr7",70460339,70460367,29,57,67,153
"20544","chr7",70581387,70581409,23,118,5,146
"20545","chr7",70739805,70739826,22,27,62,111
"20546","chr7",70741692,70741718,27,68,5,100
"20547","chr7",70796777,70796798,22,77,39,138
"20548","chr7",70807301,70807341,41,32,74,147
"20549","chr7",70807356,70807385,30,76,19,125
"20550","chr7",70990452,70990578,127,30,77,234
"20551","chr7",71154212,71154237,26,127,112,265
"20552","chr7",71441455,71441477,23,54,106,183
"20553","chr7",71525358,71525378,21,28,60,109
"20554","chr7",71544298,71544315,18,29,144,191
"20555","chr7",71633104,71633125,22,20,74,116
"20556","chr7",71743676,71743714,39,31,75,145
"20557","chr7",71873002,71873021,20,76,57,153
"20558","chr7",72017171,72017191,21,60,67,148
"20559","chr7",72226094,72226111,18,93,8,119
"20560","chr7",72475919,72475942,24,52,65,141
"20561","chr7",72475942,72475966,25,76,42,143
"20562","chr7",72500270,72500300,31,78,87,196
"20563","chr7",72567952,72567978,27,75,4,106
"20564","chr7",72659578,72659595,18,75,74,167
"20565","chr7",72799152,72799176,25,8,140,173
"20566","chr7",72857536,72857561,26,131,117,274
"20567","chr7",72899576,72899596,21,8,108,137
"20568","chr7",72923590,72923617,28,8,143,179
"20569","chr7",73006527,73006576,50,102,92,244
"20570","chr7",73122587,73122612,26,12,121,159
"20571","chr7",73135872,73135897,26,75,7,108
"20572","chr7",73151364,73151382,19,27,35,81
"20573","chr7",73154801,73154836,36,22,114,172
"20574","chr7",73155450,73155475,26,5,67,98
"20575","chr7",73155654,73155689,36,84,16,136
"20576","chr7",73223319,73223372,54,41,4,99
"20577","chr7",73227874,73227891,18,56,74,148
"20578","chr7",73236746,73236765,20,103,73,196
"20579","chr7",73280397,73280449,53,31,73,157
"20580","chr7",73309085,73309108,24,78,2,104
"20581","chr7",73374273,73374290,18,78,119,215
"20582","chr7",73409117,73409136,20,115,67,202
"20583","chr7",73416011,73416121,111,72,34,217
"20584","chr7",73433483,73433506,24,11,73,108
"20585","chr7",73452725,73452742,18,3,71,92
"20586","chr7",73455028,73455046,19,121,70,210
"20587","chr7",73482038,73482061,24,46,75,145
"20588","chr7",73521779,73521807,29,76,17,122
"20589","chr7",73540830,73540855,26,3,6,35
"20590","chr7",73577265,73577284,20,138,2,160
"20591","chr7",73579540,73579563,24,84,45,153
"20592","chr7",73657669,73657699,31,130,118,279
"20593","chr7",73657844,73657870,27,76,26,129
"20594","chr7",73660238,73660271,34,53,8,95
"20595","chr7",73665235,73665269,35,129,6,170
"20596","chr7",73667848,73667919,72,30,37,139
"20597","chr7",73684924,73684959,36,82,6,124
"20598","chr7",73708263,73708298,36,36,7,79
"20599","chr7",73719715,73719771,57,49,28,134
"20600","chr7",73723509,73723530,22,145,27,194
"20601","chr7",73725690,73725723,34,51,6,91
"20602","chr7",73725721,73725783,63,6,42,111
"20603","chr7",73733663,73733683,21,8,7,36
"20604","chr7",73739745,73739767,23,89,35,147
"20605","chr7",73769329,73769366,38,80,21,139
"20606","chr7",73770144,73770166,23,30,82,135
"20607","chr7",73808446,73808486,41,8,141,190
"20608","chr7",73832812,73832829,18,114,134,266
"20609","chr7",73861445,73861462,18,32,44,94
"20610","chr7",74011613,74011652,40,71,29,140
"20611","chr7",74028059,74028103,45,34,83,162
"20612","chr7",74028863,74028882,20,73,39,132
"20613","chr7",74083865,74083893,29,77,28,134
"20614","chr7",74091955,74091983,29,75,9,113
"20615","chr7",74118378,74118426,49,104,41,194
"20616","chr7",74127177,74127194,18,134,34,186
"20617","chr7",74152891,74152913,23,76,50,149
"20618","chr7",74154957,74154978,22,34,34,90
"20619","chr7",74201516,74201538,23,7,112,142
"20620","chr7",74201909,74201926,18,69,56,143
"20621","chr7",74213422,74213442,21,8,144,173
"20622","chr7",74219010,74219047,38,69,132,239
"20623","chr7",74222231,74222251,21,77,26,124
"20624","chr7",74277199,74277223,25,8,23,56
"20625","chr7",74281609,74281628,20,6,61,87
"20626","chr7",74281788,74281811,24,8,135,167
"20627","chr7",74282551,74282580,30,75,75,180
"20628","chr7",74308466,74308485,20,39,26,85
"20629","chr7",74320196,74320226,31,130,74,235
"20630","chr7",74329075,74329107,33,37,80,150
"20631","chr7",74343492,74343522,31,59,59,149
"20632","chr7",74351836,74351885,50,9,6,65
"20633","chr7",74366876,74366899,24,94,43,161
"20634","chr7",74375838,74375855,18,4,120,142
"20635","chr7",74428582,74428620,39,57,73,169
"20636","chr7",74428618,74428638,21,75,37,133
"20637","chr7",74447699,74447719,21,64,76,161
"20638","chr7",74484454,74484472,19,72,138,229
"20639","chr7",74491996,74492021,26,8,11,45
"20640","chr7",74492171,74492188,18,76,143,237
"20641","chr7",74546213,74546239,27,8,122,157
"20642","chr7",74547440,74547460,21,12,30,63
"20643","chr7",74574151,74574173,23,27,75,125
"20644","chr7",74615178,74615196,19,77,25,121
"20645","chr7",74626191,74626214,24,8,135,167
"20646","chr7",74637313,74637334,22,75,128,225
"20647","chr7",74647149,74647173,25,10,73,108
"20648","chr7",74652985,74653022,38,53,4,95
"20649","chr7",74657652,74657698,47,30,22,99
"20650","chr7",74660588,74660633,46,70,49,165
"20651","chr7",74666812,74666830,19,77,27,123
"20652","chr7",74697947,74697974,28,9,64,101
"20653","chr7",74776708,74776761,54,41,4,99
"20654","chr7",74781245,74781265,21,56,74,151
"20655","chr7",74790116,74790135,20,103,73,196
"20656","chr7",74833222,74833256,35,31,73,139
"20657","chr7",74891200,74891249,50,102,92,244
"20658","chr7",74908647,74908691,45,8,12,65
"20659","chr7",74931408,74931433,26,12,121,159
"20660","chr7",74935884,74935920,37,71,78,186
"20661","chr7",74944686,74944714,29,75,7,111
"20662","chr7",74961128,74961146,19,27,35,81
"20663","chr7",74965205,74965230,26,4,67,97
"20664","chr7",74965410,74965445,36,84,15,135
"20665","chr7",74988293,74988314,22,43,79,144
"20666","chr7",75009263,75009287,25,10,4,39
"20667","chr7",75011429,75011446,18,141,6,165
"20668","chr7",75011728,75011758,31,18,82,131
"20669","chr7",75014420,75014440,21,75,25,121
"20670","chr7",75033072,75033094,23,31,74,128
"20671","chr7",75037172,75037202,31,125,97,253
"20672","chr7",75048267,75048287,21,58,74,153
"20673","chr7",75050287,75050317,31,72,69,172
"20674","chr7",75064329,75064346,18,144,7,169
"20675","chr7",75092775,75092806,32,54,55,141
"20676","chr7",75112086,75112118,33,75,29,137
"20677","chr7",75155816,75155838,23,75,101,199
"20678","chr7",75169216,75169269,54,6,39,99
"20679","chr7",75236946,75236981,36,17,82,135
"20680","chr7",75237161,75237186,26,69,2,97
"20681","chr7",75237798,75237827,30,116,22,168
"20682","chr7",75241249,75241267,19,37,25,81
"20683","chr7",75256819,75256839,21,9,69,99
"20684","chr7",75270048,75270073,26,123,10,159
"20685","chr7",75358542,75358591,50,94,100,244
"20686","chr7",75467532,75467555,24,110,6,140
"20687","chr7",75599839,75599856,18,11,1,30
"20688","chr7",75639199,75639219,21,6,80,107
"20689","chr7",75639245,75639285,41,8,34,83
"20690","chr7",75669376,75669410,35,75,71,181
"20691","chr7",75669565,75669586,22,98,71,191
"20692","chr7",75723950,75723983,34,86,110,230
"20693","chr7",75727846,75727864,19,93,6,118
"20694","chr7",75763318,75763335,18,79,112,209
"20695","chr7",75791014,75791043,30,75,49,154
"20696","chr7",75792742,75792791,50,21,5,76
"20697","chr7",75829647,75829666,20,36,68,124
"20698","chr7",75871484,75871531,48,41,74,163
"20699","chr7",75878896,75878915,20,18,103,141
"20700","chr7",75891616,75891635,20,145,34,199
"20701","chr7",75894433,75894477,45,6,62,113
"20702","chr7",76007897,76007915,19,146,58,223
"20703","chr7",76046646,76046664,19,41,146,206
"20704","chr7",76167554,76167589,36,142,63,241
"20705","chr7",76191187,76191210,24,76,93,193
"20706","chr7",76212465,76212487,23,9,118,150
"20707","chr7",76236006,76236030,25,147,105,277
"20708","chr7",76266173,76266688,516,75,6,597
"20709","chr7",76267535,76267554,20,99,26,145
"20710","chr7",76275106,76275135,30,48,6,84
"20711","chr7",76285697,76285732,36,69,62,167
"20712","chr7",76292422,76292439,18,5,11,34
"20713","chr7",76316401,76316418,18,36,29,83
"20714","chr7",76390958,76390984,27,144,110,281
"20715","chr7",76451275,76451293,19,76,8,103
"20716","chr7",76454931,76454973,43,73,128,244
"20717","chr7",76456728,76456747,20,28,76,124
"20718","chr7",76460801,76460840,40,68,138,246
"20719","chr7",76471157,76471179,23,8,17,48
"20720","chr7",76514906,76514929,24,6,6,36
"20721","chr7",76608089,76608118,30,76,86,192
"20722","chr7",76620160,76620179,20,78,26,124
"20723","chr7",76621941,76621975,35,130,5,170
"20724","chr7",76949357,76949377,21,76,8,105
"20725","chr7",76953015,76953061,47,73,128,248
"20726","chr7",76954837,76954856,20,28,76,124
"20727","chr7",76958626,76958645,20,41,51,112
"20728","chr7",76958913,76958952,40,68,138,246
"20729","chr7",76969256,76969274,19,8,17,44
"20730","chr7",77390947,77390983,37,145,44,226
"20731","chr7",77416516,77416534,19,97,8,124
"20732","chr7",77435833,77435874,42,142,11,195
"20733","chr7",77440171,77440197,27,71,145,243
"20734","chr7",77537106,77537131,26,123,21,170
"20735","chr7",77537204,77537234,31,15,105,151
"20736","chr7",77613168,77613192,25,76,48,149
"20737","chr7",77652613,77652640,28,18,19,65
"20738","chr7",77661144,77661165,22,118,2,142
"20739","chr7",77724826,77724859,34,75,45,154
"20740","chr7",77725245,77725265,21,8,44,73
"20741","chr7",77725631,77725651,21,51,61,133
"20742","chr7",77927158,77927178,21,12,7,40
"20743","chr7",78020098,78020118,21,58,94,173
"20744","chr7",78536104,78536130,27,8,6,41
"20745","chr7",79453794,79453823,30,34,54,118
"20746","chr7",79687499,79687520,22,37,56,115
"20747","chr7",80551421,80551442,22,93,26,141
"20748","chr7",80956947,80956964,18,100,125,243
"20749","chr7",80989651,80989701,51,78,4,133
"20750","chr7",81041870,81041892,23,134,75,232
"20751","chr7",81793692,81793714,23,37,113,173
"20752","chr7",82092541,82092565,25,28,74,127
"20753","chr7",82172617,82172640,24,58,146,228
"20754","chr7",83924759,83924813,55,130,4,189
"20755","chr7",84133887,84133912,26,145,35,206
"20756","chr7",85147077,85147119,43,7,31,81
"20757","chr7",85244709,85244729,21,9,132,162
"20758","chr7",85843462,85843481,20,106,68,194
"20759","chr7",86126413,86126454,42,109,35,186
"20760","chr7",86275509,86275528,20,77,131,228
"20761","chr7",86828112,86828137,26,14,74,114
"20762","chr7",87475717,87475741,25,11,25,61
"20763","chr7",87628585,87628625,41,117,106,264
"20764","chr7",87875996,87876019,24,49,5,78
"20765","chr7",88052342,88052359,18,86,23,127
"20766","chr7",88190538,88190557,20,46,3,69
"20767","chr7",88195502,88195533,32,8,21,61
"20768","chr7",88418597,88418614,18,50,21,89
"20769","chr7",88870385,88870407,23,122,6,151
"20770","chr7",89215884,89215930,47,60,5,112
"20771","chr7",90153965,90153990,26,20,4,50
"20772","chr7",90337946,90337977,32,7,121,160
"20773","chr7",90338132,90338153,22,24,139,185
"20774","chr7",90998891,90998919,29,26,72,127
"20775","chr7",92223274,92223295,22,76,27,125
"20776","chr7",92246091,92246111,21,19,32,72
"20777","chr7",92554363,92554381,19,12,123,154
"20778","chr7",92554398,92554444,47,75,88,210
"20779","chr7",92590620,92590651,32,10,40,82
"20780","chr7",92836942,92836961,20,129,4,153
"20781","chr7",92870370,92870398,29,56,73,158
"20782","chr7",92870618,92870643,26,134,25,185
"20783","chr7",93261678,93261699,22,84,6,112
"20784","chr7",93510872,93510894,23,92,31,146
"20785","chr7",94867402,94867419,18,38,73,129
"20786","chr7",95954916,95954938,23,67,74,164
"20787","chr7",96107870,96107890,21,117,101,239
"20788","chr7",96140398,96140422,25,9,5,39
"20789","chr7",96996549,96996582,34,27,42,103
"20790","chr7",97006052,97006110,59,35,41,135
"20791","chr7",97028177,97028226,50,8,12,70
"20792","chr7",97035913,97035948,36,12,53,101
"20793","chr7",97035954,97035981,28,45,12,85
"20794","chr7",97098388,97098413,26,8,32,66
"20795","chr7",97452391,97452410,20,78,75,173
"20796","chr7",97463957,97463975,19,75,66,160
"20797","chr7",97806193,97806217,25,32,66,123
"20798","chr7",97880916,97880934,19,52,76,147
"20799","chr7",97880935,97880959,25,77,57,159
"20800","chr7",97933746,97933764,19,146,71,236
"20801","chr7",97971631,97971648,18,80,110,208
"20802","chr7",97971695,97971712,18,144,46,208
"20803","chr7",98028272,98028289,18,56,74,148
"20804","chr7",98028299,98028335,37,102,47,186
"20805","chr7",98035584,98035627,44,89,5,138
"20806","chr7",98089330,98089373,44,107,72,223
"20807","chr7",98107207,98107225,19,23,9,51
"20808","chr7",98172303,98172322,20,76,53,149
"20809","chr7",98210474,98210492,19,44,66,129
"20810","chr7",98211364,98211396,33,42,75,150
"20811","chr7",98216559,98216578,20,80,79,179
"20812","chr7",98223341,98223364,24,52,79,155
"20813","chr7",98231150,98231171,22,56,84,162
"20814","chr7",98262753,98262772,20,8,18,46
"20815","chr7",98280229,98280246,18,61,77,156
"20816","chr7",98280248,98280275,28,90,58,176
"20817","chr7",98281657,98281676,20,40,13,73
"20818","chr7",98359274,98359291,18,77,1,96
"20819","chr7",98407570,98407594,25,8,18,51
"20820","chr7",98529522,98529563,42,42,6,90
"20821","chr7",98582411,98582429,19,73,75,167
"20822","chr7",98617153,98617175,23,50,77,150
"20823","chr7",98681151,98681169,19,70,3,92
"20824","chr7",98684154,98684176,23,74,31,128
"20825","chr7",98690302,98690322,21,8,35,64
"20826","chr7",98692242,98692259,18,145,26,189
"20827","chr7",98731583,98731630,48,12,65,125
"20828","chr7",98740407,98740429,23,143,7,173
"20829","chr7",98769322,98769348,27,6,2,35
"20830","chr7",98780589,98780627,39,98,109,246
"20831","chr7",98812127,98812157,31,4,131,166
"20832","chr7",98824074,98824091,18,81,3,102
"20833","chr7",98857894,98857912,19,26,74,119
"20834","chr7",98906403,98906449,47,125,92,264
"20835","chr7",99100109,99100126,18,5,64,87
"20836","chr7",99103893,99103910,18,76,139,233
"20837","chr7",99143829,99143847,19,45,15,79
"20838","chr7",99144016,99144048,33,55,10,98
"20839","chr7",99208247,99208270,24,73,22,119
"20840","chr7",99274670,99274691,22,76,26,124
"20841","chr7",99347708,99347729,22,127,3,152
"20842","chr7",99349841,99349859,19,76,5,100
"20843","chr7",99387737,99387758,22,125,74,221
"20844","chr7",99408557,99408582,26,50,11,87
"20845","chr7",99438954,99438975,22,65,38,125
"20846","chr7",99447260,99447285,26,8,134,168
"20847","chr7",99466559,99466577,19,82,126,227
"20848","chr7",99483234,99483252,19,129,71,219
"20849","chr7",99488931,99488950,20,94,74,188
"20850","chr7",99503949,99503972,24,58,8,90
"20851","chr7",99506850,99506869,20,29,75,124
"20852","chr7",99599126,99599148,23,29,76,128
"20853","chr7",99634798,99634816,19,101,73,193
"20854","chr7",99636047,99636070,24,121,6,151
"20855","chr7",100027748,100027765,18,147,74,239
"20856","chr7",100039312,100039343,32,115,6,153
"20857","chr7",100042738,100042761,24,22,17,63
"20858","chr7",100044503,100044532,30,78,36,144
"20859","chr7",100069552,100069573,22,18,74,114
"20860","chr7",100088993,100089013,21,28,23,72
"20861","chr7",100131764,100131886,123,128,126,377
"20862","chr7",100134397,100134419,23,9,75,107
"20863","chr7",100136254,100136273,20,88,54,162
"20864","chr7",100145433,100145451,19,103,20,142
"20865","chr7",100151381,100151403,23,5,52,80
"20866","chr7",100168006,100168032,27,37,99,163
"20867","chr7",100172686,100172834,149,19,53,221
"20868","chr7",100271491,100271526,36,17,82,135
"20869","chr7",100271706,100271731,26,73,2,101
"20870","chr7",100272316,100272333,18,127,23,168
"20871","chr7",100288038,100288069,32,126,10,168
"20872","chr7",100335435,100335484,50,94,100,244
"20873","chr7",100358016,100358034,19,19,33,71
"20874","chr7",100380975,100380993,19,22,70,111
"20875","chr7",100381997,100382023,27,91,66,184
"20876","chr7",100447073,100447093,21,110,73,204
"20877","chr7",100457619,100457638,20,8,95,123
"20878","chr7",100472415,100472441,27,40,115,182
"20879","chr7",100478323,100478351,29,64,20,113
"20880","chr7",100493656,100493682,27,60,79,166
"20881","chr7",100505917,100505940,24,145,34,203
"20882","chr7",100527860,100527887,28,26,142,196
"20883","chr7",100539402,100539419,18,11,9,38
"20884","chr7",100550306,100550330,25,79,76,180
"20885","chr7",100560809,100560829,21,76,102,199
"20886","chr7",100579597,100579614,18,27,6,51
"20887","chr7",100591032,100591055,24,9,83,116
"20888","chr7",100601997,100602019,23,29,74,126
"20889","chr7",100610670,100610705,36,145,46,227
"20890","chr7",100611826,100611843,18,8,6,32
"20891","chr7",100623888,100623910,23,57,33,113
"20892","chr7",100632517,100632535,19,13,14,46
"20893","chr7",100633699,100633726,28,8,43,79
"20894","chr7",100634178,100634220,43,30,21,94
"20895","chr7",100637402,100637437,36,70,71,177
"20896","chr7",100673816,100673860,45,8,42,95
"20897","chr7",100678355,100678374,20,98,140,258
"20898","chr7",100694313,100694383,71,21,4,96
"20899","chr7",100706470,100706490,21,43,100,164
"20900","chr7",100708768,100708791,24,38,119,181
"20901","chr7",100725132,100725165,34,106,7,147
"20902","chr7",100725532,100725564,33,78,57,168
"20903","chr7",100732005,100732031,27,129,11,167
"20904","chr7",100746235,100746260,26,74,67,167
"20905","chr7",100795905,100795931,27,78,7,112
"20906","chr7",100817083,100817104,22,15,74,111
"20907","chr7",100817860,100817883,24,120,87,231
"20908","chr7",100828552,100828575,24,121,60,205
"20909","chr7",100848084,100848108,25,33,76,134
"20910","chr7",100889727,100889788,62,97,14,173
"20911","chr7",100895809,100895840,32,2,36,70
"20912","chr7",100936302,100936405,104,76,30,210
"20913","chr7",100937660,100937681,22,44,51,117
"20914","chr7",101014778,101014823,46,117,145,308
"20915","chr7",101051365,101051389,25,45,74,144
"20916","chr7",101104554,101104576,23,3,70,96
"20917","chr7",101133294,101133320,27,117,73,217
"20918","chr7",101135220,101135344,125,33,9,167
"20919","chr7",101178711,101178734,24,70,33,127
"20920","chr7",101178890,101178910,21,10,7,38
"20921","chr7",101179141,101179167,27,10,60,97
"20922","chr7",101186782,101186801,20,65,7,92
"20923","chr7",101187703,101187721,19,27,75,121
"20924","chr7",101187745,101187767,23,73,33,129
"20925","chr7",101193418,101193448,31,78,32,141
"20926","chr7",101199001,101199020,20,70,26,116
"20927","chr7",101201403,101201442,40,84,50,174
"20928","chr7",101217220,101217244,25,53,29,107
"20929","chr7",101276283,101276308,26,98,69,193
"20930","chr7",101351163,101351180,18,137,72,227
"20931","chr7",101361755,101361790,36,130,74,240
"20932","chr7",101392398,101392419,22,76,74,172
"20933","chr7",101461997,101462017,21,8,32,61
"20934","chr7",101466796,101466838,43,43,138,224
"20935","chr7",101493758,101493783,26,77,36,139
"20936","chr7",101547703,101547851,149,81,139,369
"20937","chr7",101549358,101549386,29,24,143,196
"20938","chr7",101642037,101642054,18,9,6,33
"20939","chr7",101654044,101654061,18,12,4,34
"20940","chr7",101654273,101654294,22,29,77,128
"20941","chr7",101658663,101658687,25,76,10,111
"20942","chr7",101680291,101680310,20,78,117,215
"20943","chr7",101691949,101691971,23,20,95,138
"20944","chr7",101702899,101702938,40,50,55,145
"20945","chr7",101737187,101737210,24,104,76,204
"20946","chr7",101737210,101737233,24,127,53,204
"20947","chr7",101743688,101743725,38,47,100,185
"20948","chr7",101744539,101744558,20,145,91,256
"20949","chr7",101765098,101765121,24,46,52,122
"20950","chr7",101816406,101816447,42,38,8,88
"20951","chr7",101816757,101816780,24,6,7,37
"20952","chr7",101831735,101831757,23,74,6,103
"20953","chr7",101834996,101835032,37,10,74,121
"20954","chr7",101870145,101870170,26,5,69,100
"20955","chr7",101956139,101956163,25,22,49,96
"20956","chr7",101967000,101967028,29,73,54,156
"20957","chr7",102005325,102005351,27,7,73,107
"20958","chr7",102123609,102123627,19,23,74,116
"20959","chr7",102126178,102126212,35,29,146,210
"20960","chr7",102131109,102131126,18,112,46,176
"20961","chr7",102143773,102143798,26,6,76,108
"20962","chr7",102180897,102180959,63,8,59,130
"20963","chr7",102231026,102231047,22,8,32,62
"20964","chr7",102239735,102239763,29,7,27,63
"20965","chr7",102264005,102264023,19,8,45,72
"20966","chr7",102286791,102286840,50,55,12,117
"20967","chr7",102293199,102293221,23,69,102,194
"20968","chr7",102298915,102298938,24,29,104,157
"20969","chr7",102300586,102300614,29,44,126,199
"20970","chr7",102301538,102301601,64,19,79,162
"20971","chr7",102434122,102434145,24,9,3,36
"20972","chr7",102444236,102444267,32,5,125,162
"20973","chr7",102459146,102459165,20,74,74,168
"20974","chr7",102463323,102463347,25,8,73,106
"20975","chr7",102479069,102479109,41,103,17,161
"20976","chr7",102517809,102517841,33,44,62,139
"20977","chr7",102540844,102540900,57,7,74,138
"20978","chr7",102572733,102572760,28,97,14,139
"20979","chr7",102616788,102616820,33,44,62,139
"20980","chr7",102639952,102640011,60,7,74,141
"20981","chr7",103061176,103061209,34,54,60,148
"20982","chr7",103970124,103970159,36,8,78,122
"20983","chr7",103975713,103975730,18,36,75,129
"20984","chr7",103989357,103989387,31,115,127,273
"20985","chr7",104173839,104173862,24,8,39,71
"20986","chr7",104328733,104328778,46,100,4,150
"20987","chr7",104328789,104328820,32,142,146,320
"20988","chr7",104409032,104409049,18,29,74,121
"20989","chr7",104489079,104489100,22,8,2,32
"20990","chr7",104856241,104856268,28,37,27,92
"20991","chr7",104914018,104914046,29,69,2,100
"20992","chr7",105011850,105011872,23,143,6,172
"20993","chr7",105014152,105014196,45,87,87,219
"20994","chr7",105070633,105070656,24,70,7,101
"20995","chr7",105140603,105140629,27,96,4,127
"20996","chr7",105203717,105203745,29,114,128,271
"20997","chr7",105335652,105335669,18,145,124,287
"20998","chr7",105385172,105385198,27,9,145,181
"20999","chr7",105388923,105388943,21,81,23,125
"21000","chr7",105388980,105389014,35,28,64,127
"21001","chr7",105405714,105405744,31,69,11,111
"21002","chr7",105413787,105413844,58,144,5,207
"21003","chr7",105419876,105419899,24,41,71,136
"21004","chr7",105472921,105472942,22,37,75,134
"21005","chr7",105520520,105520562,43,98,13,154
"21006","chr7",105540261,105540278,18,7,60,85
"21007","chr7",105554428,105554454,27,5,50,82
"21008","chr7",105580475,105580497,23,99,6,128
"21009","chr7",105596073,105596119,47,76,112,235
"21010","chr7",105627842,105627862,21,8,135,164
"21011","chr7",105628793,105628839,47,54,6,107
"21012","chr7",105671105,105671133,29,77,8,114
"21013","chr7",105969088,105969109,22,5,74,101
"21014","chr7",106054601,106054624,24,2,128,154
"21015","chr7",106112348,106112375,28,72,4,104
"21016","chr7",106284564,106284589,26,45,5,76
"21017","chr7",106284719,106284752,34,11,126,171
"21018","chr7",106785395,106785429,35,8,119,162
"21019","chr7",106981710,106981737,28,8,42,78
"21020","chr7",107205955,107205978,24,8,41,73
"21021","chr7",107316658,107316682,25,29,55,109
"21022","chr7",107414704,107414743,40,42,13,95
"21023","chr7",107507470,107507488,19,38,66,123
"21024","chr7",107580389,107580415,27,91,57,175
"21025","chr7",107602965,107602988,24,77,10,111
"21026","chr7",108046237,108046255,19,20,74,113
"21027","chr7",108526347,108526374,28,99,30,157
"21028","chr7",108738606,108738625,20,72,64,156
"21029","chr7",109241387,109241415,29,77,140,246
"21030","chr7",109948586,109948613,28,76,15,119
"21031","chr7",111702888,111702911,24,76,94,194
"21032","chr7",111925925,111925947,23,79,34,136
"21033","chr7",112678474,112678497,24,76,13,113
"21034","chr7",112902417,112902460,44,114,57,215
"21035","chr7",112939757,112939777,21,61,10,92
"21036","chr7",113018731,113018749,19,7,66,92
"21037","chr7",113631559,113631586,28,76,91,195
"21038","chr7",113700214,113700244,31,69,119,219
"21039","chr7",114017180,114017204,25,108,6,139
"21040","chr7",114086235,114086282,48,6,5,59
"21041","chr7",114328224,114328254,31,8,96,135
"21042","chr7",114676076,114676100,25,27,144,196
"21043","chr7",114678548,114678573,26,35,134,195
"21044","chr7",114922584,114922603,20,67,46,133
"21045","chr7",115660864,115660912,49,97,40,186
"21046","chr7",116862569,116862591,23,28,33,84
"21047","chr7",116953448,116953465,18,119,72,209
"21048","chr7",116953940,116953957,18,3,5,26
"21049","chr7",118857332,118857354,23,145,27,195
"21050","chr7",118887603,118887624,22,55,7,84
"21051","chr7",119313289,119313311,23,109,75,207
"21052","chr7",120273367,120273386,20,129,45,194
"21053","chr7",120642397,120642415,19,80,24,123
"21054","chr7",120857372,120857400,29,29,13,71
"21055","chr7",120950749,120950775,27,94,69,190
"21056","chr7",121683341,121683383,43,129,41,213
"21057","chr7",121872840,121872860,21,18,147,186
"21058","chr7",122640934,122640951,18,125,6,149
"21059","chr7",122673909,122673926,18,35,86,139
"21060","chr7",122809406,122809430,25,77,35,137
"21061","chr7",123443188,123443230,43,29,77,149
"21062","chr7",123748478,123748500,23,84,32,139
"21063","chr7",124447635,124447655,21,57,75,153
"21064","chr7",125562157,125562218,62,42,35,139
"21065","chr7",125818262,125818289,28,8,130,166
"21066","chr7",125891892,125891914,23,113,112,248
"21067","chr7",125962891,125962908,18,78,134,230
"21068","chr7",127252857,127252883,27,19,73,119
"21069","chr7",127630579,127630596,18,8,22,48
"21070","chr7",127691545,127691567,23,63,5,91
"21071","chr7",127691780,127691800,21,7,25,53
"21072","chr7",128361727,128361756,30,64,72,166
"21073","chr7",128557320,128557337,18,76,86,180
"21074","chr7",128557800,128557817,18,104,107,229
"21075","chr7",128601580,128601605,26,76,140,242
"21076","chr7",128622063,128622086,24,7,2,33
"21077","chr7",128746763,128746786,24,8,66,98
"21078","chr7",128825016,128825048,33,30,4,67
"21079","chr7",128890846,128890863,18,135,50,203
"21080","chr7",129034895,129034914,20,69,74,163
"21081","chr7",129070647,129070677,31,8,78,117
"21082","chr7",129087784,129087831,48,8,5,61
"21083","chr7",129153060,129153099,40,128,72,240
"21084","chr7",129189199,129189220,22,24,42,88
"21085","chr7",129193786,129193822,37,17,47,101
"21086","chr7",129221692,129221718,27,75,6,108
"21087","chr7",129227458,129227477,20,102,121,243
"21088","chr7",129299370,129299411,42,76,86,204
"21089","chr7",129349469,129349488,20,63,36,119
"21090","chr7",129524913,129524930,18,77,113,208
"21091","chr7",129550206,129550239,34,70,13,117
"21092","chr7",129611701,129611719,19,6,91,116
"21093","chr7",129612296,129612320,25,64,11,100
"21094","chr7",129625676,129625699,24,76,135,235
"21095","chr7",129683634,129683652,19,10,6,35
"21096","chr7",129696061,129696086,26,137,33,196
"21097","chr7",129779510,129779533,24,20,9,53
"21098","chr7",129784033,129784066,34,37,143,214
"21099","chr7",129784503,129784533,31,69,2,102
"21100","chr7",129809331,129809357,27,135,74,236
"21101","chr7",129930910,129930933,24,144,4,172
"21102","chr7",129993331,129993357,27,20,23,70
"21103","chr7",130024895,130024922,28,7,20,55
"21104","chr7",130031325,130031342,18,97,75,190
"21105","chr7",130052329,130052346,18,27,76,121
"21106","chr7",130068187,130068239,53,71,143,267
"21107","chr7",130078375,130078406,32,73,5,110
"21108","chr7",130107844,130107867,24,79,6,109
"21109","chr7",130108016,130108033,18,31,6,55
"21110","chr7",130108048,130108079,32,77,41,150
"21111","chr7",130512053,130512077,25,138,33,196
"21112","chr7",130519006,130519023,18,15,75,108
"21113","chr7",130734150,130734206,57,44,46,147
"21114","chr7",131071256,131071274,19,25,75,119
"21115","chr7",131110046,131110069,24,39,74,137
"21116","chr7",131133799,131133846,48,7,133,188
"21117","chr7",131137926,131137944,19,77,94,190
"21118","chr7",131157219,131157246,28,25,119,172
"21119","chr7",131217700,131217718,19,9,32,60
"21120","chr7",131221675,131221692,18,27,143,188
"21121","chr7",131221899,131221922,24,7,67,98
"21122","chr7",131222861,131222892,32,76,27,135
"21123","chr7",131233176,131233207,32,128,35,195
"21124","chr7",131271619,131271637,19,144,72,235
"21125","chr7",131510336,131510362,27,78,31,136
"21126","chr7",131556271,131556295,25,25,17,67
"21127","chr7",131556668,131556690,23,16,25,64
"21128","chr7",131556723,131556752,30,2,93,125
"21129","chr7",131578380,131578421,42,6,2,50
"21130","chr7",131593124,131593167,44,114,24,182
"21131","chr7",131991431,131991451,21,148,27,196
"21132","chr7",132509161,132509193,33,111,98,242
"21133","chr7",132576295,132576312,18,52,42,112
"21134","chr7",132577370,132577435,66,3,45,114
"21135","chr7",132930164,132930183,20,7,90,117
"21136","chr7",134147262,134147284,23,144,22,189
"21137","chr7",134256460,134256480,21,130,72,223
"21138","chr7",134293793,134293810,18,76,34,128
"21139","chr7",134549383,134549415,33,139,10,182
"21140","chr7",134646898,134646922,25,34,95,154
"21141","chr7",135015859,135015881,23,77,27,127
"21142","chr7",135212412,135212433,22,13,34,69
"21143","chr7",135212716,135212736,21,145,5,171
"21144","chr7",135320021,135320068,48,13,56,117
"21145","chr7",135504463,135504504,42,8,143,193
"21146","chr7",135513851,135513877,27,64,5,96
"21147","chr7",135666348,135666365,18,7,30,55
"21148","chr7",135739311,135739328,18,11,73,102
"21149","chr7",136424602,136424624,23,75,57,155
"21150","chr7",136739905,136739924,20,4,73,97
"21151","chr7",137194004,137194026,23,27,23,73
"21152","chr7",137662241,137662259,19,6,127,152
"21153","chr7",137846770,137846790,21,1,14,36
"21154","chr7",138008338,138008360,23,8,98,129
"21155","chr7",138155611,138155634,24,35,6,65
"21156","chr7",138258542,138258559,18,92,12,122
"21157","chr7",138260166,138260184,19,5,34,58
"21158","chr7",138320875,138320892,18,66,136,220
"21159","chr7",138455341,138455358,18,66,6,90
"21160","chr7",138461135,138461152,18,55,25,98
"21161","chr7",138869837,138869867,31,76,116,223
"21162","chr7",138981540,138981569,30,21,12,63
"21163","chr7",139104722,139104746,25,138,74,237
"21164","chr7",139105033,139105063,31,144,73,248
"21165","chr7",139126157,139126207,51,82,33,166
"21166","chr7",139195483,139195501,19,10,61,90
"21167","chr7",139196162,139196182,21,118,140,279
"21168","chr7",139275278,139275299,22,11,74,107
"21169","chr7",139332185,139332239,55,138,5,198
"21170","chr7",139377826,139377847,22,88,11,121
"21171","chr7",139433319,139433346,28,11,62,101
"21172","chr7",139433626,139433644,19,27,10,56
"21173","chr7",139450218,139450242,25,9,67,101
"21174","chr7",139486705,139486744,40,36,27,103
"21175","chr7",139522698,139522720,23,145,6,174
"21176","chr7",139777806,139777836,31,9,125,165
"21177","chr7",139778037,139778077,41,65,68,174
"21178","chr7",139859200,139859219,20,71,120,211
"21179","chr7",140003212,140003235,24,89,16,129
"21180","chr7",140176345,140176376,32,1,58,91
"21181","chr7",140267359,140267386,28,51,6,85
"21182","chr7",140396883,140396907,25,135,21,181
"21183","chr7",140398737,140398763,27,51,16,94
"21184","chr7",140407881,140407906,26,19,129,174
"21185","chr7",140407977,140408000,24,113,33,170
"21186","chr7",140444573,140444591,19,27,73,119
"21187","chr7",140470586,140470629,44,7,42,93
"21188","chr7",140511057,140511089,33,47,71,151
"21189","chr7",140515017,140515034,18,28,16,62
"21190","chr7",140542566,140542587,22,81,72,175
"21191","chr7",140583308,140583335,28,14,75,117
"21192","chr7",140640100,140640166,67,7,107,181
"21193","chr7",140662185,140662205,21,98,23,142
"21194","chr7",140673118,140673140,23,44,32,99
"21195","chr7",140879551,140879570,20,38,74,132
"21196","chr7",140906088,140906108,21,67,6,94
"21197","chr7",140924604,140924625,22,57,74,153
"21198","chr7",140924758,140924803,46,58,2,106
"21199","chr7",140950510,140950532,23,78,85,186
"21200","chr7",141125680,141125714,35,112,7,154
"21201","chr7",141292635,141292655,21,8,44,73
"21202","chr7",141701604,141701630,27,20,24,71
"21203","chr7",142101918,142101941,24,40,64,128
"21204","chr7",142598793,142598813,21,72,41,134
"21205","chr7",143288336,143288354,19,64,110,193
"21206","chr7",143362766,143362796,31,53,8,92
"21207","chr7",143382972,143382994,23,67,50,140
"21208","chr7",143388666,143388699,34,119,5,158
"21209","chr7",143413944,143413980,37,9,97,143
"21210","chr7",143546333,143546351,19,63,136,218
"21211","chr7",143783104,143783127,24,138,61,223
"21212","chr7",143882194,143882219,26,3,115,144
"21213","chr7",143939913,143939930,18,41,75,134
"21214","chr7",143950736,143950768,33,6,138,177
"21215","chr7",144196153,144196179,27,3,12,42
"21216","chr7",144294733,144294759,27,3,12,42
"21217","chr7",144354827,144354886,60,14,4,78
"21218","chr7",144403782,144403800,19,47,86,152
"21219","chr7",144403824,144403848,25,95,44,164
"21220","chr7",144492417,144492441,25,53,34,112
"21221","chr7",145148972,145149012,41,26,8,75
"21222","chr7",145635074,145635104,31,6,44,81
"21223","chr7",145777532,145777564,33,7,141,181
"21224","chr7",146116098,146116138,41,4,66,111
"21225","chr7",146116215,146116239,25,56,134,215
"21226","chr7",146370261,146370289,29,145,76,250
"21227","chr7",146842995,146843023,29,121,1,151
"21228","chr7",147081584,147081628,45,31,75,151
"21229","chr7",147093073,147093092,20,146,21,187
"21230","chr7",147219943,147219962,20,29,75,124
"21231","chr7",147482721,147482761,41,76,6,123
"21232","chr7",148022469,148022500,32,72,74,178
"21233","chr7",148235686,148235704,19,77,115,211
"21234","chr7",148657015,148657034,20,78,1,99
"21235","chr7",148661968,148661993,26,8,68,102
"21236","chr7",148699065,148699083,19,37,2,58
"21237","chr7",148884202,148884231,30,107,9,146
"21238","chr7",148938797,148938815,19,72,29,120
"21239","chr7",149021489,149021511,23,111,6,140
"21240","chr7",149064962,149064995,34,78,110,222
"21241","chr7",149077630,149077652,23,128,72,223
"21242","chr7",149091051,149091091,41,28,13,82
"21243","chr7",149092173,149092202,30,9,13,52
"21244","chr7",149123836,149123858,23,69,6,98
"21245","chr7",149167616,149167652,37,32,93,162
"21246","chr7",149173094,149173122,29,52,106,187
"21247","chr7",149189116,149189148,33,32,119,184
"21248","chr7",149194193,149194217,25,69,133,227
"21249","chr7",149217381,149217414,34,77,55,166
"21250","chr7",149239672,149239690,19,26,17,62
"21251","chr7",149244300,149244325,26,3,27,56
"21252","chr7",149263266,149263305,40,44,62,146
"21253","chr7",149263305,149263325,21,64,23,108
"21254","chr7",149421859,149421878,20,16,74,110
"21255","chr7",149497865,149497893,29,81,7,117
"21256","chr7",149772131,149772156,26,142,29,197
"21257","chr7",149773486,149773527,42,58,10,110
"21258","chr7",150047665,150047688,24,12,22,58
"21259","chr7",150072700,150072721,22,137,45,204
"21260","chr7",150100698,150100720,23,74,20,117
"21261","chr7",150375749,150375776,28,48,12,88
"21262","chr7",150421831,150421853,23,137,1,161
"21263","chr7",150802078,150802137,60,100,64,224
"21264","chr7",150860177,150860204,28,17,8,53
"21265","chr7",150862557,150862574,18,100,82,200
"21266","chr7",150977952,150977969,18,12,106,136
"21267","chr7",150978892,150978981,90,16,3,109
"21268","chr7",151051581,151051600,20,51,53,124
"21269","chr7",151059515,151059542,28,27,131,186
"21270","chr7",151066529,151066554,26,1,12,39
"21271","chr7",151081661,151081698,38,111,8,157
"21272","chr7",151086658,151086707,50,58,73,181
"21273","chr7",151090381,151090405,25,125,87,237
"21274","chr7",151114693,151114733,41,2,3,46
"21275","chr7",151167159,151167186,28,29,2,59
"21276","chr7",151617249,151617320,72,113,18,203
"21277","chr7",151618454,151618479,26,147,5,178
"21278","chr7",151823024,151823045,22,72,90,184
"21279","chr7",151839013,151839031,19,87,76,182
"21280","chr7",151875563,151875614,52,2,77,131
"21281","chr7",151876066,151876095,30,34,2,66
"21282","chr7",151877796,151877824,29,10,16,55
"21283","chr7",151944357,151944377,21,4,104,129
"21284","chr7",152091041,152091060,20,72,70,162
"21285","chr7",152091228,152091249,22,67,61,150
"21286","chr7",152099343,152099385,43,80,44,167
"21287","chr7",152331608,152331637,30,47,76,153
"21288","chr7",152331643,152331667,25,77,41,143
"21289","chr7",152391544,152391564,21,19,145,185
"21290","chr7",152423018,152423048,31,137,73,241
"21291","chr7",152435461,152435487,27,40,84,151
"21292","chr7",152435838,152435865,28,79,24,131
"21293","chr7",152436019,152436106,88,11,19,118
"21294","chr7",152436749,152436775,27,34,106,167
"21295","chr7",152439616,152439639,24,14,6,44
"21296","chr7",152453342,152453362,21,80,99,200
"21297","chr7",152507513,152507551,39,93,74,206
"21298","chr7",152512516,152512546,31,129,74,234
"21299","chr7",152544340,152544360,21,115,75,211
"21300","chr7",152592764,152592793,30,113,109,252
"21301","chr7",152598410,152598433,24,76,146,246
"21302","chr7",152611015,152611036,22,19,71,112
"21303","chr7",152701147,152701164,18,11,73,102
"21304","chr7",152705987,152706016,30,75,27,132
"21305","chr7",152737435,152737462,28,77,79,184
"21306","chr7",152750771,152750799,29,77,35,141
"21307","chr7",152796861,152796898,38,36,135,209
"21308","chr7",152910175,152910192,18,27,3,48
"21309","chr7",152936349,152936372,24,81,127,232
"21310","chr7",153440793,153440815,23,136,99,258
"21311","chr7",153536953,153536975,23,19,17,59
"21312","chr7",153999961,153999983,23,17,72,112
"21313","chr7",154052688,154052708,21,97,38,156
"21314","chr7",154052987,154053007,21,54,48,123
"21315","chr7",154222657,154222688,32,102,4,138
"21316","chr7",154305019,154305087,69,43,57,169
"21317","chr7",154802837,154802854,18,80,74,172
"21318","chr7",154906530,154906549,20,8,69,97
"21319","chr7",155002773,155002817,45,3,38,86
"21320","chr7",155002963,155002997,35,95,130,260
"21321","chr7",155003087,155003111,25,5,6,36
"21322","chr7",155150511,155150541,31,126,67,224
"21323","chr7",155173540,155173566,27,23,6,56
"21324","chr7",155226144,155226182,39,80,125,244
"21325","chr7",155231575,155231603,29,18,138,185
"21326","chr7",155255603,155255660,58,51,99,208
"21327","chr7",155255612,155255755,144,146,90,380
"21328","chr7",155356182,155356208,27,24,23,74
"21329","chr7",155467834,155467865,32,36,21,89
"21330","chr7",155788333,155788351,19,77,27,123
"21331","chr7",155788501,155788527,27,26,6,59
"21332","chr7",155789635,155789672,38,75,7,120
"21333","chr7",155824537,155824562,26,19,32,77
"21334","chr7",156080060,156080084,25,39,45,109
"21335","chr7",156709897,156709922,26,8,48,82
"21336","chr7",156893208,156893229,22,58,24,104
"21337","chr7",156948637,156948658,22,10,48,80
"21338","chr7",156986876,156986912,37,15,74,126
"21339","chr7",157000581,157000599,19,70,10,99
"21340","chr7",157003569,157003596,28,24,32,84
"21341","chr7",157009950,157009984,35,66,11,112
"21342","chr7",157010036,157010053,18,51,6,75
"21343","chr7",157010193,157010221,29,145,26,200
"21344","chr7",157021061,157021086,26,118,121,265
"21345","chr7",157131049,157131163,115,9,116,240
"21346","chr7",157131163,157131189,27,35,2,64
"21347","chr7",157291380,157291397,18,7,6,31
"21348","chr7",157306076,157306100,25,144,3,172
"21349","chr7",157306252,157306271,20,114,5,139
"21350","chr7",157336535,157336557,23,63,37,123
"21351","chr7",157337341,157337372,32,27,7,66
"21352","chr7",157413719,157413742,24,39,66,129
"21353","chr7",157585729,157585751,23,35,41,99
"21354","chr7",157684569,157684613,45,3,30,78
"21355","chr7",157789613,157790317,705,40,37,782
"21356","chr7",158094307,158094327,21,76,77,174
"21357","chr7",158226674,158226691,18,149,50,217
"21358","chr7",158587624,158587652,29,2,67,98
"21359","chr7",158587828,158587856,29,12,6,47
"21360","chr7",158669769,158669796,28,11,6,45
"21361","chr7",158711432,158711456,25,142,6,173
"21362","chr7",158712601,158712626,26,76,93,195
"21363","chr7",158842027,158842045,19,7,59,85
"21364","chr7",158881442,158881470,29,7,25,61
"21365","chr7",158972523,158972544,22,44,99,165
"21366","chr7",159190809,159190831,23,134,74,231
"21367","chr8",206386,206410,25,38,29,92
"21368","chr8",326918,326947,30,68,50,148
"21369","chr8",358396,358434,39,6,42,87
"21370","chr8",512257,512275,19,69,40,128
"21371","chr8",544659,544686,28,12,104,144
"21372","chr8",688272,688313,42,46,55,143
"21373","chr8",737686,737711,26,8,2,36
"21374","chr8",738675,738711,37,6,16,59
"21375","chr8",738995,739014,20,20,11,51
"21376","chr8",785222,785252,31,12,1,44
"21377","chr8",862300,862317,18,73,17,108
"21378","chr8",902749,902766,18,88,90,196
"21379","chr8",1437814,1437836,23,145,27,195
"21380","chr8",1548459,1548484,26,42,6,74
"21381","chr8",1577568,1577590,23,22,74,119
"21382","chr8",1595674,1595691,18,136,67,221
"21383","chr8",1744956,1744978,23,91,73,187
"21384","chr8",1764358,1764375,18,118,12,148
"21385","chr8",1798022,1798054,33,125,147,305
"21386","chr8",1803329,1803347,19,81,75,175
"21387","chr8",1832312,1833483,1172,141,62,1375
"21388","chr8",1908228,1908248,21,76,118,215
"21389","chr8",1950699,1950751,53,27,76,156
"21390","chr8",1974079,1974145,67,5,20,92
"21391","chr8",2182199,2182246,48,48,11,107
"21392","chr8",3136244,3136267,24,76,55,155
"21393","chr8",3466578,3466599,22,26,74,122
"21394","chr8",3725500,3725528,29,12,124,165
"21395","chr8",3968005,3968027,23,67,34,124
"21396","chr8",4453815,4453839,25,8,81,114
"21397","chr8",4561374,4561396,23,75,124,222
"21398","chr8",4713375,4713418,44,43,96,183
"21399","chr8",4993379,4993410,32,117,50,199
"21400","chr8",5737256,5737311,56,72,35,163
"21401","chr8",6261587,6261609,23,76,58,157
"21402","chr8",6281477,6281494,18,82,26,126
"21403","chr8",6281638,6281668,31,23,75,129
"21404","chr8",6314550,6314572,23,5,129,157
"21405","chr8",6346224,6346260,37,65,68,170
"21406","chr8",6347613,6347634,22,8,48,78
"21407","chr8",6504318,6504337,20,27,6,53
"21408","chr8",6593082,6593101,20,8,34,62
"21409","chr8",6656109,6656130,22,112,73,207
"21410","chr8",6678870,6678986,117,1,5,123
"21411","chr8",6868837,6868860,24,33,78,135
"21412","chr8",6954858,6954882,25,8,108,141
"21413","chr8",7086596,7086615,20,77,145,242
"21414","chr8",7608414,7608440,27,125,34,186
"21415","chr8",8056402,8056428,27,125,34,186
"21416","chr8",8247252,8247301,50,113,76,239
"21417","chr8",8284100,8284127,28,145,33,206
"21418","chr8",8318844,8318885,42,92,9,143
"21419","chr8",8377353,8377379,27,7,6,40
"21420","chr8",8667893,8667910,18,107,6,131
"21421","chr8",8677715,8677733,19,82,61,162
"21422","chr8",8897425,8897450,26,89,74,189
"21423","chr8",9005505,9005532,28,16,56,100
"21424","chr8",9278070,9278089,20,76,68,164
"21425","chr8",9369950,9369967,18,100,103,221
"21426","chr8",9387925,9387943,19,77,32,128
"21427","chr8",9415614,9415637,24,71,70,165
"21428","chr8",9419942,9420010,69,21,22,112
"21429","chr8",9439611,9439632,22,78,26,126
"21430","chr8",9515165,9515189,25,70,139,234
"21431","chr8",9703014,9703043,30,78,76,184
"21432","chr8",9735801,9735828,28,21,73,122
"21433","chr8",9828159,9828181,23,127,142,292
"21434","chr8",9905566,9905601,36,68,94,198
"21435","chr8",9932887,9932919,33,18,80,131
"21436","chr8",10199313,10199339,27,78,128,233
"21437","chr8",10269644,10269669,26,8,47,81
"21438","chr8",10358566,10358610,45,8,44,97
"21439","chr8",10547732,10547750,19,132,2,153
"21440","chr8",10990896,10990919,24,75,132,231
"21441","chr8",11004477,11004506,30,146,1,177
"21442","chr8",11038025,11038042,18,62,8,88
"21443","chr8",11125089,11125124,36,37,6,79
"21444","chr8",11201205,11201231,27,22,140,189
"21445","chr8",11249326,11249369,44,16,35,95
"21446","chr8",11411271,11411307,37,30,76,143
"21447","chr8",11710689,11710714,26,22,75,123
"21448","chr8",11842937,11842959,23,69,145,237
"21449","chr8",11898722,11898744,23,75,52,150
"21450","chr8",11922316,11922338,23,5,102,130
"21451","chr8",12034481,12034498,18,138,108,264
"21452","chr8",12375952,12375998,47,149,72,268
"21453","chr8",12544330,12544351,22,76,61,159
"21454","chr8",12618757,12618777,21,73,35,129
"21455","chr8",12668525,12668547,23,33,123,179
"21456","chr8",12807164,12807199,36,138,70,244
"21457","chr8",12847650,12847670,21,147,70,238
"21458","chr8",13053968,13053986,19,7,97,123
"21459","chr8",13326940,13326970,31,6,20,57
"21460","chr8",13327121,13327146,26,29,144,199
"21461","chr8",13412932,13412954,23,147,6,176
"21462","chr8",13905908,13905937,30,37,66,133
"21463","chr8",14079522,14079551,30,91,32,153
"21464","chr8",14177676,14177697,22,29,76,127
"21465","chr8",14177944,14177975,32,8,25,65
"21466","chr8",14239902,14239936,35,39,6,80
"21467","chr8",15243510,15243528,19,144,74,237
"21468","chr8",15483650,15483673,24,8,1,33
"21469","chr8",15788547,15788564,18,80,6,104
"21470","chr8",15885625,15885670,46,77,34,157
"21471","chr8",16702679,16702703,25,77,27,129
"21472","chr8",17497025,17497051,27,10,69,106
"21473","chr8",17801486,17801509,24,16,12,52
"21474","chr8",17923989,17924011,23,5,4,32
"21475","chr8",18117369,18117399,31,75,100,206
"21476","chr8",18768117,18768137,21,78,25,124
"21477","chr8",18930570,18930588,19,77,14,110
"21478","chr8",18970325,18970362,38,115,6,159
"21479","chr8",19071711,19071728,18,9,37,64
"21480","chr8",19262313,19262339,27,61,91,179
"21481","chr8",20196737,20196762,26,135,4,165
"21482","chr8",20275405,20275422,18,107,71,196
"21483","chr8",20303978,20304029,52,14,9,75
"21484","chr8",20304886,20304928,43,80,23,146
"21485","chr8",20794209,20794229,21,36,6,63
"21486","chr8",21024150,21024188,39,9,10,58
"21487","chr8",21459608,21459662,55,34,68,157
"21488","chr8",21728266,21728292,27,8,139,174
"21489","chr8",21789101,21789134,34,1,12,47
"21490","chr8",21795354,21795406,53,117,35,205
"21491","chr8",21919676,21919710,35,115,6,156
"21492","chr8",21933097,21933118,22,8,79,109
"21493","chr8",21954638,21954673,36,144,70,250
"21494","chr8",22048671,22048689,19,55,1,75
"21495","chr8",22049069,22049089,21,17,57,95
"21496","chr8",22089010,22089029,20,5,36,61
"21497","chr8",22101008,22101031,24,67,31,122
"21498","chr8",22187498,22187522,25,29,76,130
"21499","chr8",22223361,22223381,21,82,7,110
"21500","chr8",22294337,22294358,22,12,75,109
"21501","chr8",22320260,22320281,22,72,146,240
"21502","chr8",22322917,22322934,18,75,41,134
"21503","chr8",22323144,22323165,22,76,16,114
"21504","chr8",22396386,22396599,214,20,55,289
"21505","chr8",22432646,22432664,19,7,143,169
"21506","chr8",22439149,22439175,27,57,135,219
"21507","chr8",22551860,22551879,20,15,31,66
"21508","chr8",22599694,22599712,19,36,127,182
"21509","chr8",22692648,22692717,70,35,8,113
"21510","chr8",22694975,22694993,19,120,57,196
"21511","chr8",22695553,22695572,20,7,5,32
"21512","chr8",22761236,22761264,29,70,131,230
"21513","chr8",22844236,22844255,20,74,17,111
"21514","chr8",22865357,22865391,35,53,81,169
"21515","chr8",23031376,23031413,38,17,145,200
"21516","chr8",23124610,23124627,18,27,4,49
"21517","chr8",23131484,23131512,29,75,141,245
"21518","chr8",23163090,23163116,27,4,74,105
"21519","chr8",23163417,23163443,27,114,131,272
"21520","chr8",23172790,23172813,24,25,22,71
"21521","chr8",23225479,23225500,22,8,128,158
"21522","chr8",23226492,23226509,18,73,73,164
"21523","chr8",23234902,23234920,19,12,4,35
"21524","chr8",23352994,23353052,59,51,96,206
"21525","chr8",23548478,23548496,19,16,145,180
"21526","chr8",23553421,23553452,32,92,74,198
"21527","chr8",23682701,23682727,27,3,37,67
"21528","chr8",23708095,23708114,20,139,52,211
"21529","chr8",23748160,23748186,27,76,25,128
"21530","chr8",24579144,24579178,35,94,71,200
"21531","chr8",24628069,24628098,30,8,142,180
"21532","chr8",24740661,24740696,36,40,66,142
"21533","chr8",24942855,24942878,24,7,101,132
"21534","chr8",24980255,24980275,21,54,86,161
"21535","chr8",25184729,25184756,28,2,25,55
"21536","chr8",25190777,25190801,25,76,93,194
"21537","chr8",25239305,25239370,66,63,141,270
"21538","chr8",25662483,25662506,24,122,75,221
"21539","chr8",25858652,25858677,26,7,114,147
"21540","chr8",26007797,26007827,31,38,79,148
"21541","chr8",26018497,26018521,25,77,27,129
"21542","chr8",26119828,26119851,24,34,76,134
"21543","chr8",26203346,26203365,20,8,35,63
"21544","chr8",26211162,26211185,24,74,100,198
"21545","chr8",26290861,26290886,26,74,62,162
"21546","chr8",26383527,26383549,23,69,31,123
"21547","chr8",26601364,26601395,32,8,103,143
"21548","chr8",26656175,26656192,18,57,133,208
"21549","chr8",27165490,27165509,20,144,82,246
"21550","chr8",27520334,27520353,20,65,129,214
"21551","chr8",27593373,27593427,55,31,45,131
"21552","chr8",27628293,27628314,22,13,19,54
"21553","chr8",27712563,27712581,19,83,6,108
"21554","chr8",27759609,27759630,22,77,74,173
"21555","chr8",27759780,27759799,20,80,74,174
"21556","chr8",27774828,27774847,20,143,102,265
"21557","chr8",28386490,28386508,19,12,56,87
"21558","chr8",28404886,28404915,30,30,6,66
"21559","chr8",28427343,28427385,43,37,72,152
"21560","chr8",28444780,28444804,25,29,145,199
"21561","chr8",28660839,28660865,27,10,28,65
"21562","chr8",28701618,28701640,23,6,9,38
"21563","chr8",29103242,29103259,18,11,119,148
"21564","chr8",29118328,29118345,18,77,97,192
"21565","chr8",29161715,29161742,28,65,55,148
"21566","chr8",29291092,29291119,28,75,145,248
"21567","chr8",29291274,29291297,24,114,71,209
"21568","chr8",29529226,29529251,26,115,11,152
"21569","chr8",29782326,29782352,27,33,61,121
"21570","chr8",30049784,30049813,30,2,78,110
"21571","chr8",30282151,30282180,30,122,20,172
"21572","chr8",30384459,30384501,43,121,41,205
"21573","chr8",30423819,30423852,34,5,7,46
"21574","chr8",30497598,30497634,37,76,72,185
"21575","chr8",30519651,30519669,19,28,143,190
"21576","chr8",30658138,30658169,32,81,45,158
"21577","chr8",30780329,30780346,18,135,38,191
"21578","chr8",30984322,30984345,24,76,87,187
"21579","chr8",31033161,31033205,45,43,53,141
"21580","chr8",31149456,31149491,36,7,15,58
"21581","chr8",31276700,31276717,18,77,58,153
"21582","chr8",31294994,31295023,30,5,4,39
"21583","chr8",31819055,31819073,19,130,8,157
"21584","chr8",32536923,32536949,27,39,7,73
"21585","chr8",32548858,32548892,35,23,12,70
"21586","chr8",32971118,32971152,35,74,32,141
"21587","chr8",33074960,33074981,22,75,119,216
"21588","chr8",33331664,33331689,26,4,29,59
"21589","chr8",33360015,33360059,45,48,65,158
"21590","chr8",33502825,33502847,23,13,120,156
"21591","chr8",33509133,33509151,19,42,84,145
"21592","chr8",33540533,33540553,21,76,105,202
"21593","chr8",33571921,33571941,21,74,77,172
"21594","chr8",33646332,33646357,26,27,6,59
"21595","chr8",33999743,33999779,37,24,67,128
"21596","chr8",34018794,34018811,18,8,101,127
"21597","chr8",34784702,34784728,27,9,23,59
"21598","chr8",35132776,35132797,22,9,85,116
"21599","chr8",35310624,35310650,27,34,2,63
"21600","chr8",35507045,35507073,29,8,21,58
"21601","chr8",35544596,35544620,25,76,52,153
"21602","chr8",35711169,35711198,30,77,12,119
"21603","chr8",35823940,35823963,24,47,140,211
"21604","chr8",35823963,35823981,19,65,117,201
"21605","chr8",36309972,36309995,24,94,61,179
"21606","chr8",36321800,36321825,26,119,74,219
"21607","chr8",36826183,36826225,43,74,83,200
"21608","chr8",36835332,36835360,29,73,110,212
"21609","chr8",37121929,37121951,23,108,27,158
"21610","chr8",37311861,37311879,19,116,81,216
"21611","chr8",37582231,37582262,32,107,60,199
"21612","chr8",37677074,37677115,42,79,41,162
"21613","chr8",37695353,37695383,31,25,40,96
"21614","chr8",37695808,37695834,27,54,25,106
"21615","chr8",37696023,37696048,26,23,42,91
"21616","chr8",37698416,37698443,28,63,98,189
"21617","chr8",37793108,37793127,20,8,59,87
"21618","chr8",37828641,37828658,18,68,88,174
"21619","chr8",37838251,37838271,21,10,42,73
"21620","chr8",37868423,37868446,24,138,73,235
"21621","chr8",37873853,37873891,39,24,4,67
"21622","chr8",37876195,37876216,22,33,6,61
"21623","chr8",37895219,37895260,42,92,120,254
"21624","chr8",37895260,37895293,34,125,79,238
"21625","chr8",37898652,37898670,19,21,7,47
"21626","chr8",37898821,37898839,19,11,5,35
"21627","chr8",37899609,37899642,34,112,48,194
"21628","chr8",37936117,37936134,18,14,48,80
"21629","chr8",37936133,37936159,27,39,32,98
"21630","chr8",37967324,37967357,34,67,73,174
"21631","chr8",38035521,38035547,27,50,7,84
"21632","chr8",38102831,38102855,25,76,15,116
"21633","chr8",38175026,38175061,36,39,72,147
"21634","chr8",38292788,38292811,24,66,75,165
"21635","chr8",38382005,38382022,18,42,9,69
"21636","chr8",38382228,38382259,32,28,53,113
"21637","chr8",38432411,38432430,20,76,81,177
"21638","chr8",38442363,38442395,33,102,18,153
"21639","chr8",38443497,38443523,27,77,33,137
"21640","chr8",38462903,38462923,21,37,11,69
"21641","chr8",38475327,38475350,24,58,58,140
"21642","chr8",38485542,38485560,19,141,64,224
"21643","chr8",38507900,38508019,120,21,76,217
"21644","chr8",38507913,38508035,123,37,63,223
"21645","chr8",38513736,38513759,24,15,6,45
"21646","chr8",38518131,38518148,18,114,143,275
"21647","chr8",38542565,38542595,31,35,46,112
"21648","chr8",38928237,38928262,26,40,113,179
"21649","chr8",38931273,38931295,23,90,11,124
"21650","chr8",38978994,38979011,18,72,74,164
"21651","chr8",39130957,39130974,18,76,117,211
"21652","chr8",39623575,39623614,40,8,22,70
"21653","chr8",40259036,40259055,20,147,74,241
"21654","chr8",40334403,40334422,20,145,27,192
"21655","chr8",40613181,40613200,20,8,75,103
"21656","chr8",40626113,40626130,18,11,71,100
"21657","chr8",40807444,40807461,18,52,4,74
"21658","chr8",40833541,40833558,18,42,101,161
"21659","chr8",40909397,40909440,44,29,143,216
"21660","chr8",41056839,41056861,23,77,83,183
"21661","chr8",41175975,41175992,18,8,99,125
"21662","chr8",41197886,41197931,46,30,33,109
"21663","chr8",41341345,41341373,29,104,75,208
"21664","chr8",41435392,41435427,36,34,30,100
"21665","chr8",41650989,41651007,19,56,33,108
"21666","chr8",41651007,41651029,23,78,15,116
"21667","chr8",41660607,41660625,19,90,76,185
"21668","chr8",41683079,41683128,50,76,65,191
"21669","chr8",41767267,41767313,47,35,90,172
"21670","chr8",41798036,41798058,23,17,29,69
"21671","chr8",41838768,41838793,26,146,71,243
"21672","chr8",41896787,41896804,18,37,13,68
"21673","chr8",42051391,42051429,39,58,6,103
"21674","chr8",42171877,42171898,22,124,6,152
"21675","chr8",42195110,42195130,21,91,37,149
"21676","chr8",42225264,42225297,34,8,85,127
"21677","chr8",42276861,42276884,24,76,143,243
"21678","chr8",42328248,42328268,21,95,7,123
"21679","chr8",42333470,42333488,19,8,14,41
"21680","chr8",42359522,42359544,23,36,75,134
"21681","chr8",42413224,42413242,19,44,31,94
"21682","chr8",42414647,42414669,23,131,4,158
"21683","chr8",42476085,42476114,30,6,135,171
"21684","chr8",42490596,42490613,18,3,7,28
"21685","chr8",42520009,42520031,23,76,97,196
"21686","chr8",42541761,42541790,30,22,22,74
"21687","chr8",42649008,42649036,29,17,6,52
"21688","chr8",42691951,42691977,27,20,79,126
"21689","chr8",42735219,42735247,29,139,7,175
"21690","chr8",42785774,42785821,48,119,61,228
"21691","chr8",42785821,42785843,23,141,14,178
"21692","chr8",42789264,42789298,35,81,22,138
"21693","chr8",42818580,42818640,61,74,3,138
"21694","chr8",42896741,42896786,46,60,60,166
"21695","chr8",42904307,42904327,21,76,140,237
"21696","chr8",42951505,42951522,18,10,2,30
"21697","chr8",43008627,43008677,51,8,1,60
"21698","chr8",43041018,43041045,28,8,102,138
"21699","chr8",43067896,43067918,23,77,65,165
"21700","chr8",43090821,43090842,22,140,108,270
"21701","chr8",43094078,43094110,33,64,6,103
"21702","chr8",43141289,43141312,24,94,86,204
"21703","chr8",43923585,43923621,37,94,82,213
"21704","chr8",46669070,46669105,36,6,88,130
"21705","chr8",47389689,47389711,23,12,74,109
"21706","chr8",47574604,47574637,34,78,25,137
"21707","chr8",47761994,47762030,37,14,9,60
"21708","chr8",47763673,47764235,563,67,98,728
"21709","chr8",48035108,48035132,25,75,20,120
"21710","chr8",48069311,48069335,25,6,124,155
"21711","chr8",48655428,48655461,34,75,2,111
"21712","chr8",49382821,49382845,25,93,17,135
"21713","chr8",49401376,49401399,24,54,76,154
"21714","chr8",49465181,49465212,32,7,74,113
"21715","chr8",50236451,50236468,18,8,71,97
"21716","chr8",50338139,50338167,29,67,3,99
"21717","chr8",50849184,50849201,18,23,38,79
"21718","chr8",51608401,51608432,32,24,62,118
"21719","chr8",51761026,51761046,21,29,75,125
"21720","chr8",51777905,51777927,23,20,72,115
"21721","chr8",51937124,51937160,37,65,4,106
"21722","chr8",52218555,52218579,25,35,75,135
"21723","chr8",52367237,52367270,34,75,20,129
"21724","chr8",52389927,52389953,27,49,17,93
"21725","chr8",53251650,53251669,20,41,62,123
"21726","chr8",53286778,53286805,28,82,74,184
"21727","chr8",53693095,53693118,24,28,61,113
"21728","chr8",53850544,53850573,30,7,72,109
"21729","chr8",53952059,53952077,19,58,32,109
"21730","chr8",53958136,53958191,56,57,6,119
"21731","chr8",54022277,54022302,26,9,4,39
"21732","chr8",54084142,54084164,23,22,3,48
"21733","chr8",54103153,54103179,27,87,20,134
"21734","chr8",54135571,54135594,24,60,10,94
"21735","chr8",54140565,54140591,27,8,7,42
"21736","chr8",54142152,54142171,20,75,10,105
"21737","chr8",54152264,54152287,24,27,141,192
"21738","chr8",54177153,54177197,45,26,4,75
"21739","chr8",54446904,54446938,35,76,72,183
"21740","chr8",54459699,54459727,29,101,2,132
"21741","chr8",54555263,54555464,202,37,62,301
"21742","chr8",54913715,54913732,18,11,7,36
"21743","chr8",55102667,55102692,26,98,121,245
"21744","chr8",55135890,55135912,23,77,20,120
"21745","chr8",55217242,55217259,18,23,6,47
"21746","chr8",55455259,55455281,23,149,91,263
"21747","chr8",55611778,55611799,22,76,11,109
"21748","chr8",55773239,55773257,19,1,61,81
"21749","chr8",55819289,55819313,25,7,92,124
"21750","chr8",55824124,55824141,18,28,66,112
"21751","chr8",55911066,55911286,221,16,73,310
"21752","chr8",55977186,55977211,26,144,5,175
"21753","chr8",56082357,56082376,20,75,59,154
"21754","chr8",56084794,56084824,31,96,143,270
"21755","chr8",56194577,56194646,70,52,120,242
"21756","chr8",56993637,56993664,28,100,111,239
"21757","chr8",57354827,57354844,18,42,6,66
"21758","chr8",58426203,58426224,22,8,78,108
"21759","chr8",58734398,58734419,22,77,93,192
"21760","chr8",59009308,59009354,47,40,91,178
"21761","chr8",59009352,59009387,36,73,47,156
"21762","chr8",59547389,59547413,25,26,44,95
"21763","chr8",60121969,60121990,22,72,24,118
"21764","chr8",60516829,60516850,22,57,59,138
"21765","chr8",60577793,60577815,23,29,73,125
"21766","chr8",60658231,60658281,51,143,5,199
"21767","chr8",60675166,60675188,23,145,28,196
"21768","chr8",60678639,60678672,34,90,15,139
"21769","chr8",60678765,60678812,48,37,60,145
"21770","chr8",60679118,60679138,21,7,51,79
"21771","chr8",60679152,60679169,18,38,17,73
"21772","chr8",60679653,60679676,24,79,6,109
"21773","chr8",60680409,60680432,24,4,37,65
"21774","chr8",60812735,60812766,32,13,3,48
"21775","chr8",60998742,60998760,19,61,78,158
"21776","chr8",61539700,61539741,42,2,71,115
"21777","chr8",61706405,61706429,25,50,85,160
"21778","chr8",61706428,61706515,88,136,62,286
"21779","chr8",61809282,61809304,23,148,118,289
"21780","chr8",62248656,62248680,25,149,18,192
"21781","chr8",63038998,63039023,26,102,60,188
"21782","chr8",63059768,63059785,18,88,147,253
"21783","chr8",63059779,63059799,21,102,136,259
"21784","chr8",63112201,63112223,23,75,45,143
"21785","chr8",63188679,63188702,24,47,6,77
"21786","chr8",63576933,63576970,38,71,8,117
"21787","chr8",63576938,63576999,62,100,3,165
"21788","chr8",64194629,64194656,28,37,75,140
"21789","chr8",64369227,64369274,48,17,118,183
"21790","chr8",64450192,64450210,19,114,143,276
"21791","chr8",64581061,64581080,20,38,40,98
"21792","chr8",64581434,64581461,28,65,18,111
"21793","chr8",64581464,64581493,30,97,66,193
"21794","chr8",64880106,64880129,24,6,79,109
"21795","chr8",65632615,65632642,28,19,72,119
"21796","chr8",65675294,65675312,19,146,62,227
"21797","chr8",65757597,65757634,38,6,98,142
"21798","chr8",65841964,65841994,31,93,36,160
"21799","chr8",65964105,65964126,22,145,64,231
"21800","chr8",66085442,66085462,21,116,72,209
"21801","chr8",66650861,66650889,29,134,50,213
"21802","chr8",66663104,66663126,23,68,75,166
"21803","chr8",66691498,66691519,22,145,74,241
"21804","chr8",66705716,66705743,28,76,144,248
"21805","chr8",66737618,66737635,18,10,130,158
"21806","chr8",66887385,66887402,18,145,108,271
"21807","chr8",66924634,66924651,18,105,7,130
"21808","chr8",66934243,66934266,24,3,141,168
"21809","chr8",67006740,67006764,25,12,74,111
"21810","chr8",67104950,67104967,18,50,135,203
"21811","chr8",67104967,67104992,26,75,118,219
"21812","chr8",67105024,67105042,19,125,61,205
"21813","chr8",67184944,67184966,23,88,27,138
"21814","chr8",67206411,67206434,24,9,5,38
"21815","chr8",67343821,67343847,27,61,88,176
"21816","chr8",67660497,67660519,23,32,143,198
"21817","chr8",68330795,68330826,32,15,94,141
"21818","chr8",69616703,69616722,20,25,144,189
"21819","chr8",69832995,69833019,25,51,101,177
"21820","chr8",69834736,69834780,45,103,75,223
"21821","chr8",69873260,69873290,31,61,83,175
"21822","chr8",69989265,69989304,40,9,113,162
"21823","chr8",69993169,69993193,25,13,122,160
"21824","chr8",69994164,69994208,45,72,46,163
"21825","chr8",70013301,70013336,36,6,74,116
"21826","chr8",70024695,70024730,36,78,42,156
"21827","chr8",70027527,70027546,20,8,103,131
"21828","chr8",70038498,70038517,20,109,91,220
"21829","chr8",70363080,70363101,22,13,72,107
"21830","chr8",70403848,70403879,32,31,2,65
"21831","chr8",70426733,70426759,27,25,118,170
"21832","chr8",71425105,71425129,25,73,27,125
"21833","chr8",72968825,72968845,21,9,102,132
"21834","chr8",73350387,73350431,45,9,142,196
"21835","chr8",73622124,73622145,22,9,75,106
"21836","chr8",73894936,73894962,27,77,27,131
"21837","chr8",73934366,73934399,34,26,147,207
"21838","chr8",73934401,73934422,22,49,112,183
"21839","chr8",74050019,74050040,22,127,6,155
"21840","chr8",74185881,74185899,19,5,37,61
"21841","chr8",74198244,74198272,29,28,9,66
"21842","chr8",74321482,74321503,22,9,43,74
"21843","chr8",74552554,74552578,25,7,52,84
"21844","chr8",74604438,74604473,36,57,94,187
"21845","chr8",75023074,75023094,21,144,135,300
"21846","chr8",75105072,75105282,211,39,8,258
"21847","chr8",75418723,75418744,22,75,81,178
"21848","chr8",76320021,76320044,24,122,58,204
"21849","chr8",76853063,76853115,53,136,49,238
"21850","chr8",77957559,77957586,28,66,2,96
"21851","chr8",79697430,79697492,63,24,136,223
"21852","chr8",79768280,79768332,53,19,10,82
"21853","chr8",79866683,79866718,36,106,74,216
"21854","chr8",79872811,79872831,21,82,64,167
"21855","chr8",80171359,80171405,47,10,65,122
"21856","chr8",80199440,80199457,18,101,11,130
"21857","chr8",80233750,80233776,27,80,6,113
"21858","chr8",80239712,80239731,20,76,21,117
"21859","chr8",80266451,80266473,23,134,6,163
"21860","chr8",80329331,80329477,147,24,46,217
"21861","chr8",80403971,80403998,28,139,73,240
"21862","chr8",80482067,80482089,23,7,50,80
"21863","chr8",80486106,80486142,37,18,1,56
"21864","chr8",80486602,80486622,21,68,96,185
"21865","chr8",80486786,80486804,19,2,3,24
"21866","chr8",80873657,80873697,41,8,50,99
"21867","chr8",80873855,80873877,23,30,91,144
"21868","chr8",80874315,80874341,27,65,5,97
"21869","chr8",81842344,81842580,237,96,88,421
"21870","chr8",82154111,82154135,25,6,85,116
"21871","chr8",82885073,82885091,19,51,75,145
"21872","chr8",84003870,84003889,20,61,113,194
"21873","chr8",84184489,84184521,33,133,113,279
"21874","chr8",84535603,84535653,51,36,143,230
"21875","chr8",84978384,84978407,24,29,78,131
"21876","chr8",85144906,85144928,23,143,3,169
"21877","chr8",85628067,85628092,26,129,75,230
"21878","chr8",85632449,85632478,30,86,6,122
"21879","chr8",86105610,86105636,27,12,114,153
"21880","chr8",86198028,86198058,31,29,74,134
"21881","chr8",86289307,86289337,31,10,75,116
"21882","chr8",86950053,86950079,27,76,146,249
"21883","chr8",87045725,87045744,20,136,6,162
"21884","chr8",87855405,87855437,33,76,8,117
"21885","chr8",88183885,88183924,40,34,73,147
"21886","chr8",88327549,88327584,36,16,33,85
"21887","chr8",88327748,88327765,18,6,121,145
"21888","chr8",88327765,88327821,57,62,104,223
"21889","chr8",88352796,88352815,20,47,99,166
"21890","chr8",88352813,88352832,20,64,82,166
"21891","chr8",89207056,89207081,26,145,32,203
"21892","chr8",89639110,89639127,18,138,75,231
"21893","chr8",89902982,89903011,30,70,19,119
"21894","chr8",90605011,90605051,41,76,19,136
"21895","chr8",91040816,91040864,49,134,29,212
"21896","chr8",93826124,93826151,28,125,41,194
"21897","chr8",93868476,93868506,31,127,118,276
"21898","chr8",93899745,93899777,33,36,76,145
"21899","chr8",93917274,93917299,26,1,31,58
"21900","chr8",93917508,93917553,46,1,7,54
"21901","chr8",94068226,94068252,27,30,75,132
"21902","chr8",94233876,94233894,19,47,32,98
"21903","chr8",94523965,94523989,25,48,70,143
"21904","chr8",94700938,94700984,47,122,65,234
"21905","chr8",94713086,94713105,20,75,28,123
"21906","chr8",94751485,94751506,22,73,78,173
"21907","chr8",94804503,94804540,38,145,6,189
"21908","chr8",94896252,94896284,33,44,17,94
"21909","chr8",95161530,95161547,18,5,48,71
"21910","chr8",95268752,95268794,43,130,72,245
"21911","chr8",95316161,95316180,20,86,14,120
"21912","chr8",95405175,95405192,18,39,74,131
"21913","chr8",95921797,95921819,23,117,3,143
"21914","chr8",96177920,96177945,26,145,21,192
"21915","chr8",96385879,96385904,26,16,33,75
"21916","chr8",96418953,96418971,19,8,94,121
"21917","chr8",96508297,96508344,48,146,5,199
"21918","chr8",97164242,97164266,25,29,75,129
"21919","chr8",97209439,97209462,24,61,40,125
"21920","chr8",97448101,97448130,30,7,103,140
"21921","chr8",97561470,97561597,128,10,31,169
"21922","chr8",97649950,97649972,23,75,99,197
"21923","chr8",97755120,97755140,21,64,43,128
"21924","chr8",97757854,97757875,22,119,79,220
"21925","chr8",97768726,97768758,33,48,52,133
"21926","chr8",97774992,97775020,29,145,74,248
"21927","chr8",97800485,97800511,27,5,65,97
"21928","chr8",97868175,97868197,23,14,24,61
"21929","chr8",97892236,97892263,28,145,44,217
"21930","chr8",97943385,97943482,98,67,91,256
"21931","chr8",98359345,98359373,29,78,34,141
"21932","chr8",98858291,98858324,34,9,97,140
"21933","chr8",98858324,98858371,48,56,64,168
"21934","chr8",98941697,98941719,23,116,121,260
"21935","chr8",98948489,98948517,29,18,91,138
"21936","chr8",99013371,99013392,22,107,38,167
"21937","chr8",99103494,99103516,23,7,78,108
"21938","chr8",100213263,100213287,25,50,76,151
"21939","chr8",100317084,100317101,18,107,28,153
"21940","chr8",100358781,100358836,56,6,6,68
"21941","chr8",100680409,100680433,25,116,5,146
"21942","chr8",100742707,100742725,19,145,93,257
"21943","chr8",100951473,100951490,18,27,24,69
"21944","chr8",100971431,100971454,24,134,6,164
"21945","chr8",101024360,101024390,31,73,65,169
"21946","chr8",101060900,101060921,22,29,142,193
"21947","chr8",101060922,101060969,48,77,120,245
"21948","chr8",101186153,101186180,28,27,74,129
"21949","chr8",101206481,101206503,23,78,33,134
"21950","chr8",101206651,101206683,33,133,75,241
"21951","chr8",101643370,101643396,27,128,9,164
"21952","chr8",102123808,102123837,30,73,116,219
"21953","chr8",102451348,102451391,44,96,6,146
"21954","chr8",102456191,102456224,34,5,90,129
"21955","chr8",102531484,102531513,30,8,3,41
"21956","chr8",102553207,102553227,21,27,27,75
"21957","chr8",102613134,102613168,35,69,21,125
"21958","chr8",102659545,102659567,23,55,7,85
"21959","chr8",102689799,102689827,29,110,6,145
"21960","chr8",102777839,102777857,19,64,6,89
"21961","chr8",102787470,102787489,20,1,81,102
"21962","chr8",102863614,102863647,34,65,37,136
"21963","chr8",102964992,102965012,21,74,68,163
"21964","chr8",103010275,103010292,18,146,31,195
"21965","chr8",103298774,103298810,37,46,34,117
"21966","chr8",103370967,103370997,31,77,6,114
"21967","chr8",103632732,103632756,25,14,134,173
"21968","chr8",104155410,104155429,20,6,141,167
"21969","chr8",105289846,105289882,37,149,34,220
"21970","chr8",105318846,105318873,28,23,90,141
"21971","chr8",105422048,105422069,22,61,5,88
"21972","chr8",106057915,106057955,41,85,67,193
"21973","chr8",106851963,106851984,22,75,140,237
"21974","chr8",107662541,107662562,22,97,43,162
"21975","chr8",108072493,108072511,19,29,75,123
"21976","chr8",108787621,108787645,25,136,22,183
"21977","chr8",108946956,108947018,63,94,69,226
"21978","chr8",109266393,109266416,24,28,30,82
"21979","chr8",109331331,109331366,36,77,77,190
"21980","chr8",109357020,109357046,27,75,25,127
"21981","chr8",109362369,109362388,20,63,121,204
"21982","chr8",110491231,110491257,27,77,22,126
"21983","chr8",110588319,110588346,28,29,146,203
"21984","chr8",111039666,111039692,27,143,6,176
"21985","chr8",111164656,111164675,20,8,94,122
"21986","chr8",111331922,111331969,48,5,70,123
"21987","chr8",111394193,111394212,20,78,5,103
"21988","chr8",111580839,111580863,25,130,6,161
"21989","chr8",111624543,111624565,23,75,130,228
"21990","chr8",112680360,112680386,27,76,72,175
"21991","chr8",113409062,113409081,20,57,32,109
"21992","chr8",113409080,113409101,22,77,14,113
"21993","chr8",114875638,114875664,27,7,23,57
"21994","chr8",114939792,114939809,18,17,71,106
"21995","chr8",116446375,116446392,18,145,86,249
"21996","chr8",116923608,116923652,45,74,145,264
"21997","chr8",116952851,116952871,21,27,45,93
"21998","chr8",117953922,117953944,23,80,62,165
"21999","chr8",118111698,118111735,38,56,1,95
"22000","chr8",118500068,118500092,25,72,5,102
"22001","chr8",119176284,119176318,35,3,80,118
"22002","chr8",119208386,119208405,20,3,132,155
"22003","chr8",119208415,119208441,27,39,103,169
"22004","chr8",119545303,119545325,23,7,140,170
"22005","chr8",119717034,119717059,26,78,59,163
"22006","chr8",119863438,119863458,21,145,29,195
"22007","chr8",120023227,120023258,32,76,32,140
"22008","chr8",120249094,120249111,18,49,74,141
"22009","chr8",120501191,120501212,22,145,6,173
"22010","chr8",120811815,120811834,20,2,123,145
"22011","chr8",120865724,120865743,20,78,27,125
"22012","chr8",120948772,120948790,19,142,113,274
"22013","chr8",121046114,121046162,49,77,86,212
"22014","chr8",121442781,121442799,19,15,140,174
"22015","chr8",121566822,121566847,26,137,74,237
"22016","chr8",121948351,121948370,20,91,5,116
"22017","chr8",121989184,121989220,37,121,6,164
"22018","chr8",122065785,122065810,26,85,80,191
"22019","chr8",122102609,122102627,19,29,75,123
"22020","chr8",122175399,122175439,41,5,30,76
"22021","chr8",122937934,122937954,21,77,97,195
"22022","chr8",123157720,123157742,23,22,50,95
"22023","chr8",123174175,123174198,24,104,6,134
"22024","chr8",123206911,123207096,186,62,131,379
"22025","chr8",123241150,123241173,24,2,48,74
"22026","chr8",123276346,123276368,23,5,14,42
"22027","chr8",123424073,123424090,18,76,120,214
"22028","chr8",123584189,123584217,29,80,32,141
"22029","chr8",123686471,123686493,23,110,63,196
"22030","chr8",123741806,123741826,21,32,27,80
"22031","chr8",123741977,123742002,26,61,73,160
"22032","chr8",124003452,124003481,30,3,15,48
"22033","chr8",124601063,124601084,22,82,18,122
"22034","chr8",124640542,124640560,19,7,49,75
"22035","chr8",125668107,125668129,23,77,26,126
"22036","chr8",126478334,126478354,21,77,124,222
"22037","chr8",126782683,126782707,25,4,6,35
"22038","chr8",126782706,126782726,21,23,51,95
"22039","chr8",126995276,126995293,18,21,17,56
"22040","chr8",127315601,127315638,38,83,49,170
"22041","chr8",127703601,127703618,18,10,21,49
"22042","chr8",127798705,127798726,22,77,75,174
"22043","chr8",127804539,127804558,20,20,9,49
"22044","chr8",127879533,127879572,40,145,2,187
"22045","chr8",128074343,128074373,31,77,35,143
"22046","chr8",128662547,128662564,18,7,28,53
"22047","chr8",128662564,128662614,51,57,11,119
"22048","chr8",128827409,128827430,22,76,39,137
"22049","chr8",129349674,129349777,104,86,3,193
"22050","chr8",129448811,129448830,20,35,75,130
"22051","chr8",129723235,129723257,23,75,129,227
"22052","chr8",130016510,130016532,23,57,19,99
"22053","chr8",130107516,130107561,46,122,114,282
"22054","chr8",130123588,130123612,25,44,85,154
"22055","chr8",130358612,130358632,21,44,37,102
"22056","chr8",130358689,130358761,73,50,4,127
"22057","chr8",130424998,130425020,23,119,1,143
"22058","chr8",130474908,130474925,18,141,8,167
"22059","chr8",130717604,130717625,22,77,58,157
"22060","chr8",131204340,131204368,29,131,19,179
"22061","chr8",132372760,132372784,25,77,3,105
"22062","chr8",132479950,132479993,44,8,138,190
"22063","chr8",132480456,132480512,57,30,49,136
"22064","chr8",132480875,132480895,21,103,60,184
"22065","chr8",132775397,132775425,29,5,50,84
"22066","chr8",132872478,132872501,24,6,6,36
"22067","chr8",133094238,133094260,23,78,82,183
"22068","chr8",133482905,133482931,27,19,64,110
"22069","chr8",133631813,133631830,18,7,85,110
"22070","chr8",133838101,133838132,32,83,74,189
"22071","chr8",134712720,134712748,29,62,20,111
"22072","chr8",134832489,134832511,23,15,32,70
"22073","chr8",135906818,135906847,30,108,77,215
"22074","chr8",136016952,136016988,37,21,124,182
"22075","chr8",136453668,136453686,19,45,18,82
"22076","chr8",136734020,136734054,35,67,135,237
"22077","chr8",137253476,137253525,50,8,74,132
"22078","chr8",137848600,137848632,33,133,6,172
"22079","chr8",138384346,138384386,41,109,33,183
"22080","chr8",138496766,138496784,19,49,89,157
"22081","chr8",138504105,138504136,32,8,127,167
"22082","chr8",139456119,139456187,69,19,27,115
"22083","chr8",139456185,139456208,24,40,1,65
"22084","chr8",139703071,139703109,39,7,89,135
"22085","chr8",139703131,139703150,20,48,29,97
"22086","chr8",139703920,139703945,26,32,10,68
"22087","chr8",139704101,139704148,48,88,68,204
"22088","chr8",139704215,139704236,22,39,102,163
"22089","chr8",140125588,140125612,25,76,58,159
"22090","chr8",140376174,140376197,24,70,47,141
"22091","chr8",140429054,140429099,46,76,110,232
"22092","chr8",140444036,140444060,25,143,73,241
"22093","chr8",140473018,140473035,18,32,74,124
"22094","chr8",140629852,140629947,96,112,51,259
"22095","chr8",140635673,140635691,19,30,5,54
"22096","chr8",140635675,140635725,51,11,3,65
"22097","chr8",140635790,140635810,21,14,10,45
"22098","chr8",141001240,141001259,20,37,18,75
"22099","chr8",141135135,141135155,21,107,14,142
"22100","chr8",141153093,141153111,19,76,8,103
"22101","chr8",141212132,141212161,30,20,90,140
"22102","chr8",141255717,141255761,45,97,73,215
"22103","chr8",141258061,141258082,22,46,91,159
"22104","chr8",141263426,141263452,27,114,48,189
"22105","chr8",141263770,141263807,38,20,74,132
"22106","chr8",141308133,141308150,18,9,49,76
"22107","chr8",141308483,141308516,34,41,31,106
"22108","chr8",141326584,141326623,40,61,44,145
"22109","chr8",141415694,141415781,88,66,50,204
"22110","chr8",141785827,141785850,24,66,141,231
"22111","chr8",142232795,142232817,23,36,14,73
"22112","chr8",142392940,142392966,27,105,6,138
"22113","chr8",142449533,142449577,45,35,120,200
"22114","chr8",142453025,142453045,21,63,16,100
"22115","chr8",142453043,142453061,19,79,19,117
"22116","chr8",142464246,142464270,25,38,6,69
"22117","chr8",142475799,142475821,23,46,14,83
"22118","chr8",142510713,142510730,18,18,3,39
"22119","chr8",142510820,142510841,22,129,11,162
"22120","chr8",142787143,142787165,23,36,87,146
"22121","chr8",143044531,143044548,18,130,38,186
"22122","chr8",143050177,143050199,23,77,17,117
"22123","chr8",143116621,143116639,19,7,63,89
"22124","chr8",143165554,143165572,19,77,24,120
"22125","chr8",143225029,143225067,39,10,134,183
"22126","chr8",143284366,143284383,18,37,75,130
"22127","chr8",143290006,143290027,22,6,4,32
"22128","chr8",143403805,143404012,208,38,72,318
"22129","chr8",143429784,143429813,30,28,12,70
"22130","chr8",143430149,143430182,34,145,75,254
"22131","chr8",143441582,143441600,19,1,58,78
"22132","chr8",143500978,143500995,18,34,95,147
"22133","chr8",143626493,143626513,21,9,1,31
"22134","chr8",143685529,143685548,20,138,1,159
"22135","chr8",143733910,143733986,77,4,9,90
"22136","chr8",143767878,143767899,22,74,81,177
"22137","chr8",143771391,143771411,21,1,3,25
"22138","chr8",143777521,143777539,19,119,69,207
"22139","chr8",143820939,143820969,31,13,16,60
"22140","chr8",143837341,143837384,44,101,144,289
"22141","chr8",143859324,143859370,47,72,20,139
"22142","chr8",143860551,143860581,31,28,9,68
"22143","chr8",143860932,143860972,41,72,20,133
"22144","chr8",143862153,143862183,31,28,9,68
"22145","chr8",143862534,143862574,41,72,20,133
"22146","chr8",143864127,143864167,41,72,20,133
"22147","chr8",143865348,143865384,37,28,9,74
"22148","chr8",143865735,143865775,41,72,20,133
"22149","chr8",143897482,143897503,22,76,131,229
"22150","chr8",143898198,143898225,28,6,103,137
"22151","chr8",143906086,143906117,32,72,52,156
"22152","chr8",143932058,143932075,18,2,19,39
"22153","chr8",143953444,143953476,33,64,15,112
"22154","chr8",143973562,143973593,32,16,54,102
"22155","chr8",143980012,143980031,20,139,6,165
"22156","chr8",143990256,143990275,20,24,71,115
"22157","chr8",144015741,144015776,36,8,7,51
"22158","chr8",144018878,144018896,19,81,74,174
"22159","chr8",144049293,144049311,19,16,4,39
"22160","chr8",144051682,144051704,23,80,22,125
"22161","chr8",144051860,144051886,27,104,21,152
"22162","chr8",144104524,144104549,26,3,104,133
"22163","chr8",144129415,144129466,52,8,106,166
"22164","chr8",144169618,144169647,30,63,27,120
"22165","chr8",144187096,144187125,30,144,8,182
"22166","chr8",144225911,144225933,23,45,50,118
"22167","chr8",144305724,144305750,27,36,26,89
"22168","chr8",144327559,144327583,25,13,84,122
"22169","chr8",144336367,144336456,90,25,138,253
"22170","chr8",144336885,144336919,35,34,24,93
"22171","chr8",144336968,144336989,22,3,51,76
"22172","chr8",144354560,144354602,43,4,67,114
"22173","chr8",144367607,144367627,21,29,77,127
"22174","chr8",144383887,144383910,24,37,62,123
"22175","chr8",144431815,144431847,33,77,8,118
"22176","chr8",144444127,144444149,23,60,116,199
"22177","chr8",144462368,144462391,24,46,28,98
"22178","chr8",144462569,144462589,21,56,25,102
"22179","chr8",144482076,144482096,21,82,145,248
"22180","chr8",144646966,144646987,22,9,40,71
"22181","chr8",144682245,144682267,23,147,30,200
"22182","chr8",144693059,144693079,21,73,145,239
"22183","chr8",144737838,144737862,25,115,68,208
"22184","chr8",144759182,144759204,23,88,5,116
"22185","chr8",144805328,144805345,18,5,39,62
"22186","chr8",144827216,144827266,51,130,58,239
"22187","chr8",144831782,144831799,18,79,120,217
"22188","chr9",11166,11194,29,1,20,50
"22189","chr9",74033,74088,56,35,140,231
"22190","chr9",150117,150144,28,76,147,251
"22191","chr9",418265,418288,24,75,8,107
"22192","chr9",493029,493055,27,131,1,159
"22193","chr9",648000,648019,20,74,54,148
"22194","chr9",741488,741505,18,8,70,96
"22195","chr9",746460,746480,21,7,39,67
"22196","chr9",786577,786594,18,143,62,223
"22197","chr9",842231,842253,23,9,135,167
"22198","chr9",871500,871522,23,38,75,136
"22199","chr9",997748,997791,44,56,32,132
"22200","chr9",1012458,1012482,25,25,43,93
"22201","chr9",1141660,1141680,21,115,6,142
"22202","chr9",2017134,2017151,18,120,64,202
"22203","chr9",2017387,2017407,21,73,126,220
"22204","chr9",2843574,2843596,23,8,76,107
"22205","chr9",3470482,3470508,27,37,75,139
"22206","chr9",3669250,3669281,32,37,82,151
"22207","chr9",3669277,3669299,23,55,55,133
"22208","chr9",4283254,4283283,30,8,131,169
"22209","chr9",4619156,4619175,20,9,77,106
"22210","chr9",4710375,4710392,18,29,75,122
"22211","chr9",4745546,4745568,23,75,71,169
"22212","chr9",4761146,4761168,23,76,3,102
"22213","chr9",4855053,4855073,21,38,6,65
"22214","chr9",5042125,5042148,24,69,90,183
"22215","chr9",5392815,5392857,43,6,140,189
"22216","chr9",5452016,5452043,28,85,147,260
"22217","chr9",5629197,5629215,19,4,114,137
"22218","chr9",5702499,5702545,47,65,122,234
"22219","chr9",5702539,5702558,20,10,82,112
"22220","chr9",5865512,5865541,30,138,70,238
"22221","chr9",6419912,6419930,19,44,138,201
"22222","chr9",6423950,6423968,19,92,38,149
"22223","chr9",6634528,6634562,35,95,7,137
"22224","chr9",6697497,6697516,20,25,5,50
"22225","chr9",6732365,6732401,37,141,6,184
"22226","chr9",6738136,6738183,48,136,72,256
"22227","chr9",6747004,6747043,40,27,8,75
"22228","chr9",6747198,6747228,31,110,119,260
"22229","chr9",6752333,6752361,29,83,6,118
"22230","chr9",6770768,6770787,20,69,117,206
"22231","chr9",6856748,6856768,21,69,18,108
"22232","chr9",8222755,8222857,103,22,10,135
"22233","chr9",8353418,8353449,32,7,88,127
"22234","chr9",8581767,8581815,49,148,104,301
"22235","chr9",8858086,8858125,40,113,34,187
"22236","chr9",8858797,8858862,66,50,23,139
"22237","chr9",10612956,10612998,43,26,18,87
"22238","chr9",10613176,10613193,18,59,83,160
"22239","chr9",10766276,10766319,44,61,7,112
"22240","chr9",11073101,11073135,35,76,32,143
"22241","chr9",11150140,11150157,18,29,143,190
"22242","chr9",12352903,12352922,20,132,32,184
"22243","chr9",12665652,12665692,41,58,143,242
"22244","chr9",13279243,13279299,57,49,97,203
"22245","chr9",14007445,14007465,21,30,111,162
"22246","chr9",14053361,14053379,19,127,105,251
"22247","chr9",14314318,14314347,30,139,6,175
"22248","chr9",14692899,14692916,18,12,67,97
"22249","chr9",14693156,14693196,41,10,49,100
"22250","chr9",14856836,14856856,21,120,3,144
"22251","chr9",15302540,15302563,24,67,83,174
"22252","chr9",15348314,15348333,20,10,6,36
"22253","chr9",15515374,15515397,24,8,145,177
"22254","chr9",15605516,15605537,22,145,35,202
"22255","chr9",15637463,15637486,24,116,30,170
"22256","chr9",16059492,16059525,34,121,29,184
"22257","chr9",16677579,16677607,29,50,118,197
"22258","chr9",16793855,16793883,29,38,53,120
"22259","chr9",16872285,16872304,20,62,94,176
"22260","chr9",16901579,16901596,18,97,74,189
"22261","chr9",17098476,17098510,35,5,140,180
"22262","chr9",17440422,17440439,18,145,23,186
"22263","chr9",17612190,17612209,20,117,93,230
"22264","chr9",17816088,17816114,27,64,18,109
"22265","chr9",19103380,19103403,24,6,87,117
"22266","chr9",19103706,19103733,28,9,78,115
"22267","chr9",19107687,19107705,19,7,114,140
"22268","chr9",19175436,19175473,38,66,115,219
"22269","chr9",19226768,19226787,20,56,6,82
"22270","chr9",19227805,19227831,27,135,29,191
"22271","chr9",19238450,19238662,213,67,27,307
"22272","chr9",19272946,19272966,21,76,64,161
"22273","chr9",19275278,19275310,33,76,145,254
"22274","chr9",19279368,19279385,18,139,35,192
"22275","chr9",19332518,19332536,19,30,81,130
"22276","chr9",19416509,19416549,41,82,59,182
"22277","chr9",20210638,20210675,38,27,78,143
"22278","chr9",20260850,20260872,23,7,53,83
"22279","chr9",20621903,20621921,19,7,80,106
"22280","chr9",20622409,20622432,24,54,9,87
"22281","chr9",21335319,21335341,23,112,56,191
"22282","chr9",21802986,21803037,52,17,7,76
"22283","chr9",22056213,22056235,23,23,57,103
"22284","chr9",22447240,22447266,27,118,73,218
"22285","chr9",22958425,22958448,24,37,134,195
"22286","chr9",23821757,23821779,23,31,130,184
"22287","chr9",23898194,23898212,19,144,35,198
"22288","chr9",24731477,24731494,18,125,70,213
"22289","chr9",25197819,25197838,20,80,29,129
"22290","chr9",25678180,25678197,18,123,8,149
"22291","chr9",25679801,25679823,23,58,6,87
"22292","chr9",26247575,26247600,26,8,50,84
"22293","chr9",27517648,27517672,25,24,6,55
"22294","chr9",27573209,27573234,26,6,78,110
"22295","chr9",27941432,27941453,22,71,11,104
"22296","chr9",28809746,28809764,19,65,74,158
"22297","chr9",28932108,28932152,45,131,73,249
"22298","chr9",29624707,29624732,26,8,76,110
"22299","chr9",30992846,30992875,30,74,12,116
"22300","chr9",31026320,31026354,35,75,43,153
"22301","chr9",31255098,31255142,45,122,67,234
"22302","chr9",32548000,32548023,24,24,74,122
"22303","chr9",32565972,32565994,23,119,74,216
"22304","chr9",32927774,32927795,22,60,6,88
"22305","chr9",32930809,32930835,27,74,66,167
"22306","chr9",33051121,33051154,34,6,6,46
"22307","chr9",33077146,33077167,22,119,8,149
"22308","chr9",33194675,33194701,27,78,74,179
"22309","chr9",33345164,33345191,28,144,72,244
"22310","chr9",33486732,33486752,21,3,16,40
"22311","chr9",33486759,33486795,37,46,57,140
"22312","chr9",33677010,33677037,28,42,79,149
"22313","chr9",33677370,33677389,20,105,104,229
"22314","chr9",33677386,33677404,19,120,88,227
"22315","chr9",33750148,33750171,24,35,51,110
"22316","chr9",33766264,33766289,26,11,75,112
"22317","chr9",33817733,33817756,24,65,3,92
"22318","chr9",33818122,33818148,27,1,9,37
"22319","chr9",33832311,33832333,23,106,71,200
"22320","chr9",33898081,33898103,23,76,139,238
"22321","chr9",33899367,33899390,24,6,38,68
"22322","chr9",33945492,33945515,24,58,13,95
"22323","chr9",33958707,33958724,18,5,145,168
"22324","chr9",34024044,34024066,23,19,6,48
"22325","chr9",34030451,34030474,24,145,72,241
"22326","chr9",34046644,34046672,29,67,6,102
"22327","chr9",34074982,34075015,34,74,4,112
"22328","chr9",34116350,34116386,37,6,13,56
"22329","chr9",34134743,34134767,25,112,73,210
"22330","chr9",34172019,34172041,23,76,79,178
"22331","chr9",34173997,34174019,23,107,44,174
"22332","chr9",34181418,34181448,31,6,143,180
"22333","chr9",34377761,34377795,35,80,115,230
"22334","chr9",34430847,34430866,20,97,37,154
"22335","chr9",34577922,34577963,42,8,24,74
"22336","chr9",34589684,34589716,33,140,38,211
"22337","chr9",34590167,34590187,21,105,121,247
"22338","chr9",34642012,34642038,27,123,127,277
"22339","chr9",34652181,34652211,31,57,7,95
"22340","chr9",34665395,34665417,23,1,36,60
"22341","chr9",34666553,34666570,18,52,101,171
"22342","chr9",34809999,34810031,33,24,42,99
"22343","chr9",34958227,34958257,31,8,74,113
"22344","chr9",34990028,34990050,23,10,79,112
"22345","chr9",35111317,35111343,27,140,141,308
"22346","chr9",35160417,35160436,20,4,27,51
"22347","chr9",35489593,35489623,31,22,73,126
"22348","chr9",35490117,35490139,23,102,17,142
"22349","chr9",35535535,35535554,20,6,26,52
"22350","chr9",35564549,35564567,19,62,23,104
"22351","chr9",35605297,35605317,21,17,3,41
"22352","chr9",35605360,35605382,23,8,24,55
"22353","chr9",35885099,35885149,51,76,22,149
"22354","chr9",35887976,35887994,19,5,90,114
"22355","chr9",35906351,35906371,21,51,77,149
"22356","chr9",35906548,35906616,69,119,52,240
"22357","chr9",36028641,36028669,29,117,33,179
"22358","chr9",36036361,36036379,19,50,77,146
"22359","chr9",36043192,36043215,24,29,75,128
"22360","chr9",36198703,36198720,18,74,52,144
"22361","chr9",36199435,36199467,33,76,9,118
"22362","chr9",36272621,36272645,25,4,74,103
"22363","chr9",36274069,36274116,48,11,11,70
"22364","chr9",36285722,36285746,25,76,84,185
"22365","chr9",36295552,36295574,23,146,8,177
"22366","chr9",36311861,36311887,27,69,136,232
"22367","chr9",36323711,36323734,24,30,5,59
"22368","chr9",36400879,36400941,63,34,3,100
"22369","chr9",36401199,36401223,25,116,9,150
"22370","chr9",36464163,36464189,27,50,10,87
"22371","chr9",36478404,36478423,20,35,6,61
"22372","chr9",36487499,36487545,47,10,6,63
"22373","chr9",36507254,36507271,18,6,117,141
"22374","chr9",36543116,36543138,23,145,72,240
"22375","chr9",36543453,36543482,30,147,74,251
"22376","chr9",36554191,36554208,18,76,143,237
"22377","chr9",36567971,36568002,32,128,5,165
"22378","chr9",36574431,36574453,23,145,26,194
"22379","chr9",36596558,36596603,46,75,8,129
"22380","chr9",36604269,36604295,27,75,145,247
"22381","chr9",36649920,36649956,37,3,38,78
"22382","chr9",36652043,36652064,22,77,65,164
"22383","chr9",37402264,37402287,24,77,35,136
"22384","chr9",37512449,37512466,18,18,134,170
"22385","chr9",37526798,37526867,70,75,40,185
"22386","chr9",37752159,37752210,52,87,54,193
"22387","chr9",37785080,37785101,22,29,4,55
"22388","chr9",37936041,37936058,18,137,59,214
"22389","chr9",38067405,38067430,26,110,72,208
"22390","chr9",38244984,38245003,20,72,6,98
"22391","chr9",38424367,38424398,32,30,42,104
"22392","chr9",38623303,38623343,41,117,21,179
"22393","chr9",38646564,38646625,62,46,74,182
"22394","chr9",38653535,38653560,26,75,10,111
"22395","chr9",38672793,38672830,38,8,37,83
"22396","chr9",38679352,38679377,26,19,36,81
"22397","chr9",38807775,38807799,25,42,4,71
"22398","chr9",38843981,38844000,20,69,33,122
"22399","chr9",38912176,38912194,19,43,106,168
"22400","chr9",39062539,39062559,21,29,72,122
"22401","chr9",39175203,39175230,28,27,6,61
"22402","chr9",39295437,39295478,42,125,71,238
"22403","chr9",39295513,39295544,32,65,63,160
"22404","chr9",39350150,39350179,30,9,6,45
"22405","chr9",39394554,39394574,21,8,145,174
"22406","chr9",39572632,39572651,20,77,40,137
"22407","chr9",40106076,40106101,26,2,63,91
"22408","chr9",40588927,40588953,27,75,12,114
"22409","chr9",40589796,40589828,33,42,101,176
"22410","chr9",40651088,40651112,25,96,17,138
"22411","chr9",41160411,41160433,23,69,147,239
"22412","chr9",41355816,41355833,18,37,79,134
"22413","chr9",41359403,41359436,34,65,6,105
"22414","chr9",41652493,41652552,60,89,108,257
"22415","chr9",41750095,41750113,19,77,35,131
"22416","chr9",41799409,41799429,21,8,95,124
"22417","chr9",41995731,41995751,21,139,6,166
"22418","chr9",42136457,42136497,41,29,78,148
"22419","chr9",42222632,42222657,26,8,145,179
"22420","chr9",42258896,42258924,29,53,9,91
"22421","chr9",42268392,42268416,25,48,144,217
"22422","chr9",42329292,42329311,20,77,33,130
"22423","chr9",42643186,42643228,43,115,71,229
"22424","chr9",60854441,60854473,33,118,71,222
"22425","chr9",60854515,60854554,40,65,65,170
"22426","chr9",60908840,60908862,23,9,6,38
"22427","chr9",60953363,60953383,21,8,145,174
"22428","chr9",61130015,61130061,47,122,71,240
"22429","chr9",61130099,61130144,46,65,55,166
"22430","chr9",61228726,61228746,21,8,145,174
"22431","chr9",61323482,61323525,44,3,65,112
"22432","chr9",61323559,61323595,37,73,124,234
"22433","chr9",61443735,61443762,28,8,25,61
"22434","chr9",61661666,61661703,38,16,88,142
"22435","chr9",61866459,61866485,27,89,105,221
"22436","chr9",61869176,61869198,23,99,29,151
"22437","chr9",61869205,61869241,37,142,122,301
"22438","chr9",61962138,61962156,19,77,35,131
"22439","chr9",62054327,62054345,19,28,75,122
"22440","chr9",62068412,62068429,18,69,33,120
"22441","chr9",62136595,62136613,19,43,106,168
"22442","chr9",62450635,62450677,43,115,71,229
"22443","chr9",63048554,63048580,27,14,73,114
"22444","chr9",63389898,63389924,27,75,12,114
"22445","chr9",63390762,63390793,32,41,101,174
"22446","chr9",63450488,63450521,34,96,17,147
"22447","chr9",63703382,63703416,35,60,2,97
"22448","chr9",63814821,63814843,23,38,147,208
"22449","chr9",63972145,63972165,21,11,33,65
"22450","chr9",64716398,64716424,27,75,12,114
"22451","chr9",64717278,64717310,33,42,101,176
"22452","chr9",65200718,65200744,27,75,12,114
"22453","chr9",65201587,65201619,33,42,101,176
"22454","chr9",65298794,65298825,32,11,33,76
"22455","chr9",65395507,65395545,39,89,105,233
"22456","chr9",65401992,65402029,38,46,108,192
"22457","chr9",65480158,65480223,66,74,130,270
"22458","chr9",65592671,65592708,38,16,88,142
"22459","chr9",65704911,65704938,28,149,74,251
"22460","chr9",65722698,65722733,36,35,9,80
"22461","chr9",65820960,65820985,26,14,72,112
"22462","chr9",65897234,65897254,21,80,7,108
"22463","chr9",66179452,66179474,23,102,83,208
"22464","chr9",66266933,66266950,18,37,79,134
"22465","chr9",66671874,66671891,18,52,2,72
"22466","chr9",66711040,66711058,19,133,6,158
"22467","chr9",66792368,66792388,21,42,75,138
"22468","chr9",66818688,66818708,21,8,8,37
"22469","chr9",66953509,66953531,23,147,6,176
"22470","chr9",67052045,67052093,49,148,29,226
"22471","chr9",67052158,67052204,47,75,88,210
"22472","chr9",67191629,67191657,29,8,137,174
"22473","chr9",67451756,67451773,18,108,41,167
"22474","chr9",67519950,67519967,18,35,67,120
"22475","chr9",67534040,67534065,26,145,26,197
"22476","chr9",67610434,67610485,52,74,130,256
"22477","chr9",67626388,67626405,18,37,75,130
"22478","chr9",67711574,67711610,37,124,140,301
"22479","chr9",67711617,67711639,23,31,97,151
"22480","chr9",67714330,67714354,25,107,87,219
"22481","chr9",68288648,68288674,27,35,1,63
"22482","chr9",68857956,68857991,36,8,48,92
"22483","chr9",68988445,68988467,23,8,1,32
"22484","chr9",69037285,69037304,20,21,79,120
"22485","chr9",69088241,69088263,23,69,87,179
"22486","chr9",69098895,69098919,25,110,9,144
"22487","chr9",69125304,69125324,21,126,94,241
"22488","chr9",69611286,69611315,30,143,106,279
"22489","chr9",69760014,69760032,19,98,118,235
"22490","chr9",69923265,69923299,35,11,73,119
"22491","chr9",70044387,70044413,27,132,10,169
"22492","chr9",70179353,70179371,19,74,31,124
"22493","chr9",70375435,70375453,19,109,24,152
"22494","chr9",70412187,70412214,28,64,82,174
"22495","chr9",70434179,70434214,36,77,88,201
"22496","chr9",70464292,70464310,19,68,43,130
"22497","chr9",70629326,70629344,19,67,39,125
"22498","chr9",71743067,71743085,19,87,24,130
"22499","chr9",71768574,71768609,36,44,59,139
"22500","chr9",71768898,71768919,22,74,104,200
"22501","chr9",71982975,71982999,25,112,24,161
"22502","chr9",72000692,72000733,42,87,54,183
"22503","chr9",72055269,72055439,171,41,113,325
"22504","chr9",72123483,72123504,22,75,145,242
"22505","chr9",72148301,72148352,52,36,94,182
"22506","chr9",72229172,72229199,28,143,120,291
"22507","chr9",72229353,72229385,33,71,4,108
"22508","chr9",72365284,72365304,21,113,17,151
"22509","chr9",72548567,72548584,18,94,85,197
"22510","chr9",72685363,72685381,19,76,54,149
"22511","chr9",72699957,72699980,24,147,6,177
"22512","chr9",73079209,73079229,21,25,72,118
"22513","chr9",73081315,73081332,18,80,143,241
"22514","chr9",73661851,73661878,28,21,65,114
"22515","chr9",74498818,74498840,23,12,72,107
"22516","chr9",74902336,74902368,33,123,34,190
"22517","chr9",74903151,74903182,32,76,96,204
"22518","chr9",74927533,74927564,32,11,66,109
"22519","chr9",74960209,74960232,24,148,27,199
"22520","chr9",75088217,75088241,25,33,132,190
"22521","chr9",75403034,75403055,22,63,130,215
"22522","chr9",75547682,75547704,23,79,50,152
"22523","chr9",75809175,75809203,29,8,4,41
"22524","chr9",75876421,75876453,33,125,74,232
"22525","chr9",76345411,76345437,27,77,64,168
"22526","chr9",77020146,77020177,32,32,41,105
"22527","chr9",77020311,77020349,39,14,135,188
"22528","chr9",77904318,77904348,31,74,146,251
"22529","chr9",78030875,78030928,54,4,120,178
"22530","chr9",78031589,78031609,21,21,88,130
"22531","chr9",78031820,78031851,32,39,31,102
"22532","chr9",78237956,78237975,20,145,19,184
"22533","chr9",78308956,78308973,18,96,72,186
"22534","chr9",78412839,78413223,385,98,100,583
"22535","chr9",79248829,79248846,18,81,32,131
"22536","chr9",80003163,80003188,26,12,48,86
"22537","chr9",80089701,80089724,24,53,3,80
"22538","chr9",80359493,80359522,30,136,121,287
"22539","chr9",81325560,81325585,26,75,144,245
"22540","chr9",81514808,81514832,25,76,123,224
"22541","chr9",81527616,81527633,18,38,6,62
"22542","chr9",81623618,81623642,25,145,32,202
"22543","chr9",81700998,81701015,18,26,111,155
"22544","chr9",81747451,81747469,19,77,74,170
"22545","chr9",81753990,81754017,28,132,6,166
"22546","chr9",81881398,81881427,30,5,70,105
"22547","chr9",81960957,81960986,30,68,6,104
"22548","chr9",81976760,81976790,31,76,30,137
"22549","chr9",83058173,83058200,28,8,124,160
"22550","chr9",83817838,83817864,27,3,15,45
"22551","chr9",83964499,83964526,28,107,6,141
"22552","chr9",84041777,84041816,40,85,6,131
"22553","chr9",84547116,84547156,41,33,74,148
"22554","chr9",84699728,84699754,27,24,131,182
"22555","chr9",85160899,85160922,24,15,70,109
"22556","chr9",85366594,85366611,18,77,39,134
"22557","chr9",85741900,85741949,50,89,25,164
"22558","chr9",85873999,85874027,29,78,6,113
"22559","chr9",85953218,85953239,22,148,1,171
"22560","chr9",86045353,86045372,20,129,4,153
"22561","chr9",86076422,86076454,33,18,73,124
"22562","chr9",86186373,86186486,114,2,10,126
"22563","chr9",86216631,86216659,29,121,103,253
"22564","chr9",86240686,86240726,41,76,2,119
"22565","chr9",86632855,86632874,20,76,50,146
"22566","chr9",87148505,87148523,19,77,81,177
"22567","chr9",87430256,87430346,91,28,124,243
"22568","chr9",87589056,87589079,24,26,143,193
"22569","chr9",87915292,87915318,27,98,5,130
"22570","chr9",87918761,87918787,27,98,5,130
"22571","chr9",88007229,88007255,27,1,47,75
"22572","chr9",88021435,88021460,26,74,74,174
"22573","chr9",88101118,88101138,21,7,81,109
"22574","chr9",88134157,88134183,27,7,96,130
"22575","chr9",88137625,88137651,27,7,96,130
"22576","chr9",88141123,88141140,18,4,2,24
"22577","chr9",88194789,88194818,30,9,43,82
"22578","chr9",88214270,88214295,26,8,136,170
"22579","chr9",88217097,88217120,24,76,92,192
"22580","chr9",88270096,88270117,22,35,10,67
"22581","chr9",88304583,88304604,22,8,64,94
"22582","chr9",88322241,88322265,25,7,124,156
"22583","chr9",88334321,88334344,24,62,44,130
"22584","chr9",88405537,88405556,20,71,2,93
"22585","chr9",88408966,88409010,45,5,141,191
"22586","chr9",88444682,88444708,27,8,6,41
"22587","chr9",88482228,88482250,23,30,96,149
"22588","chr9",88967926,88967952,27,24,75,126
"22589","chr9",89180556,89180583,28,126,10,164
"22590","chr9",89296506,89296535,30,23,109,162
"22591","chr9",89347466,89347489,24,69,140,233
"22592","chr9",89438965,89438999,35,8,11,54
"22593","chr9",89452174,89452196,23,8,88,119
"22594","chr9",89453858,89453875,18,76,17,111
"22595","chr9",89497978,89498006,29,62,48,139
"22596","chr9",89648376,89648394,19,91,82,192
"22597","chr9",89707322,89707340,19,44,64,127
"22598","chr9",89707562,89707661,100,38,35,173
"22599","chr9",90134504,90134532,29,6,79,114
"22600","chr9",91859824,91859847,24,5,7,36
"22601","chr9",92002395,92002420,26,145,13,184
"22602","chr9",92004726,92004745,20,31,63,114
"22603","chr9",92005510,92005532,23,87,72,182
"22604","chr9",92060744,92060763,20,118,34,172
"22605","chr9",92204735,92204757,23,75,23,121
"22606","chr9",92345251,92345275,25,85,76,186
"22607","chr9",92764802,92764831,30,16,36,82
"22608","chr9",92914108,92914147,40,111,6,157
"22609","chr9",92946093,92946114,22,22,18,62
"22610","chr9",92955473,92955493,21,45,105,171
"22611","chr9",93023796,93023821,26,123,98,247
"22612","chr9",93048237,93048267,31,4,3,38
"22613","chr9",93050172,93050194,23,110,75,208
"22614","chr9",93058660,93058680,21,35,50,106
"22615","chr9",93125895,93125921,27,19,142,188
"22616","chr9",93233198,93233217,20,86,10,116
"22617","chr9",93299593,93299610,18,125,111,254
"22618","chr9",93322306,93322336,31,76,141,248
"22619","chr9",93451522,93451546,25,35,23,83
"22620","chr9",93451697,93451719,23,4,22,49
"22621","chr9",93576892,93576916,25,36,62,123
"22622","chr9",93576978,93576997,20,20,74,114
"22623","chr9",93676649,93676704,56,116,25,197
"22624","chr9",93951568,93951594,27,8,56,91
"22625","chr9",93955404,93955433,30,58,10,98
"22626","chr9",94162957,94162975,19,3,74,96
"22627","chr9",94260088,94260106,19,44,66,129
"22628","chr9",94260813,94260838,26,9,10,45
"22629","chr9",94261015,94261049,35,66,48,149
"22630","chr9",94346108,94346141,34,26,4,64
"22631","chr9",94494070,94494087,18,76,31,125
"22632","chr9",94521302,94521321,20,71,73,164
"22633","chr9",94555113,94555148,36,112,102,250
"22634","chr9",94582851,94582871,21,76,7,104
"22635","chr9",94614131,94614204,74,93,24,191
"22636","chr9",94621214,94621237,24,68,6,98
"22637","chr9",94635087,94635110,24,34,76,134
"22638","chr9",94661474,94661526,53,77,36,166
"22639","chr9",94777626,94777651,26,76,92,194
"22640","chr9",94784925,94784950,26,6,118,150
"22641","chr9",94848452,94848473,22,78,74,174
"22642","chr9",95004941,95004987,47,27,12,86
"22643","chr9",95088508,95088527,20,5,118,143
"22644","chr9",95318611,95318628,18,110,10,138
"22645","chr9",95357147,95357170,24,144,73,241
"22646","chr9",95375427,95375452,26,88,7,121
"22647","chr9",95508365,95508387,23,31,7,61
"22648","chr9",95509243,95509273,31,108,33,172
"22649","chr9",95525913,95525940,28,129,7,164
"22650","chr9",95779776,95779819,44,72,97,213
"22651","chr9",96030702,96030720,19,82,6,107
"22652","chr9",96407002,96407028,27,70,74,171
"22653","chr9",96407981,96408019,39,119,70,228
"22654","chr9",96415222,96415240,19,30,75,124
"22655","chr9",96415480,96415515,36,8,31,75
"22656","chr9",96417583,96417608,26,52,22,100
"22657","chr9",96417977,96417996,20,15,22,57
"22658","chr9",96453088,96453109,22,100,143,265
"22659","chr9",96583371,96583414,44,76,117,237
"22660","chr9",96624442,96624478,37,25,87,149
"22661","chr9",96654925,96654955,31,62,110,203
"22662","chr9",96699557,96699575,19,72,65,156
"22663","chr9",96734508,96734530,23,6,59,88
"22664","chr9",96911500,96911538,39,8,13,60
"22665","chr9",97237764,97237796,33,11,10,54
"22666","chr9",97412046,97412091,46,12,18,76
"22667","chr9",97413076,97413095,20,91,2,113
"22668","chr9",97530788,97530806,19,9,140,168
"22669","chr9",97854413,97854451,39,34,5,78
"22670","chr9",97908412,97908431,20,69,74,163
"22671","chr9",98056747,98056764,18,80,80,178
"22672","chr9",98151815,98151834,20,8,143,171
"22673","chr9",98187283,98187309,27,77,6,110
"22674","chr9",98227782,98227799,18,116,74,208
"22675","chr9",98708638,98708671,34,33,107,174
"22676","chr9",98708679,98708705,27,4,66,97
"22677","chr9",98708891,98708922,32,17,20,69
"22678","chr9",99105166,99105184,19,44,26,89
"22679","chr9",99105256,99105283,28,3,63,94
"22680","chr9",99199706,99199724,19,14,70,103
"22681","chr9",99204883,99204906,24,62,34,120
"22682","chr9",99369013,99369035,23,145,71,239
"22683","chr9",99820032,99820076,45,70,39,154
"22684","chr9",99821691,99821709,19,113,94,226
"22685","chr9",99822746,99822779,34,135,74,243
"22686","chr9",99906589,99906615,27,68,133,228
"22687","chr9",100427251,100427272,22,12,61,95
"22688","chr9",100430325,100430342,18,7,94,119
"22689","chr9",100440932,100440953,22,76,138,236
"22690","chr9",100473999,100474018,20,123,65,208
"22691","chr9",100490837,100490898,62,124,110,296
"22692","chr9",100526956,100526981,26,133,31,190
"22693","chr9",100727453,100727479,27,59,102,188
"22694","chr9",101109135,101109158,24,90,66,180
"22695","chr9",101398944,101398966,23,32,46,101
"22696","chr9",101778706,101778741,36,8,115,159
"22697","chr9",103885041,103885074,34,77,27,138
"22698","chr9",104039213,104039247,35,43,55,133
"22699","chr9",104302738,104302772,35,100,144,279
"22700","chr9",104316035,104316083,49,81,38,168
"22701","chr9",104377476,104377495,20,118,14,152
"22702","chr9",104764541,104764558,18,9,85,112
"22703","chr9",104874570,104874603,34,142,70,246
"22704","chr9",104874583,104874607,25,146,57,228
"22705","chr9",104942375,104942401,27,9,11,47
"22706","chr9",105119617,105119636,20,7,90,117
"22707","chr9",105139940,105139988,49,20,147,216
"22708","chr9",105162043,105162074,32,49,64,145
"22709","chr9",105244585,105244603,19,64,88,171
"22710","chr9",105244728,105244754,27,56,99,182
"22711","chr9",105257088,105257109,22,71,143,236
"22712","chr9",105508175,105508195,21,75,5,101
"22713","chr9",105656220,105656238,19,38,53,110
"22714","chr9",105694835,105694859,25,88,85,198
"22715","chr9",105903236,105903283,48,5,111,164
"22716","chr9",106629157,106629193,37,145,25,207
"22717","chr9",106844639,106844677,39,78,36,153
"22718","chr9",106863000,106863135,136,65,67,268
"22719","chr9",107245876,107245895,20,36,61,117
"22720","chr9",107309931,107309950,20,102,74,196
"22721","chr9",107339851,107339870,20,19,75,114
"22722","chr9",107395793,107395816,24,6,4,34
"22723","chr9",107501527,107501553,27,6,71,104
"22724","chr9",107525445,107525465,21,13,1,35
"22725","chr9",107605730,107605750,21,76,67,164
"22726","chr9",108210529,108210562,34,11,76,121
"22727","chr9",108393601,108393621,21,42,113,176
"22728","chr9",108667293,108667318,26,119,74,219
"22729","chr9",108830378,108830404,27,40,14,81
"22730","chr9",109320481,109320510,30,6,34,70
"22731","chr9",109320699,109320717,19,10,36,65
"22732","chr9",109321009,109321042,34,9,56,99
"22733","chr9",109478955,109478989,35,143,105,283
"22734","chr9",109488094,109488114,21,40,24,85
"22735","chr9",109499842,109499870,29,47,51,127
"22736","chr9",109532945,109532972,28,75,5,108
"22737","chr9",109533127,109533155,29,69,71,169
"22738","chr9",109534623,109534653,31,28,25,84
"22739","chr9",109598876,109598894,19,122,5,146
"22740","chr9",110049379,110049402,24,52,17,93
"22741","chr9",110050611,110050648,38,11,107,156
"22742","chr9",110109319,110109336,18,36,72,126
"22743","chr9",110198894,110198918,25,12,5,42
"22744","chr9",110203012,110203032,21,69,91,181
"22745","chr9",110466761,110466778,18,126,6,150
"22746","chr9",110694216,110694236,21,77,56,154
"22747","chr9",111504820,111504848,29,39,35,103
"22748","chr9",111504848,111504874,27,65,7,99
"22749","chr9",111505035,111505055,21,120,75,216
"22750","chr9",111519277,111519306,30,74,111,215
"22751","chr9",111534719,111534741,23,76,46,145
"22752","chr9",111560637,111560659,23,92,10,125
"22753","chr9",111740878,111740906,29,7,90,126
"22754","chr9",111796063,111796085,23,77,26,126
"22755","chr9",111803876,111803897,22,62,74,158
"22756","chr9",111828117,111828146,30,30,62,122
"22757","chr9",111856845,111856866,22,71,3,96
"22758","chr9",112155829,112156042,214,8,91,313
"22759","chr9",112176496,112176584,89,31,124,244
"22760","chr9",112176578,112176596,19,43,42,104
"22761","chr9",112330015,112330032,18,34,73,125
"22762","chr9",112380050,112380080,31,53,117,201
"22763","chr9",112486782,112486829,48,26,121,195
"22764","chr9",112523445,112523468,24,142,12,178
"22765","chr9",112682606,112682634,29,76,7,112
"22766","chr9",112725441,112725465,25,149,5,179
"22767","chr9",112819247,112819284,38,77,49,164
"22768","chr9",113150983,113151004,22,66,115,203
"22769","chr9",113294543,113294562,20,132,69,221
"22770","chr9",113303905,113303938,34,8,63,105
"22771","chr9",113314160,113314179,20,22,6,48
"22772","chr9",113314200,113314232,33,75,34,142
"22773","chr9",113324390,113324407,18,76,83,177
"22774","chr9",113344448,113344473,26,76,101,203
"22775","chr9",113349586,113349638,53,38,62,153
"22776","chr9",113376347,113376369,23,80,20,123
"22777","chr9",113804873,113804897,25,3,66,94
"22778","chr9",113876052,113876069,18,11,112,141
"22779","chr9",113876277,113876308,32,4,53,89
"22780","chr9",114155987,114156009,23,85,22,130
"22781","chr9",114611534,114611558,25,73,20,118
"22782","chr9",114702789,114702808,20,69,101,190
"22783","chr9",115199526,115199544,19,123,6,148
"22784","chr9",115922075,115922099,25,97,73,195
"22785","chr9",116154328,116154367,40,21,73,134
"22786","chr9",116267882,116267909,28,31,67,126
"22787","chr9",117414644,117414677,34,37,61,132
"22788","chr9",117414812,117414848,37,73,6,116
"22789","chr9",117414963,117414990,28,48,48,124
"22790","chr9",117923457,117923476,20,7,86,113
"22791","chr9",118114164,118114188,25,6,74,105
"22792","chr9",118514462,118514508,47,50,8,105
"22793","chr9",118514477,118514532,56,74,61,191
"22794","chr9",118664320,118664337,18,36,127,181
"22795","chr9",118695567,118695590,24,15,11,50
"22796","chr9",119369302,119369321,20,5,1,26
"22797","chr9",119417627,119417650,24,77,90,191
"22798","chr9",119599202,119599225,24,36,6,66
"22799","chr9",119952516,119952595,80,117,87,284
"22800","chr9",119952593,119952625,33,147,10,190
"22801","chr9",120081243,120081276,34,28,64,126
"22802","chr9",120342643,120342679,37,58,66,161
"22803","chr9",120382256,120382278,23,1,96,120
"22804","chr9",120589416,120589460,45,75,11,131
"22805","chr9",120714260,120714290,31,2,8,41
"22806","chr9",120877219,120877244,26,12,41,79
"22807","chr9",121223657,121223675,19,7,59,85
"22808","chr9",121320646,121320674,29,38,73,140
"22809","chr9",121530364,121530381,18,134,146,298
"22810","chr9",121553027,121553081,55,48,94,197
"22811","chr9",121699429,121699446,18,9,137,164
"22812","chr9",121897619,121897641,23,125,4,152
"22813","chr9",121985504,121985534,31,8,32,71
"22814","chr9",122093181,122093208,28,14,80,122
"22815","chr9",122094233,122094272,40,11,14,65
"22816","chr9",122094245,122094284,40,10,2,52
"22817","chr9",122119680,122119699,20,120,74,214
"22818","chr9",122126846,122126874,29,37,17,83
"22819","chr9",122788388,122788415,28,133,6,167
"22820","chr9",122827561,122827580,20,75,32,127
"22821","chr9",122905288,122905334,47,69,9,125
"22822","chr9",122913184,122913209,26,26,36,88
"22823","chr9",122915019,122915045,27,10,44,81
"22824","chr9",123108822,123108841,20,110,4,134
"22825","chr9",123284685,123284730,46,42,116,204
"22826","chr9",123299262,123299288,27,15,9,51
"22827","chr9",123376903,123376920,18,28,32,78
"22828","chr9",123398365,123398387,23,3,41,67
"22829","chr9",123464995,123465019,25,65,25,115
"22830","chr9",123903332,123903358,27,48,6,81
"22831","chr9",123918119,123918141,23,82,1,106
"22832","chr9",123929827,123929880,54,55,7,116
"22833","chr9",123999671,123999696,26,15,9,50
"22834","chr9",124011714,124011764,51,139,57,247
"22835","chr9",124016226,124016254,29,1,42,72
"22836","chr9",124064910,124064930,21,62,127,210
"22837","chr9",124090111,124090464,354,5,131,490
"22838","chr9",124140291,124140316,26,57,114,197
"22839","chr9",124146727,124146762,36,75,33,144
"22840","chr9",124190214,124190257,44,30,6,80
"22841","chr9",124334745,124334763,19,57,56,132
"22842","chr9",124350107,124350133,27,16,52,95
"22843","chr9",124444473,124444512,40,74,87,201
"22844","chr9",124492504,124492528,25,45,51,121
"22845","chr9",124504008,124504074,67,2,51,120
"22846","chr9",124628810,124628833,24,29,73,126
"22847","chr9",124745672,124745689,18,136,5,159
"22848","chr9",124771269,124771300,32,53,24,109
"22849","chr9",124777076,124777093,18,1,65,84
"22850","chr9",124847694,124847728,35,9,43,87
"22851","chr9",124869377,124869396,20,84,37,141
"22852","chr9",125006481,125006508,28,7,46,81
"22853","chr9",125007838,125007862,25,7,62,94
"22854","chr9",125069618,125069640,23,75,10,108
"22855","chr9",125075565,125075582,18,7,52,77
"22856","chr9",125167380,125167412,33,147,75,255
"22857","chr9",125221160,125221202,43,135,7,185
"22858","chr9",125323283,125323321,39,74,66,179
"22859","chr9",125408902,125408936,35,74,55,164
"22860","chr9",125409652,125410266,615,79,30,724
"22861","chr9",125722592,125722628,37,8,100,145
"22862","chr9",125746944,125746969,26,3,26,55
"22863","chr9",125747172,125747199,28,46,51,125
"22864","chr9",125747345,125747366,22,28,13,63
"22865","chr9",125747385,125747406,22,68,21,111
"22866","chr9",126005550,126005578,29,7,57,93
"22867","chr9",126005564,126005586,23,15,43,81
"22868","chr9",126035914,126035932,19,45,74,138
"22869","chr9",126052879,126052896,18,19,94,131
"22870","chr9",126164281,126164304,24,101,13,138
"22871","chr9",126326767,126326845,79,2,70,151
"22872","chr9",126326966,126326997,32,27,62,121
"22873","chr9",126509319,126509349,31,76,7,114
"22874","chr9",126540082,126540099,18,77,73,168
"22875","chr9",126555591,126555614,24,127,7,158
"22876","chr9",126555920,126555941,22,42,7,71
"22877","chr9",126556194,126556216,23,8,6,37
"22878","chr9",126614094,126614132,39,4,1,44
"22879","chr9",126682895,126682915,21,20,6,47
"22880","chr9",126730364,126730391,28,78,11,117
"22881","chr9",126757577,126757598,22,76,14,112
"22882","chr9",126780831,126780861,31,140,76,247
"22883","chr9",126850542,126850569,28,29,143,200
"22884","chr9",126915030,126915053,24,10,11,45
"22885","chr9",127018213,127018236,24,114,11,149
"22886","chr9",127224904,127224948,45,55,101,201
"22887","chr9",127460848,127460873,26,121,24,171
"22888","chr9",127494941,127494965,25,72,10,107
"22889","chr9",127502687,127502710,24,126,74,224
"22890","chr9",127554532,127554578,47,8,33,88
"22891","chr9",127569148,127569214,67,44,13,124
"22892","chr9",127640206,127640251,46,76,142,264
"22893","chr9",127646813,127646842,30,78,143,251
"22894","chr9",127649184,127649205,22,33,142,197
"22895","chr9",127649213,127649243,31,71,113,215
"22896","chr9",127677926,127677945,20,8,86,114
"22897","chr9",127721700,127721721,22,80,98,200
"22898","chr9",127725564,127725586,23,45,6,74
"22899","chr9",127736605,127736740,136,126,56,318
"22900","chr9",127737071,127737118,48,49,45,142
"22901","chr9",127764697,127764726,30,10,114,154
"22902","chr9",127785879,127785921,43,49,16,108
"22903","chr9",127821881,127821903,23,80,76,179
"22904","chr9",127824513,127824536,24,126,19,169
"22905","chr9",127877388,127877415,28,3,94,125
"22906","chr9",127898405,127898431,27,16,31,74
"22907","chr9",127898429,127898453,25,38,7,70
"22908","chr9",127899435,127899474,40,3,47,90
"22909","chr9",127917038,127917063,26,50,26,102
"22910","chr9",127984525,127984547,23,7,5,35
"22911","chr9",127986524,127986545,22,43,6,71
"22912","chr9",127990261,127990283,23,145,84,252
"22913","chr9",128029859,128029882,24,86,40,150
"22914","chr9",128049439,128049466,28,136,73,237
"22915","chr9",128051685,128051711,27,88,74,189
"22916","chr9",128053272,128053289,18,60,71,149
"22917","chr9",128055357,128055411,55,66,46,167
"22918","chr9",128070085,128070110,26,79,75,180
"22919","chr9",128070549,128070574,26,3,137,166
"22920","chr9",128105159,128105186,28,6,145,179
"22921","chr9",128110550,128110585,36,121,69,226
"22922","chr9",128121912,128121952,41,80,7,128
"22923","chr9",128160205,128160227,23,35,15,73
"22924","chr9",128263418,128263435,18,8,143,169
"22925","chr9",128264216,128264246,31,70,23,124
"22926","chr9",128264411,128264444,34,76,66,176
"22927","chr9",128287142,128287162,21,147,73,241
"22928","chr9",128294899,128294916,18,147,6,171
"22929","chr9",128312135,128312154,20,7,11,38
"22930","chr9",128312616,128312633,18,9,125,152
"22931","chr9",128371210,128371244,35,56,123,214
"22932","chr9",128412780,128412801,22,7,27,56
"22933","chr9",128413880,128413903,24,30,124,178
"22934","chr9",128415974,128415997,24,92,6,122
"22935","chr9",128418576,128418614,39,7,67,113
"22936","chr9",128433279,128433301,23,77,124,224
"22937","chr9",128443983,128444009,27,26,79,132
"22938","chr9",128444145,128444162,18,8,139,165
"22939","chr9",128453030,128453052,23,76,8,107
"22940","chr9",128453856,128453873,18,21,4,43
"22941","chr9",128454539,128454562,24,8,105,137
"22942","chr9",128455554,128455593,40,58,6,104
"22943","chr9",128482897,128482915,19,78,17,114
"22944","chr9",128497424,128497447,24,30,35,89
"22945","chr9",128497447,128497491,45,74,12,131
"22946","chr9",128511255,128511289,35,11,23,69
"22947","chr9",128561663,128561688,26,81,6,113
"22948","chr9",128570646,128570671,26,97,2,125
"22949","chr9",128589576,128589593,18,8,145,171
"22950","chr9",128596250,128596291,42,5,39,86
"22951","chr9",128642454,128642477,24,136,8,168
"22952","chr9",128655336,128655361,26,27,36,89
"22953","chr9",128665770,128665791,22,11,119,152
"22954","chr9",128689320,128689346,27,25,1,53
"22955","chr9",128689920,128689958,39,9,9,57
"22956","chr9",128698178,128698202,25,76,128,229
"22957","chr9",128699960,128699980,21,77,3,101
"22958","chr9",128701942,128701966,25,8,65,98
"22959","chr9",128704917,128704954,38,128,7,173
"22960","chr9",128738031,128738062,32,8,117,157
"22961","chr9",128738369,128738403,35,8,120,163
"22962","chr9",128787183,128787200,18,11,40,69
"22963","chr9",128787277,128787330,54,1,115,170
"22964","chr9",128795438,128795478,41,76,16,133
"22965","chr9",128866600,128866623,24,143,5,172
"22966","chr9",128876894,128876914,21,74,75,170
"22967","chr9",128931826,128931849,24,5,9,38
"22968","chr9",128932150,128932186,37,116,130,283
"22969","chr9",128933151,128933172,22,45,7,74
"22970","chr9",128954384,128954402,19,76,73,168
"22971","chr9",128984125,128984143,19,6,6,31
"22972","chr9",128991898,128991925,28,9,19,56
"22973","chr9",129027034,129027056,23,108,102,233
"22974","chr9",129034402,129034449,48,96,121,265
"22975","chr9",129035242,129035262,21,76,145,242
"22976","chr9",129039548,129039572,25,72,8,105
"22977","chr9",129039725,129039760,36,65,76,177
"22978","chr9",129045442,129045467,26,138,74,238
"22979","chr9",129061359,129061378,20,1,127,148
"22980","chr9",129066960,129066986,27,77,7,111
"22981","chr9",129079815,129079832,18,11,100,129
"22982","chr9",129126177,129126216,40,81,46,167
"22983","chr9",129166745,129166769,25,21,16,62
"22984","chr9",129177482,129177504,23,32,11,66
"22985","chr9",129177854,129177878,25,146,26,197
"22986","chr9",129180528,129180546,19,77,74,170
"22987","chr9",129197141,129197159,19,66,11,96
"22988","chr9",129262582,129262602,21,5,58,84
"22989","chr9",129290455,129290569,115,70,114,299
"22990","chr9",129344629,129344672,44,105,8,157
"22991","chr9",129356794,129356822,29,121,71,221
"22992","chr9",129438543,129438566,24,75,133,232
"22993","chr9",129448197,129448219,23,77,136,236
"22994","chr9",129469130,129469147,18,138,14,170
"22995","chr9",129470557,129470582,26,106,75,207
"22996","chr9",129493789,129493816,28,116,27,171
"22997","chr9",129513101,129513129,29,112,5,146
"22998","chr9",129513127,129513146,20,129,46,195
"22999","chr9",129517429,129517496,68,71,79,218
"23000","chr9",129517457,129517532,76,107,51,234
"23001","chr9",129544244,129544272,29,74,3,106
"23002","chr9",129558792,129558844,53,90,6,149
"23003","chr9",129568849,129568878,30,2,5,37
"23004","chr9",129652457,129652569,113,75,22,210
"23005","chr9",129653955,129653972,18,139,147,304
"23006","chr9",129657569,129657596,28,85,6,119
"23007","chr9",129660259,129660295,37,62,34,133
"23008","chr9",129664683,129664726,44,4,3,51
"23009","chr9",129666157,129666199,43,147,16,206
"23010","chr9",129672883,129672925,43,99,25,167
"23011","chr9",129744572,129744593,22,147,101,270
"23012","chr9",129760650,129760668,19,4,32,55
"23013","chr9",129764158,129764177,20,65,6,91
"23014","chr9",129770210,129770232,23,58,143,224
"23015","chr9",129797237,129797254,18,77,27,122
"23016","chr9",129808544,129808566,23,75,29,127
"23017","chr9",129823491,129823538,48,6,48,102
"23018","chr9",129823661,129823774,114,12,57,183
"23019","chr9",129823861,129823904,44,63,14,121
"23020","chr9",129892367,129892417,51,139,96,286
"23021","chr9",130038400,130038417,18,11,29,58
"23022","chr9",130046581,130046618,38,18,24,80
"23023","chr9",130069985,130070011,27,5,11,43
"23024","chr9",130070164,130070181,18,117,143,278
"23025","chr9",130081672,130081698,27,137,7,171
"23026","chr9",130172577,130172598,22,114,9,145
"23027","chr9",130172778,130172797,20,13,2,35
"23028","chr9",130178835,130178939,105,63,14,182
"23029","chr9",130211011,130211031,21,121,138,280
"23030","chr9",130265926,130265946,21,81,37,139
"23031","chr9",130330969,130331007,39,144,32,215
"23032","chr9",130420066,130420089,24,5,19,48
"23033","chr9",130479282,130479305,24,71,2,97
"23034","chr9",130499676,130499702,27,37,18,82
"23035","chr9",130550930,130550955,26,6,128,160
"23036","chr9",130570045,130570062,18,5,74,97
"23037","chr9",130579630,130579678,49,51,62,162
"23038","chr9",130649893,130649916,24,88,29,141
"23039","chr9",130669816,130669837,22,144,6,172
"23040","chr9",130681221,130681241,21,132,64,217
"23041","chr9",130681606,130681641,36,28,45,109
"23042","chr9",130707892,130707914,23,74,71,168
"23043","chr9",130814880,130814944,65,40,3,108
"23044","chr9",130821841,130821858,18,10,96,124
"23045","chr9",130835697,130835781,85,60,84,229
"23046","chr9",130859678,130859706,29,16,55,100
"23047","chr9",130889674,130889694,21,9,6,36
"23048","chr9",130912393,130912416,24,139,87,250
"23049","chr9",130938674,130938699,26,104,31,161
"23050","chr9",131000384,131000405,22,70,136,228
"23051","chr9",131004495,131004526,32,10,32,74
"23052","chr9",131096389,131096439,51,39,20,110
"23053","chr9",131105360,131105380,21,74,18,113
"23054","chr9",131244019,131244040,22,30,74,126
"23055","chr9",131270033,131270059,27,80,33,140
"23056","chr9",131272935,131272959,25,32,52,109
"23057","chr9",131301814,131301834,21,76,67,164
"23058","chr9",131314116,131314133,18,8,39,65
"23059","chr9",131334610,131334635,26,39,18,83
"23060","chr9",131350576,131350617,42,4,48,94
"23061","chr9",131353878,131353900,23,14,6,43
"23062","chr9",131364363,131364383,21,8,12,41
"23063","chr9",131376047,131376066,20,147,8,175
"23064","chr9",131386993,131387017,25,74,86,185
"23065","chr9",131394270,131394293,24,11,8,43
"23066","chr9",131411306,131411364,59,76,25,160
"23067","chr9",131472472,131472494,23,76,75,174
"23068","chr9",131502596,131502624,29,126,5,160
"23069","chr9",131543237,131543259,23,18,79,120
"23070","chr9",131730698,131730718,21,122,3,146
"23071","chr9",131745956,131745987,32,77,28,137
"23072","chr9",131939901,131939920,20,72,74,166
"23073","chr9",132003994,132004027,34,76,65,175
"23074","chr9",132162065,132162083,19,16,41,76
"23075","chr9",132190233,132190261,29,17,74,120
"23076","chr9",132196160,132196207,48,7,20,75
"23077","chr9",132248343,132248366,24,43,51,118
"23078","chr9",132254529,132254560,32,19,74,125
"23079","chr9",132294026,132294050,25,109,4,138
"23080","chr9",132355990,132356012,23,89,71,183
"23081","chr9",132364795,132364812,18,70,7,95
"23082","chr9",132432707,132432730,24,75,67,166
"23083","chr9",132438866,132438888,23,71,118,212
"23084","chr9",132451339,132451357,19,63,5,87
"23085","chr9",132469839,132469856,18,7,52,77
"23086","chr9",132529825,132529862,38,134,75,247
"23087","chr9",132681967,132681990,24,64,28,116
"23088","chr9",132999493,132999560,68,42,21,131
"23089","chr9",133022871,133022897,27,34,143,204
"23090","chr9",133038451,133038468,18,8,4,30
"23091","chr9",133057882,133057919,38,28,35,101
"23092","chr9",133199054,133199075,22,31,125,178
"23093","chr9",133240230,133240268,39,76,33,148
"23094","chr9",133266030,133266068,39,128,124,291
"23095","chr9",133335876,133335899,24,27,34,85
"23096","chr9",133364691,133364708,18,45,75,138
"23097","chr9",133375984,133376017,34,12,27,73
"23098","chr9",133396769,133396786,18,28,62,108
"23099","chr9",133428569,133428594,26,24,85,135
"23100","chr9",133431648,133431671,24,7,38,69
"23101","chr9",133435499,133435546,48,7,135,190
"23102","chr9",133450566,133450589,24,67,8,99
"23103","chr9",133460238,133460264,27,11,2,40
"23104","chr9",133460460,133460490,31,147,8,186
"23105","chr9",133470190,133470241,52,46,110,208
"23106","chr9",133533262,133533280,19,20,18,57
"23107","chr9",133565840,133565875,36,95,30,161
"23108","chr9",133604760,133604779,20,29,94,143
"23109","chr9",133658836,133658853,18,142,14,174
"23110","chr9",133757601,133757620,20,76,41,137
"23111","chr9",133898817,133898841,25,10,29,64
"23112","chr9",133903079,133903096,18,60,70,148
"23113","chr9",133910647,133910664,18,67,85,170
"23114","chr9",133983787,133983811,25,144,50,219
"23115","chr9",133989520,133989538,19,129,6,154
"23116","chr9",134006558,134006583,26,27,143,196
"23117","chr9",134017980,134017999,20,104,10,134
"23118","chr9",134067712,134067738,27,8,30,65
"23119","chr9",134067786,134067806,21,76,5,102
"23120","chr9",134068958,134068995,38,59,24,121
"23121","chr9",134068975,134068998,24,62,7,93
"23122","chr9",134107161,134107187,27,134,5,166
"23123","chr9",134123673,134123698,26,76,73,175
"23124","chr9",134126779,134126807,29,9,82,120
"23125","chr9",134130409,134130434,26,14,7,47
"23126","chr9",134221559,134221580,22,80,3,105
"23127","chr9",134298380,134298410,31,7,72,110
"23128","chr9",134326095,134326136,42,19,15,76
"23129","chr9",134326389,134326428,40,1,29,70
"23130","chr9",134326488,134326547,60,5,24,89
"23131","chr9",134438843,134438866,24,60,49,133
"23132","chr9",134523930,134523956,27,82,45,154
"23133","chr9",134524300,134524326,27,72,55,154
"23134","chr9",134524370,134524396,27,142,45,214
"23135","chr9",134524440,134524466,27,22,45,94
"23136","chr9",134524630,134524656,27,142,115,284
"23137","chr9",134642253,134642271,19,58,7,84
"23138","chr9",134749234,134749258,25,43,74,142
"23139","chr9",134753749,134753779,31,46,64,141
"23140","chr9",135087826,135087865,40,69,11,120
"23141","chr9",135088171,135088200,30,55,88,173
"23142","chr9",135107132,135107174,43,103,142,288
"23143","chr9",135124474,135124771,298,18,56,372
"23144","chr9",135207105,135207132,28,74,101,203
"23145","chr9",135293456,135293474,19,79,25,123
"23146","chr9",135354991,135355009,19,5,17,41
"23147","chr9",135426756,135426775,20,29,143,192
"23148","chr9",135479550,135479567,18,22,25,65
"23149","chr9",135633241,135633267,27,76,129,232
"23150","chr9",135714438,135714461,24,100,36,160
"23151","chr9",135774117,135774660,544,68,66,678
"23152","chr9",135784483,135784528,46,83,98,227
"23153","chr9",135786171,135786194,24,71,130,225
"23154","chr9",135907411,135907464,54,63,3,120
"23155","chr9",135959373,135959393,21,77,45,143
"23156","chr9",135966314,135966347,34,19,38,91
"23157","chr9",135995435,135995458,24,8,122,154
"23158","chr9",136000005,136000049,45,15,4,64
"23159","chr9",136051877,136051939,63,40,24,127
"23160","chr9",136067268,136067286,19,133,20,172
"23161","chr9",136077008,136077030,23,77,8,108
"23162","chr9",136099881,136099901,21,64,1,86
"23163","chr9",136102994,136103014,21,41,75,137
"23164","chr9",136257377,136257408,32,42,70,144
"23165","chr9",136289519,136289542,24,41,6,71
"23166","chr9",136323468,136323492,25,9,66,100
"23167","chr9",136327771,136327798,28,32,48,108
"23168","chr9",136383543,136383606,64,48,75,187
"23169","chr9",136407564,136407585,22,65,3,90
"23170","chr9",136420146,136420185,40,76,76,192
"23171","chr9",136421405,136421427,23,76,66,165
"23172","chr9",136545980,136546017,38,56,8,102
"23173","chr9",136576896,136576925,30,5,122,157
"23174","chr9",136637540,136637562,23,136,30,189
"23175","chr9",136646468,136646487,20,12,31,63
"23176","chr9",136653663,136653685,23,27,44,94
"23177","chr9",136654723,136654745,23,122,6,151
"23178","chr9",136665697,136665751,55,1,23,79
"23179","chr9",136666066,136666091,26,56,29,111
"23180","chr9",136692204,136692230,27,8,115,150
"23181","chr9",136712596,136712614,19,9,108,136
"23182","chr9",136716265,136716286,22,77,85,184
"23183","chr9",136725212,136725233,22,76,95,193
"23184","chr9",136737286,136737304,19,75,142,236
"23185","chr9",136758672,136758695,24,5,29,58
"23186","chr9",136763832,136763859,28,138,32,198
"23187","chr9",136798004,136798022,19,75,59,153
"23188","chr9",136842728,136842746,19,91,116,226
"23189","chr9",136866477,136866494,18,17,117,152
"23190","chr9",136866935,136866961,27,69,75,171
"23191","chr9",136886468,136886488,21,118,31,170
"23192","chr9",136886554,136886617,64,37,117,218
"23193","chr9",136904397,136904423,27,100,118,245
"23194","chr9",136938404,136938423,20,38,75,133
"23195","chr9",136973764,136973801,38,122,118,278
"23196","chr9",136987094,136987116,23,86,4,113
"23197","chr9",137001836,137001855,20,66,13,99
"23198","chr9",137017931,137017955,25,3,16,44
"23199","chr9",137042560,137042580,21,11,4,36
"23200","chr9",137048914,137048938,25,65,22,112
"23201","chr9",137073059,137073077,19,3,5,27
"23202","chr9",137075989,137076010,22,76,147,245
"23203","chr9",137077398,137077428,31,1,31,63
"23204","chr9",137098602,137098623,22,47,106,175
"23205","chr9",137118341,137118365,25,78,92,195
"23206","chr9",137119949,137119972,24,76,25,125
"23207","chr9",137120123,137120140,18,134,6,158
"23208","chr9",137134647,137134669,23,12,6,41
"23209","chr9",137139198,137139216,19,6,123,148
"23210","chr9",137151900,137151920,21,72,76,169
"23211","chr9",137169887,137169911,25,98,6,129
"23212","chr9",137182206,137182228,23,145,23,191
"23213","chr9",137200212,137200240,29,18,21,68
"23214","chr9",137208453,137208494,42,87,4,133
"23215","chr9",137222155,137222189,35,1,3,39
"23216","chr9",137239618,137239638,21,79,6,106
"23217","chr9",137240447,137240473,27,75,88,190
"23218","chr9",137257490,137257519,30,7,75,112
"23219","chr9",137260033,137260066,34,75,2,111
"23220","chr9",137261658,137261677,20,34,19,73
"23221","chr9",137263345,137263362,18,56,106,180
"23222","chr9",137265388,137265406,19,8,18,45
"23223","chr9",137288270,137288301,32,20,72,124
"23224","chr9",137291575,137291599,25,9,145,179
"23225","chr9",137308635,137308653,19,7,78,104
"23226","chr9",137390120,137390147,28,10,121,159
"23227","chr9",137391637,137391659,23,144,31,198
"23228","chr9",137408547,137408565,19,57,6,82
"23229","chr9",137411708,137411757,50,39,101,190
"23230","chr9",137413504,137413523,20,12,7,39
"23231","chr9",137423468,137423485,18,6,33,57
"23232","chr9",137432280,137432298,19,63,12,94
"23233","chr9",137459192,137459265,74,47,84,205
"23234","chr9",137549570,137549588,19,59,6,84
"23235","chr9",137573361,137573383,23,134,6,163
"23236","chr9",137590462,137590491,30,3,11,44
"23237","chr9",137591365,137591383,19,8,38,65
"23238","chr9",137597929,137597957,29,43,8,80
"23239","chr9",137599734,137599758,25,80,73,178
"23240","chr9",137601210,137601260,51,45,73,169
"23241","chr9",137601260,137601291,32,8,23,63
"23242","chr9",137614709,137614733,25,54,16,95
"23243","chr9",137616206,137616227,22,33,34,89
"23244","chr9",137618904,137618933,30,20,66,116
"23245","chr9",137619174,137619202,29,73,40,142
"23246","chr9",137619205,137619227,23,98,9,130
"23247","chr9",137624308,137624325,18,67,143,228
"23248","chr9",137662777,137662811,35,8,83,126
"23249","chr9",137675631,137675651,21,29,130,180
"23250","chr9",137675780,137675802,23,9,74,106
"23251","chr9",137768530,137768567,38,8,16,62
"23252","chr9",137821319,137821343,25,6,145,176
"23253","chr9",137862886,137862908,23,76,37,136
"23254","chr9",137877652,137877689,38,4,21,63
"23255","chr9",137878225,137878261,37,115,46,198
"23256","chr9",137878231,137878282,52,4,40,96
"23257","chr9",138020099,138020119,21,92,72,185
"23258","chr9",138079875,138079892,18,21,74,113
"23259","chr9",138148234,138148254,21,77,31,129
"23260","chrX",264745,264907,163,80,65,308
"23261","chrX",266297,266332,36,9,6,51
"23262","chrX",267667,267689,23,25,144,192
"23263","chrX",281352,281381,30,147,39,216
"23264","chrX",289497,289530,34,9,35,78
"23265","chrX",315532,315586,55,71,55,181
"23266","chrX",315607,315633,27,118,67,212
"23267","chrX",315674,315706,33,12,142,187
"23268","chrX",315731,315771,41,77,85,203
"23269","chrX",315792,315832,41,12,24,77
"23270","chrX",315875,315893,19,73,120,212
"23271","chrX",315918,315958,41,12,77,130
"23272","chrX",315979,316019,41,73,16,130
"23273","chrX",316044,316084,41,138,77,256
"23274","chrX",319240,319261,22,34,42,98
"23275","chrX",321470,321492,23,8,33,64
"23276","chrX",324494,324522,29,68,28,125
"23277","chrX",364507,364554,48,131,34,213
"23278","chrX",384983,385006,24,98,8,130
"23279","chrX",386722,386744,23,13,7,43
"23280","chrX",411604,411646,43,6,76,125
"23281","chrX",411935,411961,27,63,6,96
"23282","chrX",420963,420983,21,74,33,128
"23283","chrX",422475,422494,20,76,44,140
"23284","chrX",433183,433220,38,7,18,63
"23285","chrX",434993,435035,43,39,16,98
"23286","chrX",435984,436008,25,64,43,132
"23287","chrX",436379,437326,948,21,68,1037
"23288","chrX",466139,466173,35,127,50,212
"23289","chrX",473752,473778,27,76,67,170
"23290","chrX",481385,482115,731,63,37,831
"23291","chrX",490648,490666,19,69,59,147
"23292","chrX",490954,490979,26,35,12,73
"23293","chrX",499600,499636,37,106,38,181
"23294","chrX",519344,519367,24,59,3,86
"23295","chrX",534839,535304,466,25,25,516
"23296","chrX",536635,536666,32,17,76,125
"23297","chrX",541186,541208,23,129,70,222
"23298","chrX",560094,560116,23,74,105,202
"23299","chrX",570932,570976,45,6,11,62
"23300","chrX",588951,589018,68,38,7,113
"23301","chrX",589173,589192,20,76,50,146
"23302","chrX",615080,615099,20,62,40,122
"23303","chrX",616118,616152,35,42,6,83
"23304","chrX",619485,619502,18,22,45,85
"23305","chrX",650793,650819,27,28,11,66
"23306","chrX",670506,670539,34,49,71,154
"23307","chrX",676696,676764,69,122,8,199
"23308","chrX",677285,677304,20,122,6,148
"23309","chrX",730315,731170,856,78,66,1000
"23310","chrX",766935,767126,192,69,6,267
"23311","chrX",782545,782570,26,9,145,180
"23312","chrX",789922,789948,27,73,138,238
"23313","chrX",790235,790275,41,95,127,263
"23314","chrX",806940,807021,82,117,11,210
"23315","chrX",816739,816779,41,86,3,130
"23316","chrX",817868,818009,142,122,51,315
"23317","chrX",823774,823791,18,35,68,121
"23318","chrX",850549,850588,40,12,104,156
"23319","chrX",860029,860056,28,11,128,167
"23320","chrX",863550,863576,27,8,137,172
"23321","chrX",887870,887965,96,5,67,168
"23322","chrX",904433,904465,33,5,33,71
"23323","chrX",905830,905862,33,18,4,55
"23324","chrX",934402,934455,54,7,9,70
"23325","chrX",936416,936592,177,3,22,202
"23326","chrX",961232,961254,23,76,48,147
"23327","chrX",1005629,1005656,28,111,7,146
"23328","chrX",1011473,1011496,24,69,74,167
"23329","chrX",1123110,1123134,25,79,4,108
"23330","chrX",1139723,1139749,27,58,130,215
"23331","chrX",1141893,1141927,35,18,72,125
"23332","chrX",1148164,1148214,51,86,130,267
"23333","chrX",1148589,1148626,38,73,111,222
"23334","chrX",1163151,1163201,51,31,5,87
"23335","chrX",1166614,1166632,19,65,139,223
"23336","chrX",1195740,1196030,291,5,111,407
"23337","chrX",1196188,1196205,18,8,3,29
"23338","chrX",1204989,1205009,21,3,140,164
"23339","chrX",1206943,1206963,21,76,146,243
"23340","chrX",1217535,1217560,26,56,7,89
"23341","chrX",1231656,1231674,19,145,6,170
"23342","chrX",1233311,1233370,60,104,88,252
"23343","chrX",1240643,1240679,37,57,6,100
"23344","chrX",1243667,1243684,18,111,74,203
"23345","chrX",1261637,1261721,85,5,31,121
"23346","chrX",1271333,1271356,24,75,135,234
"23347","chrX",1273748,1273779,32,37,26,95
"23348","chrX",1277594,1277617,24,70,76,170
"23349","chrX",1299916,1299933,18,9,76,103
"23350","chrX",1301913,1301934,22,8,138,168
"23351","chrX",1304088,1304106,19,127,128,274
"23352","chrX",1310668,1310685,18,15,74,107
"23353","chrX",1317247,1317268,22,7,10,39
"23354","chrX",1318976,1319011,36,74,15,125
"23355","chrX",1322100,1322121,22,6,42,70
"23356","chrX",1323135,1323157,23,73,68,164
"23357","chrX",1323159,1323186,28,20,44,92
"23358","chrX",1326726,1326751,26,123,5,154
"23359","chrX",1345465,1345504,40,5,118,163
"23360","chrX",1347620,1347679,60,70,37,167
"23361","chrX",1360032,1360095,64,55,125,244
"23362","chrX",1377873,1377902,30,11,86,127
"23363","chrX",1378183,1378217,35,42,9,86
"23364","chrX",1380420,1380667,248,17,133,398
"23365","chrX",1392946,1393032,87,147,28,262
"23366","chrX",1398315,1398335,21,7,78,106
"23367","chrX",1434795,1434833,39,14,15,68
"23368","chrX",1497222,1497256,35,28,74,137
"23369","chrX",1497657,1497677,21,85,7,113
"23370","chrX",1521945,1521969,25,75,4,104
"23371","chrX",1533003,1533051,49,77,3,129
"23372","chrX",1539585,1539623,39,68,70,177
"23373","chrX",1611884,1611901,18,43,75,136
"23374","chrX",1620094,1620120,27,7,5,39
"23375","chrX",1662858,1662886,29,36,135,200
"23376","chrX",1668669,1668687,19,36,62,117
"23377","chrX",1670621,1670645,25,28,76,129
"23378","chrX",1695822,1695842,21,30,70,121
"23379","chrX",1701095,1701116,22,76,37,135
"23380","chrX",1719835,1720082,248,13,28,289
"23381","chrX",1731324,1731359,36,6,7,49
"23382","chrX",1733758,1733776,19,7,98,124
"23383","chrX",1789273,1789309,37,135,70,242
"23384","chrX",1807524,1807547,24,41,137,202
"23385","chrX",1845112,1845130,19,43,44,106
"23386","chrX",1872860,1872878,19,76,142,237
"23387","chrX",1901764,1901788,25,29,119,173
"23388","chrX",1901807,1901835,29,76,76,181
"23389","chrX",1918776,1918796,21,49,75,145
"23390","chrX",2174575,2174601,27,41,78,146
"23391","chrX",2175129,2175152,24,78,35,137
"23392","chrX",2205475,2205499,25,8,25,58
"23393","chrX",2255923,2255945,23,8,33,64
"23394","chrX",2390145,2390162,18,77,81,176
"23395","chrX",2420413,2420453,41,138,69,248
"23396","chrX",2460108,2460127,20,46,6,72
"23397","chrX",2498626,2498643,18,73,61,152
"23398","chrX",2601111,2601130,20,6,96,122
"23399","chrX",2663349,2663369,21,122,73,216
"23400","chrX",2683900,2683927,28,148,73,249
"23401","chrX",2687654,2687680,27,144,41,212
"23402","chrX",2698168,2698202,35,136,131,302
"23403","chrX",2710868,2710888,21,76,55,152
"23404","chrX",2736874,2736900,27,101,57,185
"23405","chrX",2766558,2766581,24,7,26,57
"23406","chrX",2775956,2775997,42,137,74,253
"23407","chrX",2851237,2851261,25,8,16,49
"23408","chrX",2930014,2930036,23,6,85,114
"23409","chrX",2934216,2934237,22,63,66,151
"23410","chrX",2943742,2943771,30,21,6,57
"23411","chrX",3044753,3044779,27,15,129,171
"23412","chrX",3053759,3053778,20,7,116,143
"23413","chrX",3056276,3056293,18,76,129,223
"23414","chrX",3316316,3316363,48,143,72,263
"23415","chrX",3344957,3344982,26,60,28,114
"23416","chrX",3437495,3437535,41,27,130,198
"23417","chrX",3439505,3439532,28,120,6,154
"23418","chrX",3463822,3463840,19,62,65,146
"23419","chrX",3650521,3650540,20,91,6,117
"23420","chrX",3699347,3699368,22,74,135,231
"23421","chrX",3788565,3788597,33,111,73,217
"23422","chrX",3836930,3836949,20,122,65,207
"23423","chrX",3875352,3875371,20,122,65,207
"23424","chrX",3913781,3913800,20,122,65,207
"23425","chrX",3950054,3950072,19,8,6,33
"23426","chrX",3950227,3950244,18,104,138,260
"23427","chrX",4719206,4719223,18,146,126,290
"23428","chrX",5421639,5421658,20,75,6,101
"23429","chrX",5736802,5736825,24,59,85,168
"23430","chrX",6167070,6167091,22,48,126,196
"23431","chrX",6225669,6225721,53,128,45,226
"23432","chrX",6316705,6316756,52,127,63,242
"23433","chrX",6713892,6713910,19,9,13,41
"23434","chrX",7076131,7076167,37,132,105,274
"23435","chrX",7152304,7152332,29,73,93,195
"23436","chrX",7162883,7162907,25,77,35,137
"23437","chrX",7491518,7491538,21,17,6,44
"23438","chrX",7611070,7611098,29,77,95,201
"23439","chrX",8221579,8221770,192,84,22,298
"23440","chrX",8561467,8561488,22,25,143,190
"23441","chrX",8623997,8624033,37,9,64,110
"23442","chrX",8732047,8732066,20,48,16,84
"23443","chrX",8743747,8743780,34,145,25,204
"23444","chrX",9264221,9264242,22,140,143,305
"23445","chrX",9339505,9339527,23,23,7,53
"23446","chrX",9443803,9443824,22,76,21,119
"23447","chrX",9465124,9465148,25,25,6,56
"23448","chrX",9526100,9526127,28,3,21,52
"23449","chrX",9652851,9652882,32,12,42,86
"23450","chrX",9786314,9786386,73,34,25,132
"23451","chrX",9848511,9848536,26,30,67,123
"23452","chrX",10015304,10015337,34,41,14,89
"23453","chrX",10127592,10127633,42,18,5,65
"23454","chrX",10206894,10206934,41,73,119,233
"23455","chrX",10224587,10224606,20,145,124,289
"23456","chrX",10609716,10609735,20,8,50,78
"23457","chrX",11111356,11111380,25,44,63,132
"23458","chrX",11128988,11129020,33,97,74,204
"23459","chrX",11140418,11140448,31,51,74,156
"23460","chrX",11195960,11195987,28,148,27,203
"23461","chrX",11427806,11427864,59,15,115,189
"23462","chrX",11454111,11454133,23,114,75,212
"23463","chrX",11758416,11758436,21,13,144,178
"23464","chrX",12137806,12137825,20,49,143,212
"23465","chrX",12613990,12614008,19,144,61,224
"23466","chrX",13632298,13632319,22,8,15,45
"23467","chrX",13938073,13938090,18,21,85,124
"23468","chrX",15182059,15182082,24,76,16,116
"23469","chrX",15351107,15351133,27,8,143,178
"23470","chrX",15461788,15461806,19,66,1,86
"23471","chrX",15632579,15632599,21,10,5,36
"23472","chrX",15736132,15736154,23,13,75,111
"23473","chrX",15823108,15823136,29,134,138,301
"23474","chrX",15854723,15854742,20,8,85,113
"23475","chrX",15922577,15922598,22,51,6,79
"23476","chrX",16504209,16504230,22,56,6,84
"23477","chrX",16630252,16630272,21,76,68,165
"23478","chrX",16638255,16638272,18,56,6,80
"23479","chrX",16655780,16655813,34,76,29,139
"23480","chrX",16697433,16697458,26,73,32,131
"23481","chrX",16748742,16748772,31,76,65,172
"23482","chrX",16757725,16757746,22,66,4,92
"23483","chrX",16773629,16773647,19,8,22,49
"23484","chrX",16784329,16784349,21,11,74,106
"23485","chrX",16929575,16929595,21,76,62,159
"23486","chrX",16945675,16945697,23,50,73,146
"23487","chrX",17012381,17012415,35,117,72,224
"23488","chrX",17375340,17375362,23,96,1,120
"23489","chrX",17376089,17376107,19,71,48,138
"23490","chrX",18195898,18195931,34,61,53,148
"23491","chrX",18218863,18218889,27,41,53,121
"23492","chrX",18343761,18343801,41,143,74,258
"23493","chrX",18343924,18343970,47,38,35,120
"23494","chrX",18634480,18634498,19,134,122,275
"23495","chrX",18678129,18678149,21,148,6,175
"23496","chrX",18831544,18831565,22,80,17,119
"23497","chrX",18831712,18831735,24,145,6,175
"23498","chrX",19112977,19113004,28,55,55,138
"23499","chrX",19345573,19345602,30,111,3,144
"23500","chrX",19352226,19352243,18,67,132,217
"23501","chrX",19367724,19367766,43,76,57,176
"23502","chrX",19373059,19373082,24,33,54,111
"23503","chrX",19443023,19443050,28,76,146,250
"23504","chrX",19480654,19480676,23,77,21,121
"23505","chrX",19559275,19559299,25,31,71,127
"23506","chrX",19600096,19600120,25,30,45,100
"23507","chrX",19887481,19887512,32,94,51,177
"23508","chrX",19887602,19887650,49,5,63,117
"23509","chrX",19887768,19887809,42,26,55,123
"23510","chrX",19990923,19990973,51,26,136,213
"23511","chrX",20142195,20142218,24,32,89,145
"23512","chrX",20255790,20255819,30,140,72,242
"23513","chrX",20266727,20266791,65,12,65,142
"23514","chrX",20391251,20391284,34,78,5,117
"23515","chrX",21277429,21277476,48,136,46,230
"23516","chrX",21374273,21374292,20,14,61,95
"23517","chrX",21374595,21374632,38,62,132,232
"23518","chrX",21374631,21374648,18,78,96,192
"23519","chrX",21656802,21656826,25,15,5,45
"23520","chrX",21839751,21839768,18,21,15,54
"23521","chrX",21849859,21849876,18,145,35,198
"23522","chrX",21856867,21856885,19,82,90,191
"23523","chrX",22122985,22123007,23,9,113,145
"23524","chrX",23053766,23053790,25,72,7,104
"23525","chrX",23088113,23088136,24,144,20,188
"23526","chrX",23117903,23117921,19,12,5,36
"23527","chrX",23334751,23334820,70,50,35,155
"23528","chrX",23401024,23401058,35,35,142,212
"23529","chrX",23412608,23412636,29,124,6,159
"23530","chrX",23542553,23542573,21,79,25,125
"23531","chrX",23684048,23684066,19,26,6,51
"23532","chrX",23694779,23694805,27,143,144,314
"23533","chrX",23704167,23704188,22,8,85,115
"23534","chrX",23733755,23733778,24,75,66,165
"23535","chrX",23768819,23768860,42,6,5,53
"23536","chrX",23771748,23771765,18,41,5,64
"23537","chrX",23808830,23808851,22,76,63,161
"23538","chrX",23864297,23864319,23,75,143,241
"23539","chrX",23876421,23876445,25,74,120,219
"23540","chrX",23941765,23941795,31,37,28,96
"23541","chrX",23946865,23946888,24,50,73,147
"23542","chrX",24001803,24001841,39,3,75,117
"23543","chrX",24009687,24009708,22,148,41,211
"23544","chrX",24022342,24022360,19,21,67,107
"23545","chrX",24027627,24027664,38,80,59,177
"23546","chrX",24035950,24035979,30,74,132,236
"23547","chrX",24054531,24054548,18,13,49,80
"23548","chrX",24103871,24103911,41,73,8,122
"23549","chrX",24113997,24114020,24,29,107,160
"23550","chrX",24142191,24142222,32,16,74,122
"23551","chrX",24178277,24178303,27,5,98,130
"23552","chrX",24236443,24236470,28,141,69,238
"23553","chrX",24274881,24274917,37,57,6,100
"23554","chrX",24311752,24311835,84,33,14,131
"23555","chrX",24347305,24347343,39,35,60,134
"23556","chrX",24353801,24353823,23,86,74,183
"23557","chrX",24392672,24392701,30,139,5,174
"23558","chrX",24564340,24564387,48,30,35,113
"23559","chrX",24698636,24698669,34,74,16,124
"23560","chrX",24730230,24730253,24,68,12,104
"23561","chrX",24984655,24984677,23,8,23,54
"23562","chrX",25005148,25005165,18,140,28,186
"23563","chrX",25007239,25007265,27,60,33,120
"23564","chrX",25013654,25013697,44,12,74,130
"23565","chrX",25022428,25022471,44,130,101,275
"23566","chrX",25042214,25042231,18,75,75,168
"23567","chrX",25201072,25201089,18,78,42,138
"23568","chrX",25268475,25268494,20,5,3,28
"23569","chrX",26485664,26485700,37,96,24,157
"23570","chrX",27743695,27743748,54,6,11,71
"23571","chrX",27809485,27809561,77,113,146,336
"23572","chrX",28497262,28497287,26,128,53,207
"23573","chrX",28873524,28873549,26,8,32,66
"23574","chrX",29623107,29623124,18,69,35,122
"23575","chrX",29678525,29678545,21,33,72,126
"23576","chrX",29723242,29723264,23,74,9,106
"23577","chrX",29769611,29769634,24,76,75,175
"23578","chrX",30011720,30011742,23,149,10,182
"23579","chrX",30548124,30548152,29,147,5,181
"23580","chrX",30691469,30691489,21,7,7,35
"23581","chrX",30712706,30712742,37,8,109,154
"23582","chrX",30721459,30721477,19,29,75,123
"23583","chrX",30750179,30750201,23,77,25,125
"23584","chrX",30889134,30889151,18,53,11,82
"23585","chrX",30889257,30889277,21,2,82,105
"23586","chrX",31222202,31222236,35,143,37,215
"23587","chrX",31266912,31266930,19,31,28,78
"23588","chrX",34503040,34503062,23,42,7,72
"23589","chrX",35499515,35499546,32,68,11,111
"23590","chrX",35799038,35799055,18,29,75,122
"23591","chrX",36008775,36008804,30,9,1,40
"23592","chrX",37685738,37685757,20,98,78,196
"23593","chrX",37888757,37888781,25,77,6,108
"23594","chrX",37990040,37990066,27,50,75,152
"23595","chrX",38220723,38220766,44,21,29,94
"23596","chrX",38561247,38561282,36,74,100,210
"23597","chrX",38561449,38561480,32,98,55,185
"23598","chrX",38561504,38561534,31,38,5,74
"23599","chrX",38562560,38562594,35,1,41,77
"23600","chrX",38628337,38628368,32,54,74,160
"23601","chrX",38804027,38804057,31,18,47,96
"23602","chrX",39090668,39090694,27,74,50,151
"23603","chrX",39803310,39803339,30,74,20,124
"23604","chrX",39896599,39896642,44,16,131,191
"23605","chrX",39945061,39945083,23,53,13,89
"23606","chrX",39961368,39961392,25,90,3,118
"23607","chrX",39990999,39991035,37,29,71,137
"23608","chrX",40005525,40005566,42,26,7,75
"23609","chrX",40012490,40012517,28,76,129,233
"23610","chrX",40014386,40014426,41,2,108,151
"23611","chrX",40014426,40014443,18,142,68,228
"23612","chrX",40014840,40014866,27,60,50,137
"23613","chrX",40014919,40014950,32,5,4,41
"23614","chrX",40017204,40017222,19,101,42,162
"23615","chrX",40090448,40090473,26,107,35,168
"23616","chrX",40097535,40097552,18,107,1,126
"23617","chrX",40133454,40133476,23,7,127,157
"23618","chrX",40161507,40161529,23,42,3,68
"23619","chrX",40176949,40176967,19,142,6,167
"23620","chrX",40206891,40206918,28,138,1,167
"23621","chrX",40215581,40215603,23,75,13,111
"23622","chrX",40226828,40226876,49,8,36,93
"23623","chrX",40234441,40234465,25,76,62,163
"23624","chrX",40292663,40292696,34,7,58,99
"23625","chrX",40301986,40302010,25,3,72,100
"23626","chrX",40508398,40508418,21,44,72,137
"23627","chrX",40645931,40645975,45,8,132,185
"23628","chrX",40740048,40740068,21,19,68,108
"23629","chrX",40979510,40979530,21,85,74,180
"23630","chrX",40992775,40992797,23,76,41,140
"23631","chrX",41052457,41052481,25,77,33,135
"23632","chrX",41057423,41057441,19,23,73,115
"23633","chrX",41063736,41063760,25,7,13,45
"23634","chrX",41072291,41072313,23,11,31,65
"23635","chrX",41076948,41076965,18,122,120,260
"23636","chrX",41242758,41242776,19,62,78,159
"23637","chrX",41255213,41255238,26,56,6,88
"23638","chrX",41268117,41268149,33,10,1,44
"23639","chrX",41272184,41272207,24,109,6,139
"23640","chrX",41275669,41275687,19,18,62,99
"23641","chrX",41276457,41276509,53,27,48,128
"23642","chrX",41285741,41285760,20,6,63,89
"23643","chrX",41310297,41310328,32,18,7,57
"23644","chrX",41333712,41333733,22,44,81,147
"23645","chrX",41359998,41360023,26,79,58,163
"23646","chrX",41382376,41382395,20,9,6,35
"23647","chrX",41388297,41388327,31,76,105,212
"23648","chrX",41417246,41417269,24,100,7,131
"23649","chrX",41472791,41472814,24,6,58,88
"23650","chrX",41484306,41484325,20,10,13,43
"23651","chrX",41512697,41512721,25,7,114,146
"23652","chrX",41780639,41780662,24,4,19,47
"23653","chrX",43478786,43478808,23,37,73,133
"23654","chrX",43536269,43536287,19,8,38,65
"23655","chrX",43623651,43623672,22,10,112,144
"23656","chrX",43655097,43655206,110,93,9,212
"23657","chrX",43853268,43853299,32,48,74,154
"23658","chrX",44073698,44073861,164,65,106,335
"23659","chrX",44283676,44283695,20,89,29,138
"23660","chrX",44287027,44287054,28,129,5,162
"23661","chrX",44493999,44494017,19,10,2,31
"23662","chrX",44533628,44533649,22,15,74,111
"23663","chrX",44533648,44533669,22,35,54,111
"23664","chrX",44546318,44546337,20,4,70,94
"23665","chrX",44555799,44555816,18,109,75,202
"23666","chrX",44563772,44563794,23,22,74,119
"23667","chrX",44608660,44608679,20,117,33,170
"23668","chrX",44612194,44612219,26,8,125,159
"23669","chrX",44799428,44799451,24,78,32,134
"23670","chrX",44848866,44848885,20,7,77,104
"23671","chrX",44871023,44871043,21,77,20,118
"23672","chrX",44873370,44873401,32,50,45,127
"23673","chrX",45026665,45026682,18,109,34,161
"23674","chrX",45081767,45081793,27,5,126,158
"23675","chrX",45312006,45312029,24,3,75,102
"23676","chrX",45836401,45836420,20,147,68,235
"23677","chrX",45839589,45839620,32,9,28,69
"23678","chrX",45848632,45848658,27,61,22,110
"23679","chrX",46146431,46146448,18,75,146,239
"23680","chrX",46758943,46758967,25,5,34,64
"23681","chrX",46824715,46824766,52,62,43,157
"23682","chrX",46824728,46824778,51,74,30,155
"23683","chrX",46835254,46835276,23,9,141,173
"23684","chrX",46869607,46869626,20,7,1,28
"23685","chrX",47077632,47077659,28,12,10,50
"23686","chrX",47078237,47078263,27,23,108,158
"23687","chrX",47078634,47078657,24,20,49,93
"23688","chrX",47078956,47078975,20,6,24,50
"23689","chrX",47079348,47079446,99,74,57,230
"23690","chrX",47171162,47171201,40,73,35,148
"23691","chrX",47203742,47203764,23,6,87,116
"23692","chrX",47218896,47218939,44,23,86,153
"23693","chrX",47244098,47244116,19,76,94,189
"23694","chrX",47265405,47265427,23,58,133,214
"23695","chrX",47265425,47265445,21,76,113,210
"23696","chrX",47320949,47320972,24,7,10,41
"23697","chrX",47323815,47323835,21,141,72,234
"23698","chrX",47374999,47375034,36,76,138,250
"23699","chrX",47428483,47428504,22,73,70,165
"23700","chrX",47531671,47531693,23,147,73,243
"23701","chrX",48011075,48011120,46,75,12,133
"23702","chrX",48015702,48015729,28,140,71,239
"23703","chrX",48055447,48055480,34,78,75,187
"23704","chrX",48133957,48134002,46,75,12,133
"23705","chrX",48286105,48286127,23,140,7,170
"23706","chrX",48307158,48307180,23,4,140,167
"23707","chrX",48307274,48307293,20,117,24,161
"23708","chrX",48378569,48378588,20,50,6,76
"23709","chrX",48383899,48383919,21,116,74,211
"23710","chrX",48411507,48411527,21,76,114,211
"23711","chrX",48416847,48416866,20,8,48,76
"23712","chrX",48456099,48456135,37,80,72,189
"23713","chrX",48462614,48462632,19,135,68,222
"23714","chrX",48542166,48542185,20,75,143,238
"23715","chrX",48573463,48573481,19,96,66,181
"23716","chrX",48573611,48573646,36,29,75,140
"23717","chrX",48610757,48610782,26,8,90,124
"23718","chrX",48619842,48619863,22,31,71,124
"23719","chrX",48630775,48630796,22,135,8,165
"23720","chrX",48743452,48743478,27,55,4,86
"23721","chrX",48826359,48826396,38,67,141,246
"23722","chrX",48900285,48900313,29,78,40,147
"23723","chrX",48957716,48957764,49,43,36,128
"23724","chrX",48964518,48964536,19,46,72,137
"23725","chrX",48964721,48964738,18,11,70,99
"23726","chrX",48984715,48984738,24,145,43,212
"23727","chrX",49000693,49000716,24,89,72,185
"23728","chrX",49007482,49007507,26,41,6,73
"23729","chrX",49017243,49017261,19,77,9,105
"23730","chrX",49045003,49045025,23,54,7,84
"23731","chrX",49095760,49095783,24,78,145,247
"23732","chrX",49135708,49135736,29,25,3,57
"23733","chrX",49235827,49235876,50,32,4,86
"23734","chrX",49248346,49248364,19,48,10,77
"23735","chrX",50211508,50211527,20,114,27,161
"23736","chrX",50470065,50470093,29,120,44,193
"23737","chrX",50905292,50905337,46,15,5,66
"23738","chrX",51406661,51406692,32,33,31,96
"23739","chrX",51685793,51685843,51,77,134,262
"23740","chrX",51707496,51707550,55,136,75,266
"23741","chrX",51889628,51889652,25,95,6,126
"23742","chrX",52626736,52626785,50,75,89,214
"23743","chrX",52708296,52708319,24,141,75,240
"23744","chrX",52750111,52750134,24,77,139,240
"23745","chrX",52896821,52896849,29,38,18,85
"23746","chrX",52958965,52958993,29,20,36,85
"23747","chrX",53048449,53048483,35,66,42,143
"23748","chrX",53136732,53136756,25,3,108,136
"23749","chrX",53180720,53180746,27,78,84,189
"23750","chrX",53208806,53208833,28,76,10,114
"23751","chrX",53267020,53267064,45,48,128,221
"23752","chrX",53277975,53278028,54,76,6,136
"23753","chrX",53443246,53443264,19,75,132,226
"23754","chrX",53445728,53445764,37,82,133,252
"23755","chrX",53483407,53483438,32,100,65,197
"23756","chrX",53519763,53519784,22,130,6,158
"23757","chrX",53712007,53712037,31,36,15,82
"23758","chrX",53813230,53813250,21,52,6,79
"23759","chrX",53836986,53837003,18,45,46,109
"23760","chrX",53837008,53837034,27,8,24,59
"23761","chrX",53925142,53925166,25,144,18,187
"23762","chrX",53945026,53945059,34,142,3,179
"23763","chrX",54082188,54082205,18,96,1,115
"23764","chrX",54344944,54344961,18,141,6,165
"23765","chrX",54368068,54368104,37,80,56,173
"23766","chrX",54374158,54374175,18,14,5,37
"23767","chrX",54375496,54375517,22,44,146,212
"23768","chrX",54383032,54383087,56,94,4,154
"23769","chrX",54399515,54399533,19,27,75,121
"23770","chrX",54495676,54495696,21,19,67,107
"23771","chrX",54495952,54495982,31,31,26,88
"23772","chrX",54530149,54530167,19,22,24,65
"23773","chrX",54575735,54575758,24,75,5,104
"23774","chrX",55140680,55140718,39,28,68,135
"23775","chrX",55267591,55267608,18,36,74,128
"23776","chrX",55488524,55488575,52,118,102,272
"23777","chrX",55925023,55925040,18,35,75,128
"23778","chrX",55949792,55949820,29,113,73,215
"23779","chrX",56144757,56144783,27,49,70,146
"23780","chrX",56144789,56144809,21,7,38,66
"23781","chrX",56731403,56731422,20,16,27,63
"23782","chrX",56803802,56803823,22,127,53,202
"23783","chrX",56803822,56803845,24,149,33,206
"23784","chrX",56995464,56995487,24,71,24,119
"23785","chrX",57592293,57592316,24,45,9,78
"23786","chrX",64894199,64894222,24,7,67,98
"23787","chrX",65511283,65511321,39,31,13,83
"23788","chrX",66726715,66726733,19,8,85,112
"23789","chrX",68141905,68141962,58,64,71,193
"23790","chrX",68351864,68351894,31,8,75,114
"23791","chrX",68353409,68353431,23,84,31,138
"23792","chrX",68475395,68475413,19,27,67,113
"23793","chrX",68475445,68475462,18,76,17,111
"23794","chrX",68652687,68653814,1128,70,44,1242
"23795","chrX",69034298,69034347,50,111,12,173
"23796","chrX",69082578,69082605,28,42,133,203
"23797","chrX",69116207,69116240,34,65,98,197
"23798","chrX",69220817,69220860,44,126,5,175
"23799","chrX",69423653,69423681,29,37,77,143
"23800","chrX",69504738,69504812,75,62,9,146
"23801","chrX",69505336,69505356,21,17,81,119
"23802","chrX",69988880,69988899,20,106,50,176
"23803","chrX",70063514,70063535,22,95,50,167
"23804","chrX",70179563,70179584,22,35,18,75
"23805","chrX",70182470,70182497,28,76,28,132
"23806","chrX",70445114,70445154,41,21,53,115
"23807","chrX",70452466,70452488,23,54,87,164
"23808","chrX",70455117,70455161,45,57,55,157
"23809","chrX",70844767,70844786,20,78,106,204
"23810","chrX",70931184,70931243,60,79,111,250
"23811","chrX",70949996,70950024,29,25,79,133
"23812","chrX",70954574,70954601,28,104,7,139
"23813","chrX",71021574,71021596,23,137,75,235
"23814","chrX",71105246,71105269,24,133,42,199
"23815","chrX",71146125,71146154,30,52,28,110
"23816","chrX",71150702,71150744,43,32,34,109
"23817","chrX",71153612,71153630,19,73,19,111
"23818","chrX",71159891,71159914,24,34,76,134
"23819","chrX",71192162,71192209,48,73,7,128
"23820","chrX",71202262,71202287,26,100,75,201
"23821","chrX",71202285,71202330,46,143,52,241
"23822","chrX",71257324,71257349,26,7,55,88
"23823","chrX",71273891,71273910,20,77,24,121
"23824","chrX",71277858,71277888,31,76,73,180
"23825","chrX",71309279,71309299,21,75,5,101
"23826","chrX",71309591,71309667,77,75,31,183
"23827","chrX",71336352,71336369,18,76,98,192
"23828","chrX",71344964,71344981,18,6,140,164
"23829","chrX",71436215,71436233,19,8,143,170
"23830","chrX",71469695,71469718,24,7,118,149
"23831","chrX",71506202,71506242,41,146,72,259
"23832","chrX",71570034,71570059,26,77,12,115
"23833","chrX",71612111,71612128,18,77,33,128
"23834","chrX",71612284,71612308,25,96,68,189
"23835","chrX",71708802,71708822,21,114,6,141
"23836","chrX",71772753,71772773,21,8,112,141
"23837","chrX",71910774,71910827,54,22,64,140
"23838","chrX",72088235,72088252,18,97,70,185
"23839","chrX",72162476,72162500,25,32,25,82
"23840","chrX",72162500,72162542,43,74,1,118
"23841","chrX",72191946,72191969,24,8,79,111
"23842","chrX",72196119,72196138,20,36,74,130
"23843","chrX",72257324,72257348,25,81,3,109
"23844","chrX",72306303,72306323,21,5,7,33
"23845","chrX",72306722,72306739,18,56,20,94
"23846","chrX",72525814,72525845,32,147,6,185
"23847","chrX",72715205,72715231,27,130,7,164
"23848","chrX",72776951,72777064,114,37,102,253
"23849","chrX",72777475,72777509,35,53,52,140
"23850","chrX",72825196,72825233,38,4,92,134
"23851","chrX",72843944,72843964,21,147,75,243
"23852","chrX",72876866,72876886,21,77,145,243
"23853","chrX",72895603,72895640,38,94,2,134
"23854","chrX",72943314,72943348,35,54,51,140
"23855","chrX",72943759,72943875,117,104,35,256
"23856","chrX",73003231,73003282,52,21,113,186
"23857","chrX",73079741,73079792,52,115,19,186
"23858","chrX",73507690,73507710,21,29,75,125
"23859","chrX",73864719,73864744,26,145,35,206
"23860","chrX",74317012,74317059,48,11,3,62
"23861","chrX",74317026,74317063,38,15,57,110
"23862","chrX",74327670,74327697,28,6,41,75
"23863","chrX",74346822,74346842,21,74,129,224
"23864","chrX",74421737,74421808,72,128,124,324
"23865","chrX",74552535,74552555,21,75,58,154
"23866","chrX",75747070,75747182,113,59,80,252
"23867","chrX",75894005,75894076,72,95,127,294
"23868","chrX",76261661,76261683,23,19,99,141
"23869","chrX",76427955,76427972,18,91,112,221
"23870","chrX",76608995,76609026,32,79,16,127
"23871","chrX",77155421,77155502,82,49,40,171
"23872","chrX",77624369,77624391,23,13,17,53
"23873","chrX",77735098,77735128,31,96,68,195
"23874","chrX",77735599,77735646,48,71,67,186
"23875","chrX",77779092,77779116,25,29,146,200
"23876","chrX",77878290,77878322,33,144,73,250
"23877","chrX",77893791,77893814,24,69,131,224
"23878","chrX",78061514,78061567,54,140,76,270
"23879","chrX",78924363,78924383,21,8,134,163
"23880","chrX",79550327,79550350,24,77,27,128
"23881","chrX",80280619,80280641,23,3,93,119
"23882","chrX",80813806,80813823,18,94,5,117
"23883","chrX",80820474,80820493,20,142,6,168
"23884","chrX",81011620,81011671,52,149,55,256
"23885","chrX",82441646,82441677,32,112,7,151
"23886","chrX",82454260,82454285,26,38,143,207
"23887","chrX",83509557,83509723,167,30,26,223
"23888","chrX",83862376,83862393,18,145,27,190
"23889","chrX",84738997,84739028,32,122,119,273
"23890","chrX",84939998,84940030,33,35,22,90
"23891","chrX",85254614,85254652,39,27,67,133
"23892","chrX",85784475,85784495,21,83,24,128
"23893","chrX",86342812,86342829,18,64,69,151
"23894","chrX",87863145,87863246,102,7,120,229
"23895","chrX",88118750,88118770,21,11,14,46
"23896","chrX",88469643,88469660,18,27,74,119
"23897","chrX",88745467,88745486,20,131,47,198
"23898","chrX",89066183,89066221,39,3,1,43
"23899","chrX",89763815,89763863,49,12,7,68
"23900","chrX",90112401,90112445,45,11,79,135
"23901","chrX",90437219,90437245,27,20,3,50
"23902","chrX",90484795,90484999,205,63,73,341
"23903","chrX",91207220,91207239,20,77,31,128
"23904","chrX",91239681,91239759,79,146,11,236
"23905","chrX",91734759,91734776,18,42,143,203
"23906","chrX",91985506,91985541,36,9,73,118
"23907","chrX",92626875,92626921,47,4,82,133
"23908","chrX",92640983,92641003,21,76,59,156
"23909","chrX",93742587,93742615,29,93,36,158
"23910","chrX",93987322,93987362,41,13,104,158
"23911","chrX",94602919,94602940,22,29,143,194
"23912","chrX",96072876,96072894,19,76,132,227
"23913","chrX",96503880,96503903,24,8,75,107
"23914","chrX",96751648,96751671,24,8,2,34
"23915","chrX",96782278,96782308,31,3,131,165
"23916","chrX",96787858,96787890,33,36,75,144
"23917","chrX",96882960,96882997,38,148,73,259
"23918","chrX",96949860,96949882,23,23,6,52
"23919","chrX",97176501,97176543,43,6,99,148
"23920","chrX",97300932,97300965,34,91,6,131
"23921","chrX",97323594,97323614,21,140,3,164
"23922","chrX",97390209,97390237,29,76,63,168
"23923","chrX",97464298,97464327,30,145,38,213
"23924","chrX",100409710,100409740,31,32,4,67
"23925","chrX",100410681,100410735,55,15,48,118
"23926","chrX",100967609,100967631,23,4,66,93
"23927","chrX",101090328,101090345,18,33,99,150
"23928","chrX",101312305,101312340,36,40,7,83
"23929","chrX",101407412,101407481,70,130,25,225
"23930","chrX",101421992,101422032,41,75,83,199
"23931","chrX",101656695,101656713,19,144,14,177
"23932","chrX",101918446,101918484,39,73,31,143
"23933","chrX",102102772,102102798,27,57,135,219
"23934","chrX",102305818,102305845,28,145,21,194
"23935","chrX",102381270,102381297,28,23,143,194
"23936","chrX",103375603,103375632,30,102,8,140
"23937","chrX",103712533,103712559,27,19,111,157
"23938","chrX",103743685,103743706,22,8,65,95
"23939","chrX",103832260,103832277,18,91,12,121
"23940","chrX",103911940,103911963,24,21,67,112
"23941","chrX",103987588,103987616,29,30,23,82
"23942","chrX",104003496,104003546,51,25,28,104
"23943","chrX",104051245,104051273,29,25,28,82
"23944","chrX",104261337,104261359,23,37,143,203
"23945","chrX",104291955,104291999,45,77,30,152
"23946","chrX",106763928,106763965,38,61,26,125
"23947","chrX",106922973,106922993,21,76,66,163
"23948","chrX",107449561,107449599,39,138,117,294
"23949","chrX",107449894,107449943,50,6,49,105
"23950","chrX",107449945,107450003,59,22,44,125
"23951","chrX",107664844,107664865,22,44,9,75
"23952","chrX",107703404,107703422,19,8,131,158
"23953","chrX",107703703,107703720,18,8,12,38
"23954","chrX",107775659,107775690,32,143,93,268
"23955","chrX",107951325,107951358,34,71,19,124
"23956","chrX",110318318,110318342,25,33,34,92
"23957","chrX",111246021,111246067,47,117,138,302
"23958","chrX",111683296,111683347,52,7,101,160
"23959","chrX",111694020,111694061,42,45,8,95
"23960","chrX",111751067,111751087,21,45,47,113
"23961","chrX",112082775,112082799,25,41,67,133
"23962","chrX",112082799,112082860,62,102,43,207
"23963","chrX",112082938,112082963,26,1,121,148
"23964","chrX",112305330,112305378,49,74,69,192
"23965","chrX",112779094,112779122,29,47,110,186
"23966","chrX",112887415,112887453,39,105,8,152
"23967","chrX",112899758,112899777,20,8,10,38
"23968","chrX",113731755,113731772,18,29,144,191
"23969","chrX",114023292,114023309,18,33,75,126
"23970","chrX",114047486,114047505,20,107,101,228
"23971","chrX",114584534,114584558,25,35,48,108
"23972","chrX",114612921,114612953,33,75,3,111
"23973","chrX",114968323,114968343,21,134,102,257
"23974","chrX",115017741,115017764,24,128,20,172
"23975","chrX",115551422,115551448,27,74,146,247
"23976","chrX",115555280,115555312,33,73,84,190
"23977","chrX",115555319,115555350,32,111,45,188
"23978","chrX",115566678,115566698,21,78,144,243
"23979","chrX",115635651,115635687,37,127,43,207
"23980","chrX",115662051,115662085,35,33,6,74
"23981","chrX",115725219,115725276,58,93,112,263
"23982","chrX",115727974,115727997,24,31,24,79
"23983","chrX",115732929,115732962,34,26,50,110
"23984","chrX",115736997,115737030,34,52,24,110
"23985","chrX",115738749,115738776,28,26,54,108
"23986","chrX",115843208,115843265,58,93,112,263
"23987","chrX",115844844,115844882,39,26,30,95
"23988","chrX",115847825,115847863,39,26,30,95
"23989","chrX",115850806,115850844,39,26,30,95
"23990","chrX",115853789,115853827,39,26,30,95
"23991","chrX",115856768,115856806,39,26,30,95
"23992","chrX",115859759,115859797,39,26,30,95
"23993","chrX",115862750,115862788,39,26,30,95
"23994","chrX",115865733,115865771,39,26,30,95
"23995","chrX",115868718,115868756,39,26,30,95
"23996","chrX",115871697,115871735,39,26,30,95
"23997","chrX",115874684,115874722,39,26,30,95
"23998","chrX",115877653,115877691,39,26,30,95
"23999","chrX",115880646,115880684,39,26,30,95
"24000","chrX",115883655,115883693,39,26,30,95
"24001","chrX",115888727,115888755,29,26,50,105
"24002","chrX",116108561,116108794,234,106,66,406
"24003","chrX",117027889,117027915,27,77,39,143
"24004","chrX",118316229,118316246,18,145,26,189
"24005","chrX",118466992,118467017,26,141,72,239
"24006","chrX",118496335,118496352,18,75,25,118
"24007","chrX",118710757,118710796,40,18,7,65
"24008","chrX",118717203,118717227,25,115,147,287
"24009","chrX",118727693,118727714,22,1,18,41
"24010","chrX",119178016,119178039,24,8,92,124
"24011","chrX",119282355,119282374,20,80,26,126
"24012","chrX",119405596,119405621,26,3,34,63
"24013","chrX",119483660,119483684,25,76,52,153
"24014","chrX",119491055,119491081,27,77,31,135
"24015","chrX",119498694,119498717,24,146,33,203
"24016","chrX",119505191,119505209,19,45,74,138
"24017","chrX",119528973,119528994,22,138,5,165
"24018","chrX",119541591,119541621,31,75,8,114
"24019","chrX",119563549,119563573,25,145,5,175
"24020","chrX",119598083,119598111,29,74,72,175
"24021","chrX",119736476,119736495,20,73,40,133
"24022","chrX",119742858,119742896,39,137,41,217
"24023","chrX",119758501,119758532,32,71,25,128
"24024","chrX",119779776,119779795,20,92,70,182
"24025","chrX",119869915,119869932,18,79,27,124
"24026","chrX",119897123,119897174,52,73,132,257
"24027","chrX",119902019,119902049,31,31,74,136
"24028","chrX",119925923,119925967,45,69,70,184
"24029","chrX",119930820,119930855,36,8,4,48
"24030","chrX",119990881,119990901,21,78,6,105
"24031","chrX",119998578,119998599,22,4,130,156
"24032","chrX",120000243,120000288,46,4,115,165
"24033","chrX",120013634,120013655,22,77,47,146
"24034","chrX",120015556,120015575,20,35,77,132
"24035","chrX",120015578,120015663,86,123,55,264
"24036","chrX",120565671,120565695,25,28,85,138
"24037","chrX",120762567,120762586,20,76,75,171
"24038","chrX",121079523,121079540,18,147,74,239
"24039","chrX",121174286,121174324,39,8,134,181
"24040","chrX",121400138,121400170,33,94,5,132
"24041","chrX",121423114,121423142,29,93,32,154
"24042","chrX",123698458,123698476,19,31,74,124
"24043","chrX",123750914,123750940,27,12,6,45
"24044","chrX",123763590,123763608,19,76,55,150
"24045","chrX",123779220,123779244,25,28,73,126
"24046","chrX",123801308,123801329,22,77,6,105
"24047","chrX",123828971,123828989,19,148,8,175
"24048","chrX",123838234,123838268,35,35,131,201
"24049","chrX",123883477,123883512,36,74,52,162
"24050","chrX",123921855,123921913,59,34,134,227
"24051","chrX",123945896,123945914,19,8,132,159
"24052","chrX",123960603,123960652,50,9,53,112
"24053","chrX",124072868,124072924,57,35,75,167
"24054","chrX",124130462,124130480,19,92,74,185
"24055","chrX",124227384,124227401,18,33,64,115
"24056","chrX",124403521,124403549,29,105,5,139
"24057","chrX",125244186,125244207,22,59,76,157
"24058","chrX",126166128,126166151,24,111,5,140
"24059","chrX",126723863,126723904,42,61,39,142
"24060","chrX",127500823,127500911,89,84,8,181
"24061","chrX",127822828,127822848,21,66,6,93
"24062","chrX",128804594,128804616,23,77,6,106
"24063","chrX",129037996,129038035,40,63,34,137
"24064","chrX",129269054,129269087,34,69,11,114
"24065","chrX",129503965,129503995,31,12,3,46
"24066","chrX",129540625,129540642,18,1,12,31
"24067","chrX",129775765,129775782,18,109,49,176
"24068","chrX",129832785,129832818,34,148,72,254
"24069","chrX",129946822,129946849,28,11,75,114
"24070","chrX",129984167,129984243,77,14,35,126
"24071","chrX",129989445,129989481,37,147,1,185
"24072","chrX",129991505,129991522,18,36,7,61
"24073","chrX",129991652,129991675,24,76,135,235
"24074","chrX",130029650,130029668,19,8,48,75
"24075","chrX",130041279,130041300,22,25,27,74
"24076","chrX",130097134,130097153,20,145,34,199
"24077","chrX",130101802,130101845,44,119,71,234
"24078","chrX",130121234,130121269,36,46,73,155
"24079","chrX",130132743,130132764,22,121,55,198
"24080","chrX",130157954,130157980,27,11,75,113
"24081","chrX",130164000,130164018,19,77,27,123
"24082","chrX",130213201,130213224,24,78,24,126
"24083","chrX",130251789,130251817,29,89,76,194
"24084","chrX",130256479,130256496,18,133,108,259
"24085","chrX",130412090,130412107,18,37,143,198
"24086","chrX",130431618,130431640,23,63,34,120
"24087","chrX",130853464,130853486,23,12,6,41
"24088","chrX",130956397,130956422,26,77,6,109
"24089","chrX",131016541,131016568,28,13,106,147
"24090","chrX",131768946,131768985,40,37,75,152
"24091","chrX",132236634,132236655,22,135,35,192
"24092","chrX",132566564,132566590,27,89,64,180
"24093","chrX",132613380,132613420,41,113,34,188
"24094","chrX",132777599,132777618,20,27,143,190
"24095","chrX",133404547,133404565,19,134,74,227
"24096","chrX",133456336,133456356,21,142,57,220
"24097","chrX",133687093,133687115,23,29,143,195
"24098","chrX",133869959,133869977,19,143,2,164
"24099","chrX",133985623,133985691,69,42,19,130
"24100","chrX",134247299,134247332,34,38,69,141
"24101","chrX",134270618,134270641,24,40,98,162
"24102","chrX",134462167,134462194,28,72,46,146
"24103","chrX",134497633,134497658,26,6,7,39
"24104","chrX",134533552,134533578,27,98,102,227
"24105","chrX",134585176,134585199,24,148,27,199
"24106","chrX",134763825,134763870,46,99,70,215
"24107","chrX",134777525,134777546,22,5,75,102
"24108","chrX",134819884,134819919,36,66,7,109
"24109","chrX",134890075,134890093,19,68,2,89
"24110","chrX",134937842,134937884,43,8,12,63
"24111","chrX",134995298,134995315,18,9,96,123
"24112","chrX",135098746,135098800,55,8,43,106
"24113","chrX",135119378,135119424,47,33,121,201
"24114","chrX",135253114,135253160,47,123,31,201
"24115","chrX",135768419,135768453,35,68,121,224
"24116","chrX",135785703,135785725,23,68,121,212
"24117","chrX",135802977,135803003,27,68,121,216
"24118","chrX",135820240,135820262,23,68,121,212
"24119","chrX",135837508,135837530,23,68,121,212
"24120","chrX",135854766,135854792,27,68,121,216
"24121","chrX",135872040,135872070,31,68,121,220
"24122","chrX",136099061,136099099,39,37,79,155
"24123","chrX",136235756,136235779,24,17,67,108
"24124","chrX",136251450,136251483,34,79,71,184
"24125","chrX",136290755,136290782,28,8,81,117
"24126","chrX",136413723,136413758,36,8,120,164
"24127","chrX",136424610,136424657,48,126,6,180
"24128","chrX",136497343,136497370,28,97,146,271
"24129","chrX",136505786,136505814,29,69,80,178
"24130","chrX",136644354,136644371,18,79,75,172
"24131","chrX",136767835,136767871,37,4,18,59
"24132","chrX",136860717,136860734,18,40,75,133
"24133","chrX",136881893,136881915,23,143,32,198
"24134","chrX",136916616,136916640,25,145,30,200
"24135","chrX",136926330,136926351,22,57,28,107
"24136","chrX",136945130,136945159,30,48,7,85
"24137","chrX",137554657,137554725,69,14,16,99
"24138","chrX",137568340,137568385,46,10,73,129
"24139","chrX",137568687,137568721,35,16,142,193
"24140","chrX",137589720,137589762,43,76,79,198
"24141","chrX",137744269,137744290,22,40,54,116
"24142","chrX",137778037,137778055,19,26,79,124
"24143","chrX",138711798,138711824,27,128,56,211
"24144","chrX",139954714,139954736,23,121,1,145
"24145","chrX",140504317,140504361,45,63,141,249
"24146","chrX",140742840,140742879,40,56,21,117
"24147","chrX",141176603,141176625,23,46,25,94
"24148","chrX",141196428,141196453,26,8,73,107
"24149","chrX",141355015,141355041,27,43,38,108
"24150","chrX",141831952,141831969,18,85,79,182
"24151","chrX",142240280,142240298,19,93,11,123
"24152","chrX",142442474,142442510,37,11,65,113
"24153","chrX",142442516,142442590,75,91,23,189
"24154","chrX",142853189,142853224,36,61,6,103
"24155","chrX",143153096,143153116,21,16,6,43
"24156","chrX",143871511,143871530,20,145,25,190
"24157","chrX",144493104,144493140,37,122,79,238
"24158","chrX",144838484,144838531,48,148,117,313
"24159","chrX",144899333,144899355,23,38,74,135
"24160","chrX",145844297,145844321,25,118,50,193
"24161","chrX",146615465,146615508,44,14,122,180
"24162","chrX",147214338,147214355,18,136,6,160
"24163","chrX",147727075,147727094,20,77,27,124
"24164","chrX",147883761,147883792,32,28,6,66
"24165","chrX",147911523,147911561,39,105,147,291
"24166","chrX",147912037,147912111,75,107,20,202
"24167","chrX",147981714,147981742,29,131,114,274
"24168","chrX",147982589,147982611,23,147,74,244
"24169","chrX",148011267,148011294,28,5,3,36
"24170","chrX",148500605,148500753,149,2,66,217
"24171","chrX",149536830,149536902,73,128,16,217
"24172","chrX",149586984,149587031,48,53,83,184
"24173","chrX",149592018,149592042,25,9,102,136
"24174","chrX",149777340,149777360,21,104,7,132
"24175","chrX",149782358,149782405,48,85,51,184
"24176","chrX",149943060,149943132,73,18,116,207
"24177","chrX",150693328,150693359,32,36,125,193
"24178","chrX",150693541,150693561,21,13,83,117
"24179","chrX",150698681,150698726,46,145,23,214
"24180","chrX",150710334,150710378,45,8,48,101
"24181","chrX",150771180,150771198,19,71,118,208
"24182","chrX",150881816,150881835,20,76,40,136
"24183","chrX",150940648,150940692,45,74,6,125
"24184","chrX",150976318,150976336,19,15,43,77
"24185","chrX",150977197,150977415,219,39,16,274
"24186","chrX",150984323,150984350,28,3,18,49
"24187","chrX",151042491,151042517,27,56,7,90
"24188","chrX",151397112,151397132,21,72,4,97
"24189","chrX",151456605,151456626,22,145,35,202
"24190","chrX",151528397,151528414,18,77,132,227
"24191","chrX",151562812,151562895,84,2,94,180
"24192","chrX",151911475,151911519,45,138,99,282
"24193","chrX",152103690,152103711,22,114,75,211
"24194","chrX",152898136,152898157,22,78,5,105
"24195","chrX",152909591,152909617,27,57,130,214
"24196","chrX",153056556,153056577,22,53,60,135
"24197","chrX",153072180,153072197,18,72,15,105
"24198","chrX",153077834,153077851,18,17,70,105
"24199","chrX",153138368,153138438,71,97,5,173
"24200","chrX",153261502,153261577,76,7,95,178
"24201","chrX",153517578,153517635,58,35,92,185
"24202","chrX",153579874,153579900,27,70,135,232
"24203","chrX",153579904,153579929,26,99,105,230
"24204","chrX",153599179,153599274,96,32,33,161
"24205","chrX",153612472,153612489,18,26,2,46
"24206","chrX",153642392,153642435,44,1,53,98
"24207","chrX",153644281,153644315,35,2,47,84
"24208","chrX",153684814,153684867,54,50,40,144
"24209","chrX",153687827,153687847,21,82,12,115
"24210","chrX",153688032,153688064,33,64,6,103
"24211","chrX",153688271,153688315,45,3,30,78
"24212","chrX",153689223,153689248,26,82,15,123
"24213","chrX",153689412,153689436,25,67,55,147
"24214","chrX",153713882,153713905,24,89,120,233
"24215","chrX",153724591,153724609,19,140,30,189
"24216","chrX",153796864,153796896,33,74,87,194
"24217","chrX",153829204,153829225,22,50,110,182
"24218","chrX",153831351,153831402,52,20,26,98
"24219","chrX",153833989,153834015,27,8,107,142
"24220","chrX",153842367,153842387,21,3,65,89
"24221","chrX",153847592,153847615,24,6,95,125
"24222","chrX",153850296,153850313,18,76,18,112
"24223","chrX",153866313,153866366,54,125,74,253
"24224","chrX",153886263,153886288,26,16,107,149
"24225","chrX",153900388,153900406,19,58,63,140
"24226","chrX",153905326,153905355,30,1,19,50
"24227","chrX",153928800,153928839,40,8,69,117
"24228","chrX",153935304,153935340,37,55,39,131
"24229","chrX",153936132,153936167,36,89,3,128
"24230","chrX",153936506,153936524,19,63,6,88
"24231","chrX",153937608,153937639,32,37,144,213
"24232","chrX",153970493,153970531,39,1,48,88
"24233","chrX",153970525,153970614,90,2,16,108
"24234","chrX",153972940,153972965,26,67,105,198
"24235","chrX",153991641,153991695,55,7,69,131
"24236","chrX",154000762,154000779,18,9,146,173
"24237","chrX",154004913,154004967,55,75,92,222
"24238","chrX",154005253,154005277,25,7,143,175
"24239","chrX",154014098,154014116,19,133,122,274
"24240","chrX",154017796,154017826,31,36,74,141
"24241","chrX",154054141,154054162,22,77,27,126
"24242","chrX",154054312,154054333,22,4,74,100
"24243","chrX",154067904,154067922,19,77,25,121
"24244","chrX",154097609,154097635,27,16,104,147
"24245","chrX",154097639,154097662,24,43,74,141
"24246","chrX",154107222,154107241,20,121,7,148
"24247","chrX",154117095,154117127,33,77,99,209
"24248","chrX",154145463,154145482,20,26,75,121
"24249","chrX",154172974,154172994,21,76,11,108
"24250","chrX",154179698,154179719,22,75,11,108
"24251","chrX",154183857,154183876,20,26,75,121
"24252","chrX",154210107,154210132,26,76,11,113
"24253","chrX",154216836,154216859,24,75,11,110
"24254","chrX",154220995,154221014,20,26,75,121
"24255","chrX",154247916,154247934,19,76,11,106
"24256","chrX",154254638,154254660,23,75,11,109
"24257","chrX",154258799,154258818,20,26,75,121
"24258","chrX",154285032,154285052,21,76,11,108
"24259","chrX",154291756,154291778,23,75,11,109
"24260","chrX",154297244,154297275,32,47,52,131
"24261","chrX",154340420,154340439,20,6,31,57
"24262","chrX",154341586,154341626,41,7,79,127
"24263","chrX",154346630,154346652,23,86,54,163
"24264","chrX",154374565,154374582,18,25,34,77
"24265","chrX",154374674,154374711,38,19,2,59
"24266","chrX",154375872,154375898,27,55,10,92
"24267","chrX",154385462,154385484,23,56,84,163
"24268","chrX",154390488,154390564,77,81,5,163
"24269","chrX",154391711,154391729,19,33,4,56
"24270","chrX",154406369,154406386,18,125,46,189
"24271","chrX",154407588,154407614,27,9,46,82
"24272","chrX",154410876,154410917,42,117,9,168
"24273","chrX",154428788,154428816,29,26,134,189
"24274","chrX",154436851,154436892,42,17,85,144
"24275","chrX",154436944,154436967,24,40,18,82
"24276","chrX",154437168,154437197,30,35,8,73
"24277","chrX",154444154,154444231,78,27,34,139
"24278","chrX",154456902,154456927,26,95,7,128
"24279","chrX",154457700,154457732,33,73,124,230
"24280","chrX",154458289,154458306,18,48,13,79
"24281","chrX",154481282,154481300,19,145,73,237
"24282","chrX",154512228,154512268,41,124,31,196
"24283","chrX",154519062,154519098,37,6,21,64
"24284","chrX",154545837,154545856,20,117,4,141
"24285","chrX",154546877,154546894,18,1,51,70
"24286","chrX",154585479,154585508,30,125,13,168
"24287","chrX",154585596,154585629,34,52,8,94
"24288","chrX",154618796,154618829,34,10,50,94
"24289","chrX",154618917,154618946,30,15,123,168
"24290","chrX",155009082,155009100,19,121,18,158
"24291","chrX",155070919,155070941,23,6,32,61
"24292","chrX",155234110,155234138,29,126,3,158
"24293","chrX",155292771,155292801,31,116,5,152
"24294","chrX",155297687,155297704,18,145,77,240
"24295","chrX",155633377,155633403,27,90,35,152
"24296","chrX",155860649,155860672,24,16,7,47
"24297","chrX",155996779,155996796,18,13,76,107
"24298","chrX",156015249,156015272,24,21,6,51
"24299","chrY",2938155,2938190,36,37,75,148
"24300","chrY",3575923,3575958,36,10,64,110
"24301","chrY",3584408,3584425,18,54,28,100
"24302","chrY",3682505,3682557,53,11,79,143
"24303","chrY",4670993,4671016,24,77,34,135
"24304","chrY",5210063,5210098,36,9,73,118
"24305","chrY",5308663,5308681,19,30,2,51
"24306","chrY",5356886,5356904,19,10,73,102
"24307","chrY",5704425,5704448,24,76,50,150
"24308","chrY",5767190,5767227,38,75,145,258
"24309","chrY",6265410,6265436,27,85,87,199
"24310","chrY",7113449,7113476,28,142,9,179
"24311","chrY",7668002,7668029,28,27,6,61
"24312","chrY",7777156,7777178,23,10,15,48
"24313","chrY",9336326,9336352,27,85,87,199
"24314","chrY",9337725,9337771,47,33,84,164
"24315","chrY",9356659,9356685,27,85,87,199
"24316","chrY",9376937,9376963,27,85,87,199
"24317","chrY",9397283,9397309,27,85,87,199
"24318","chrY",9465819,9465845,27,85,87,199
"24319","chrY",9486129,9486155,27,85,87,199
"24320","chrY",9487528,9487574,47,33,84,164
"24321","chrY",9506412,9506438,27,85,88,200
"24322","chrY",9507811,9507857,47,34,84,165
"24323","chrY",9526742,9526768,27,85,87,199
"24324","chrY",9546932,9546958,27,19,86,132
"24325","chrY",9926689,9926800,112,149,8,269
"24326","chrY",10169606,10169683,78,37,74,189
"24327","chrY",10175184,10175257,74,6,77,157
"24328","chrY",11101593,11101614,22,48,131,201
"24329","chrY",11101614,11101631,18,65,110,193
"24330","chrY",11333940,11333967,28,25,24,77
"24331","chrY",11429378,11429396,19,49,76,144
"24332","chrY",11430254,11430280,27,2,6,35
"24333","chrY",11451923,11451950,28,116,7,151
"24334","chrY",11855849,11855886,38,77,17,132
"24335","chrY",12075274,12075301,28,39,75,142
"24336","chrY",12498002,12498026,25,98,67,190
"24337","chrY",12498026,12498048,23,120,43,186
"24338","chrY",13926476,13926503,28,81,14,123
"24339","chrY",14525088,14525107,20,66,56,142
"24340","chrY",15018521,15018541,21,13,98,132
"24341","chrY",15354889,15354906,18,132,5,155
"24342","chrY",15456288,15456306,19,61,75,155
"24343","chrY",16257923,16257947,25,149,6,180
"24344","chrY",16327376,16327400,25,8,147,180
"24345","chrY",16816874,16816901,28,104,65,197
"24346","chrY",16924824,16924863,40,3,19,62
"24347","chrY",17071930,17071962,33,4,98,135
"24348","chrY",17228089,17228137,49,8,145,202
"24349","chrY",17574015,17574045,31,72,131,234
"24350","chrY",17883315,17883344,30,28,86,144
"24351","chrY",17883318,17883350,33,34,83,150
"24352","chrY",18022663,18022692,30,88,26,144
"24353","chrY",18331966,18331996,31,133,70,234
"24354","chrY",18658113,18658133,21,108,120,249
"24355","chrY",19849672,19849692,21,141,6,168
"24356","chrY",20755061,20755086,26,19,125,170
"24357","chrY",21640197,21640220,24,146,74,244
"24358","chrY",22061375,22061397,23,29,76,128
"24359","chrY",22524996,22525018,23,78,27,128
"24360","chrY",24051094,24051123,30,28,86,144
"24361","chrY",24051097,24051129,33,34,83,150
"24362","chrY",25619008,25619037,30,88,26,144
